Year,Age,G,MP,FG,FGA,3P,3PA,2P,2PA,FT,FTA,ORB,DRB,TRB,AST,STL,BLK,TOV,PF,PTS,Pos
1980,32,82,3143,835,1383,0,1,835,1382,364,476,190,696,886,371,81,280,297,216,2034,C
1980,25,67,1222,153,318,0,1,153,317,56,82,62,129,191,87,35,12,39,118,362,PF
1980,25,75,2168,465,875,0,2,465,873,188,236,158,451,609,322,108,55,218,237,1118,C
1980,31,80,2864,383,794,4,18,379,776,361,435,59,138,197,671,106,10,242,218,1131,PG
1980,31,26,560,27,60,0,0,27,60,32,50,29,86,115,40,12,15,27,66,86,C
1980,28,20,180,16,35,1,1,15,34,5,13,6,22,28,26,7,4,11,18,38,SG
1980,22,67,726,122,271,0,0,122,271,68,101,71,126,197,28,21,54,79,116,312,PF
1980,25,82,2438,545,1101,16,47,529,1054,171,227,240,398,638,159,90,36,133,197,1277,SF
1980,28,77,2330,384,760,1,3,383,757,139,209,192,264,456,279,85,49,189,268,908,SF
1980,27,20,287,24,60,0,0,24,60,16,32,34,43,77,18,5,12,18,52,64,PF
1980,35,72,1816,325,771,73,221,252,550,143,153,53,183,236,268,80,28,152,182,866,SF
1980,28,12,164,12,34,0,0,12,34,10,15,11,22,33,14,8,0,9,27,34,PF
1980,28,7,92,8,22,0,0,8,22,8,12,7,11,18,4,5,0,4,14,24,PF
1980,28,5,72,4,12,0,0,4,12,2,3,4,11,15,10,3,0,5,13,10,PF
1980,23,16,235,72,146,8,19,64,127,28,39,13,16,29,31,14,2,20,26,180,SG
1980,29,6,64,9,23,0,0,9,23,5,6,6,8,14,7,0,4,4,14,23,PF
1980,25,73,1891,299,618,1,5,298,613,99,141,126,327,453,178,73,92,157,246,698,C
1980,25,56,1389,213,431,0,1,213,430,66,97,96,237,333,127,54,74,106,178,492,C
1980,25,17,502,86,187,1,4,85,183,33,44,30,90,120,51,19,18,51,68,206,C
1980,23,68,869,88,250,10,26,78,224,58,87,16,47,63,139,58,5,104,105,244,PG
1980,30,82,2035,251,626,11,52,240,574,226,286,65,143,208,307,62,6,147,161,739,PG
1980,23,82,2955,693,1463,58,143,635,1320,301,360,216,636,852,370,143,53,263,279,1745,PF
1980,24,82,2885,781,1546,10,36,771,1510,286,412,170,161,331,202,136,22,179,226,1858,SG
1980,33,81,2392,405,915,19,50,386,865,175,196,54,173,227,309,97,3,197,232,1004,SG
1980,33,6,106,14,40,0,0,14,40,6,7,4,7,11,7,5,0,13,13,34,SG
1980,33,75,2286,391,875,19,50,372,825,169,189,50,166,216,302,92,3,184,219,970,SG
1980,23,13,125,24,52,0,0,24,52,8,13,19,20,39,2,4,2,8,25,56,PF
1980,26,79,2077,346,613,5,10,341,603,206,273,146,296,442,161,29,37,181,270,903,PF
1980,26,18,522,72,135,1,2,71,133,58,70,40,74,114,46,5,8,39,56,203,PF
1980,26,61,1555,274,478,4,8,270,470,148,203,106,222,328,115,24,29,142,214,700,PF
1980,22,64,1102,221,467,0,4,221,463,104,136,51,82,133,95,59,19,96,132,546,SG
1980,26,22,96,17,48,1,1,16,47,6,9,2,4,6,3,3,0,8,9,41,SF
1980,22,82,2027,275,609,2,5,273,604,136,174,69,154,223,252,211,48,166,194,688,SG
1980,24,82,1589,269,687,21,86,248,601,141,162,50,117,167,223,93,9,135,165,700,PG
1980,28,67,1016,90,184,0,5,90,179,14,29,101,156,257,75,42,43,47,129,194,PF
1980,24,82,2815,548,1182,6,32,542,1150,184,219,54,160,214,216,98,48,167,154,1286,SG
1980,26,81,2316,594,1243,5,27,589,1216,230,266,104,197,301,237,94,20,172,216,1423,SF
1980,28,82,2304,377,785,2,7,375,778,197,243,170,342,512,341,88,6,179,211,953,SF
1980,31,80,1701,404,843,39,88,365,755,113,135,35,120,155,174,65,17,105,117,960,SG
1980,28,32,385,37,105,0,0,37,105,38,48,26,45,71,18,3,4,29,70,112,SF
1980,28,4,24,0,7,0,0,0,7,4,4,5,4,9,4,0,0,5,4,4,SF
1980,28,28,361,37,98,0,0,37,98,34,44,21,41,62,14,3,4,24,66,108,SF
1980,29,4,37,1,3,0,0,1,3,0,0,2,8,10,1,0,3,0,4,2,C
1980,25,81,2328,294,682,5,34,289,648,161,217,171,345,516,144,102,39,170,258,754,PF
1980,25,67,1690,306,655,2,5,304,650,105,143,69,169,238,383,135,4,149,202,719,PG
1980,27,37,272,36,104,0,3,36,101,23,40,23,49,72,20,8,13,25,49,95,C
1980,29,81,2499,261,589,19,79,242,510,85,128,70,163,233,320,132,10,91,111,626,PG
1980,23,32,194,25,50,0,0,25,50,13,15,9,18,27,13,5,1,22,32,63,SF
1980,29,7,30,4,9,0,0,4,9,0,2,7,3,10,0,2,0,1,6,8,SF
1980,32,48,772,100,227,1,11,99,216,105,117,13,71,84,134,27,0,57,72,306,PG
1980,31,77,1595,390,839,2,6,388,833,127,172,81,84,165,150,39,3,108,120,909,SG
1980,24,79,1838,378,768,0,4,378,764,173,263,199,389,588,77,66,52,154,246,929,PF
1980,24,5,57,7,16,0,0,7,16,2,2,5,12,17,1,2,1,9,6,16,PF
1980,24,74,1781,371,752,0,4,371,748,171,261,194,377,571,76,64,51,145,240,913,PF
1980,29,82,1994,362,763,12,41,350,722,178,241,106,224,330,156,120,36,143,214,914,SF
1980,26,10,134,15,37,0,2,15,35,6,8,6,7,13,3,4,1,5,18,36,SG
1980,23,13,117,15,37,0,0,15,37,2,7,5,14,19,9,2,3,10,19,32,SG
1980,22,82,3150,665,1215,0,0,665,1215,451,566,194,532,726,165,48,101,222,279,1781,C
1980,28,72,1366,97,244,0,1,97,243,39,62,164,246,410,82,23,162,68,191,233,C
1980,33,60,523,67,189,1,6,66,183,32,42,31,42,73,38,31,11,33,80,167,SG
1980,23,79,2623,357,661,4,9,353,652,180,231,75,199,274,556,183,32,216,197,898,PG
1980,29,43,850,136,349,5,12,131,337,49,67,19,59,78,89,33,15,55,55,326,SG
1980,29,20,470,84,214,3,6,81,208,31,41,10,33,43,42,18,5,29,26,202,SG
1980,29,23,380,52,135,2,6,50,129,18,26,9,26,35,47,15,10,26,29,124,SG
1980,30,82,2394,372,760,0,2,372,758,125,169,143,421,564,151,56,65,175,271,869,C
1980,30,79,1789,214,450,7,31,207,419,84,113,53,99,152,288,57,11,109,133,519,PG
1980,30,22,254,30,69,3,8,27,61,12,15,10,9,19,40,13,2,17,13,75,PG
1980,30,57,1535,184,381,4,23,180,358,72,98,43,90,133,248,44,9,92,120,444,PG
1980,28,36,963,191,410,0,1,191,409,113,124,29,65,94,100,30,7,82,76,495,SG
1980,23,66,904,129,275,0,3,129,272,104,129,90,151,241,84,28,18,71,102,362,PF
1980,23,82,1973,303,578,5,20,298,558,111,143,101,128,229,221,86,38,142,215,722,SG
1980,23,79,1781,367,750,1,4,366,746,136,181,202,305,507,42,20,79,140,246,871,PF
1980,24,75,1142,182,368,0,2,182,366,63,86,70,86,156,80,61,25,84,154,427,SF
1980,23,78,826,90,216,0,0,90,216,45,68,104,166,270,63,9,31,60,120,225,C
1980,28,24,160,29,81,2,9,27,72,8,14,2,17,19,12,7,1,13,24,68,SF
1980,31,66,2159,422,932,1,12,421,920,95,122,126,408,534,206,69,61,108,216,940,C
1980,31,81,1794,249,578,1,17,248,561,172,212,27,89,116,246,74,4,130,133,671,PG
1980,23,4,28,2,4,0,0,2,4,2,2,0,1,1,7,0,0,5,4,6,PG
1980,23,71,900,187,370,0,0,187,370,94,123,81,157,238,53,22,17,74,141,468,C
1980,32,45,1457,329,729,2,11,327,718,123,152,63,183,246,178,29,36,123,112,783,SF
1980,23,68,2674,730,1267,0,2,730,1265,443,526,183,333,516,191,96,14,233,211,1903,SF
1980,24,18,268,35,63,0,1,35,62,13,16,4,13,17,50,13,1,14,28,83,PG
1980,24,5,43,2,7,0,0,2,7,3,4,0,2,2,5,3,0,3,7,7,PG
1980,24,13,225,33,56,0,1,33,55,10,12,4,11,15,45,10,1,11,21,76,PG
1980,24,4,30,6,12,0,0,6,12,1,2,2,4,6,0,1,0,3,8,13,SF
1980,24,82,2912,496,1159,4,42,492,1117,304,352,102,124,226,440,110,23,202,178,1300,PG
1980,25,75,2309,657,1166,0,4,657,1162,299,365,75,197,272,337,114,19,242,202,1613,SF
1980,23,80,2541,494,946,0,6,494,940,190,291,197,496,693,149,49,142,230,328,1178,C
1980,22,57,776,141,300,1,5,140,295,33,48,42,83,125,77,33,9,76,112,316,SF
1980,22,7,48,2,11,1,1,1,10,5,7,2,4,6,6,0,0,3,3,10,SG
1980,22,82,1872,230,528,0,0,230,528,110,183,195,288,483,64,56,30,168,306,570,PF
1980,31,79,1830,227,500,1,9,226,491,90,118,101,262,363,216,89,51,112,230,545,C
1980,25,70,1782,221,455,0,1,221,454,125,185,171,330,501,121,30,62,127,249,567,C
1980,25,80,2306,535,1182,0,7,535,1175,489,646,203,268,471,101,91,23,240,313,1559,SF
1980,23,67,1331,282,598,15,53,267,545,45,66,29,69,98,117,41,11,79,102,624,SG
1980,25,51,1036,148,319,3,20,145,299,111,134,26,74,100,210,40,4,110,120,410,PG
1980,24,82,1841,240,551,0,3,240,548,84,111,132,192,324,147,102,31,91,145,564,SG
1980,24,82,2314,528,1032,0,1,528,1031,231,339,179,399,578,127,55,104,131,324,1287,C
1980,24,54,722,101,228,1,4,100,224,104,152,67,118,185,53,29,14,88,97,307,PF
1980,25,48,502,61,136,0,3,61,133,40,53,51,65,116,30,10,24,24,67,162,PF
1980,27,58,915,104,242,0,0,104,242,51,74,74,183,257,64,41,39,67,154,259,C
1980,26,78,2401,553,1113,2,6,551,1107,210,266,269,336,605,224,73,62,214,206,1318,SF
1980,26,54,1526,346,686,0,3,346,683,114,140,167,213,380,142,45,33,124,128,806,SF
1980,26,24,875,207,427,2,3,205,424,96,126,102,123,225,82,28,29,90,78,512,SF
1980,29,78,2812,838,1614,4,20,834,1594,420,534,215,361,576,355,170,140,284,208,2100,SF
1980,24,36,381,63,140,7,18,56,122,24,42,26,49,75,37,14,1,36,64,157,PF
1980,24,79,1246,208,464,12,42,196,422,58,85,29,78,107,230,60,9,128,194,486,SG
1980,26,56,431,71,153,0,0,71,153,33,52,40,56,96,28,17,12,20,43,175,PF
1980,31,73,2115,330,709,70,164,260,545,86,114,77,104,181,215,111,27,105,178,816,SG
1980,27,73,999,131,274,1,3,130,271,45,53,44,141,185,65,22,21,51,131,308,SF
1980,27,52,580,66,130,0,1,66,129,23,28,23,75,98,36,11,15,30,86,155,SF
1980,27,21,419,65,144,1,2,64,142,22,25,21,66,87,29,11,6,21,45,153,SF
1980,23,82,2621,489,1058,4,23,485,1035,346,423,29,143,172,610,136,4,282,208,1328,PG
1980,34,3,27,4,11,0,1,4,10,2,2,1,2,3,8,2,1,4,2,10,PG
1980,26,68,2585,737,1556,9,25,728,1531,572,760,129,109,238,283,81,32,228,195,2055,SG
1980,25,76,2122,430,926,24,82,406,844,171,196,70,124,194,293,73,23,163,98,1055,SG
1980,25,21,404,66,161,1,9,65,152,44,51,23,19,42,72,19,9,34,19,177,SG
1980,25,55,1718,364,765,23,73,341,692,127,145,47,105,152,221,54,14,129,79,878,SG
1980,29,67,1474,171,377,2,13,169,364,97,120,34,118,152,312,123,13,115,134,441,PG
1980,22,78,1106,155,356,6,19,149,337,18,26,50,88,138,145,54,4,73,80,334,PG
1980,26,73,869,159,348,1,3,158,345,66,100,77,100,177,43,41,26,49,96,385,SF
1980,27,78,2934,1024,1940,32,102,992,1838,505,593,154,249,403,202,110,79,254,208,2585,SG
1980,29,17,285,23,66,0,0,23,66,9,16,14,48,62,17,6,7,22,26,55,C
1980,30,48,1568,305,513,0,0,305,513,245,344,108,324,432,133,29,59,133,167,855,C
1980,23,82,1254,182,473,0,2,182,471,106,128,114,128,242,59,51,19,59,132,470,SF
1980,24,75,800,188,364,2,10,186,354,63,73,21,45,66,85,35,7,38,79,441,SG
1980,24,59,1020,148,286,2,6,146,280,92,121,107,152,259,81,68,16,58,119,390,SF
1980,28,21,459,69,159,0,2,69,157,24,42,35,78,113,28,13,21,36,55,162,C
1980,22,82,2791,498,1051,1,7,497,1044,337,416,223,550,773,182,60,129,210,313,1334,PF
1980,26,65,1818,331,804,34,92,297,712,216,249,80,107,187,177,56,16,102,158,912,SF
1980,26,82,1812,173,313,0,0,173,313,174,240,154,284,438,250,81,53,131,306,520,C
1980,26,62,1581,221,472,1,10,220,462,95,114,84,165,249,228,60,47,166,179,538,SF
1980,24,80,1397,186,420,1,2,185,418,101,131,87,145,232,109,56,9,81,151,474,SF
1980,22,72,1116,115,287,0,2,115,285,103,150,45,62,107,192,48,5,118,82,333,PG
1980,23,76,1600,184,363,1,2,183,361,51,66,124,275,399,104,47,87,105,207,420,PF
1980,24,74,1135,215,509,69,198,146,311,24,29,35,59,94,104,46,8,45,85,523,SG
1980,29,82,1853,304,605,3,8,301,597,150,182,148,348,496,144,74,29,121,205,761,PF
1980,34,81,3183,761,1677,3,13,758,1664,334,478,269,627,896,129,62,189,215,309,1859,PF
1980,30,76,1544,288,591,1,4,287,587,159,206,132,214,346,93,35,57,134,197,736,PF
1980,31,82,1403,171,410,0,2,171,408,64,86,118,262,380,97,84,49,88,177,406,PF
1980,24,76,1061,191,382,2,6,189,376,89,129,37,46,83,147,45,15,109,96,473,PG
1980,28,66,1551,154,323,0,2,154,321,56,77,34,77,111,274,55,4,102,107,364,PG
1980,22,82,1121,144,323,1,7,143,316,120,178,69,104,173,119,71,15,123,172,409,PG
1980,26,79,2092,177,431,1,4,176,427,124,146,31,107,138,424,107,8,171,261,479,PG
1980,30,49,708,82,179,0,0,82,179,34,68,59,121,180,47,21,24,59,128,198,PF
1980,23,38,197,44,104,3,15,41,89,15,16,4,13,17,22,15,1,13,24,106,SG
1980,26,20,413,82,213,1,10,81,203,34,53,5,15,20,50,30,1,60,35,199,PG
1980,26,27,796,130,313,2,10,128,303,67,87,24,45,69,112,46,9,68,68,329,SG
1980,23,64,1189,210,451,0,2,210,449,165,220,114,206,320,70,48,10,120,202,585,PF
1980,27,70,1208,102,202,0,0,102,202,15,41,125,201,326,74,66,77,50,184,219,C
1980,22,71,923,94,241,3,17,91,224,28,38,14,44,58,159,39,5,73,83,219,PG
1980,31,82,2938,715,1416,4,12,711,1404,517,667,236,483,719,198,88,54,163,190,1951,C
1980,34,16,194,29,46,0,2,29,44,7,10,12,12,24,12,5,4,9,35,65,PF
1980,25,77,1286,288,565,0,6,288,559,161,204,114,156,270,95,40,40,117,155,737,SF
1980,22,9,53,12,30,0,0,12,30,3,5,6,8,14,2,1,0,4,11,27,SF
1980,23,79,1541,199,396,0,0,199,396,74,117,145,249,394,115,48,121,78,211,472,C
1980,25,81,2937,574,1361,12,58,562,1303,380,487,173,241,414,332,144,82,227,267,1540,SG
1980,24,79,2622,590,1212,5,13,585,1199,280,338,95,105,200,370,120,24,189,216,1465,SG
1980,31,81,2119,248,543,0,1,248,542,89,126,192,410,602,173,53,258,199,312,585,C
1980,23,75,1938,309,649,2,9,307,640,148,189,190,394,584,157,84,67,148,260,768,PF
1980,32,81,2533,377,772,0,0,377,772,161,201,163,263,426,424,76,35,247,213,915,SF
1980,20,77,2795,503,949,7,31,496,918,374,462,166,430,596,563,187,41,305,218,1387,SG
1980,23,77,2686,689,1267,2,9,687,1258,291,368,217,349,566,273,100,70,185,173,1671,SF
1980,27,82,2647,588,1271,5,32,583,1239,385,482,258,423,681,344,153,112,286,291,1566,PF
1980,30,79,1535,262,527,1,11,261,516,82,93,50,113,163,161,59,24,96,165,607,SF
1980,23,38,325,45,115,0,1,45,114,31,39,19,36,55,54,19,4,42,40,121,SG
1980,28,81,2125,398,748,0,3,398,745,257,329,152,298,450,146,102,118,146,223,1053,PF
1980,29,80,2771,232,532,0,2,232,530,124,178,219,731,950,164,43,162,218,298,588,C
1980,27,74,1448,257,506,0,0,257,506,146,201,114,254,368,101,28,42,122,207,660,PF
1980,27,21,278,50,119,0,0,50,119,27,36,31,41,72,11,4,5,20,48,127,PF
1980,27,53,1170,207,387,0,0,207,387,119,165,83,213,296,90,24,37,102,159,533,PF
1980,26,82,1545,188,392,1,3,187,389,61,108,147,234,381,67,50,67,112,186,438,PF
1980,25,82,2657,437,1017,12,48,425,969,201,258,62,208,270,557,223,27,258,238,1087,PG
1980,23,65,674,139,276,11,27,128,249,62,76,32,34,66,47,29,5,49,91,351,SF
1980,26,80,1839,229,484,0,3,229,481,244,310,200,315,515,178,78,96,198,273,702,C
1980,26,57,1466,186,399,0,3,186,396,197,250,156,241,397,128,50,79,152,215,569,C
1980,26,23,373,43,85,0,0,43,85,47,60,44,74,118,50,28,17,46,58,133,C
1980,22,50,1233,280,593,3,15,277,578,146,203,124,152,276,108,60,34,140,176,709,SF
1980,27,78,2798,647,1333,1,9,646,1324,270,345,258,517,775,231,111,18,232,192,1565,PF
1980,28,26,212,32,96,0,0,32,96,18,25,12,28,40,19,10,2,30,43,82,SF
1980,23,2,6,1,2,0,0,1,2,1,2,1,3,4,0,0,0,0,1,3,C
1980,23,19,419,71,137,0,0,71,137,34,63,24,64,88,52,7,4,50,66,176,SF
1980,22,82,2052,257,499,0,1,257,498,159,219,184,382,566,106,69,31,100,230,673,PF
1980,27,75,1910,385,722,4,15,381,707,212,262,136,225,361,155,82,9,132,96,986,SF
1980,24,81,2945,669,1265,0,2,669,1263,211,261,201,292,493,150,117,86,163,302,1549,SF
1980,23,8,45,7,22,0,0,7,22,2,2,6,6,12,3,0,5,5,8,16,C
1980,24,54,711,67,143,0,1,67,142,56,70,49,102,151,75,26,5,51,104,190,C
1980,24,24,100,12,34,0,1,12,33,5,7,3,11,14,16,7,1,5,8,29,PG
1980,28,18,302,50,114,0,0,50,114,26,43,37,75,112,29,7,22,41,59,126,C
1980,25,40,451,67,160,0,2,67,158,52,75,32,73,105,16,8,8,40,49,186,PF
1980,31,81,2412,303,677,0,1,303,676,137,185,172,473,645,460,111,109,211,307,743,C
1980,24,82,1164,146,306,0,0,146,306,90,137,127,185,312,91,19,34,97,206,382,C
1980,27,74,1324,165,400,0,3,165,397,73,101,138,214,352,56,47,42,64,203,403,PF
1980,24,77,1510,249,483,0,0,249,483,116,222,226,387,613,46,33,22,100,140,614,C
1980,24,54,1136,183,346,0,0,183,346,87,166,157,293,450,32,23,17,75,113,453,C
1980,24,23,374,66,137,0,0,66,137,29,56,69,94,163,14,10,5,25,27,161,C
1980,31,63,2131,466,867,1,6,465,861,277,354,152,400,552,184,74,89,162,200,1210,C
1980,31,37,1392,319,584,0,5,319,579,164,210,108,265,373,122,38,60,113,130,802,C
1980,31,26,739,147,283,1,1,146,282,113,144,44,135,179,62,36,29,49,70,408,C
1980,22,77,2123,330,656,3,19,327,637,180,221,57,127,184,417,127,28,205,197,843,PG
1980,23,14,55,6,24,0,0,6,24,6,8,7,4,11,12,1,0,10,2,18,PG
1980,23,3,24,2,11,0,0,2,11,0,1,3,0,3,3,0,0,3,0,4,PG
1980,23,11,31,4,13,0,0,4,13,6,7,4,4,8,9,1,0,7,2,14,PG
1980,27,61,1167,113,305,22,59,91,246,44,70,40,83,123,241,99,17,101,172,292,PG
1980,27,30,364,29,91,0,3,29,88,9,17,11,22,33,67,15,4,33,65,67,PG
1980,27,31,803,84,214,22,56,62,158,35,53,29,61,90,174,84,13,68,107,225,PG
1980,23,69,2364,588,1164,1,12,587,1152,160,194,152,185,337,206,129,26,206,221,1337,SG
1980,26,80,2763,388,830,12,42,376,788,222,289,61,159,220,602,138,3,184,196,1010,PG
1980,27,63,1884,371,813,2,9,369,804,179,239,143,394,537,208,42,62,218,223,923,PF
1980,27,41,1176,243,552,2,5,241,547,100,137,85,240,325,125,23,35,148,141,588,PF
1980,27,22,708,128,261,0,4,128,257,79,102,58,154,212,83,19,27,70,82,335,PF
1980,22,50,681,98,199,0,5,98,194,38,51,32,39,71,53,24,3,35,50,234,SG
1980,22,27,155,21,50,0,1,21,49,9,18,7,15,22,20,4,0,9,16,51,SG
1980,22,23,526,77,149,0,4,77,145,29,33,25,24,49,33,20,3,26,34,183,SG
1980,24,82,3140,778,1549,0,6,778,1543,563,783,573,617,1190,147,80,107,300,210,2119,C
1980,23,39,445,31,67,0,0,31,67,18,27,36,50,86,26,8,6,23,51,80,PF
1980,23,28,277,23,42,0,0,23,42,7,9,27,31,58,12,5,1,14,35,53,PF
1980,23,10,162,8,25,0,0,8,25,10,14,9,19,28,14,2,5,9,16,26,PF
1980,32,43,964,244,543,10,15,234,528,91,105,17,61,78,83,24,6,82,79,589,SG
1980,32,17,522,121,294,7,11,114,283,41,50,7,33,40,54,15,4,45,30,290,SG
1980,32,26,442,123,249,3,4,120,245,50,55,10,28,38,29,9,2,37,49,299,SG
1980,24,80,2744,457,750,0,0,457,750,436,554,284,420,704,199,76,61,230,266,1350,SF
1980,25,54,1298,264,587,0,4,264,583,144,172,78,140,218,104,45,5,77,126,672,SF
1980,28,58,2097,492,1025,3,24,489,1001,235,322,100,367,467,200,73,65,238,178,1222,PF
1980,26,67,1528,228,527,5,21,223,506,132,172,32,67,99,227,46,19,131,123,593,PG
1980,26,36,1012,162,356,3,14,159,342,95,119,12,38,50,162,25,14,88,78,422,PG
1980,26,31,516,66,171,2,7,64,164,37,53,20,29,49,65,21,5,43,45,171,PG
1980,29,73,2208,400,886,2,15,398,871,270,488,222,477,699,333,101,23,281,303,1072,PF
1980,29,45,1424,268,584,1,7,267,577,166,307,134,328,462,221,69,17,188,187,703,PF
1980,29,28,784,132,302,1,8,131,294,104,181,88,149,237,112,32,6,93,116,369,PF
1980,24,76,1333,206,459,1,10,205,449,107,133,20,66,86,248,58,5,89,87,520,PG
1980,27,53,1071,191,382,0,1,191,381,81,107,70,150,220,62,36,14,64,126,463,C
1980,30,36,387,90,166,0,6,90,160,39,49,3,20,23,38,10,0,36,54,219,SG
1980,26,65,1565,252,477,0,1,252,476,78,121,122,228,350,66,37,120,112,239,582,PF
1980,26,79,2204,399,830,1,5,398,825,156,246,140,308,448,225,72,40,182,218,955,PF
1980,24,82,2802,775,1482,0,6,775,1476,270,343,206,385,591,93,70,77,172,259,1820,SF
1980,32,81,1543,363,703,4,10,359,693,207,249,114,176,290,149,67,9,132,114,937,SF
1980,23,12,113,11,33,0,0,11,33,7,9,14,15,29,2,1,6,10,24,29,C
1980,22,77,1557,211,451,0,1,211,450,232,292,154,184,338,133,72,16,117,106,654,SG
1980,24,6,82,14,36,0,0,14,36,2,2,3,4,7,16,0,1,12,11,30,PG
1980,24,55,1467,259,510,0,0,259,510,81,104,28,69,97,238,53,10,143,135,599,SG
1980,35,51,633,161,352,0,0,161,352,56,64,16,20,36,67,21,3,28,46,378,SG
1980,31,76,2676,624,1267,1,25,623,1242,271,302,68,82,150,299,143,9,162,269,1520,SG
1980,30,81,2860,443,799,0,2,443,797,196,273,352,864,1216,233,45,37,257,259,1082,C
1980,23,78,2857,622,1298,3,9,619,1289,306,419,239,452,691,169,102,34,198,205,1553,SF
1980,23,53,2046,421,879,1,5,420,874,199,280,173,340,513,112,78,22,133,148,1042,SF
1980,23,25,811,201,419,2,4,199,415,107,139,66,112,178,57,24,12,65,57,511,SF
1980,31,78,2510,611,1329,45,152,566,1177,367,415,101,163,264,314,115,4,231,195,1634,SG
1980,24,82,3226,624,1209,1,8,623,1201,197,253,52,177,229,642,147,14,288,241,1446,PG
1980,22,17,189,18,43,0,0,18,43,4,6,10,33,43,6,3,12,19,41,40,C
1980,23,75,2111,291,609,0,3,291,606,210,264,83,335,418,327,67,22,180,274,792,SF
1980,24,1,15,0,2,0,0,0,2,0,0,0,1,1,0,0,0,2,2,0,SF
1980,30,76,2337,518,1008,1,2,517,1006,213,283,189,384,573,194,45,53,174,270,1250,C
1980,26,72,2119,510,1006,0,1,510,1005,203,284,247,536,783,122,58,115,225,248,1223,C
1980,24,82,2849,483,988,0,2,483,986,237,302,166,298,464,254,173,32,163,195,1203,SF
1980,31,84,2193,327,673,0,1,327,672,109,182,187,399,586,188,69,84,115,213,763,C
1980,31,47,1213,189,381,0,1,189,380,66,100,95,226,321,118,47,45,58,127,444,C
1980,31,37,980,138,292,0,0,138,292,43,82,92,173,265,70,22,39,57,86,319,C
1980,22,72,1270,189,460,1,22,188,438,64,90,25,84,109,144,48,5,93,97,443,SG
1980,22,52,628,73,169,0,2,73,167,34,55,66,117,183,33,17,23,48,100,180,SF
1980,28,44,373,44,108,0,0,44,108,21,30,28,64,92,18,12,12,18,70,109,PF
1980,23,78,1512,350,733,4,9,346,724,177,203,75,110,185,102,34,7,119,158,881,SG
1980,23,50,971,224,473,2,5,222,468,104,120,49,66,115,70,19,3,70,106,554,SG
1980,23,28,541,126,260,2,4,124,256,73,83,26,44,70,32,15,4,49,52,327,SG
1980,23,50,577,91,179,9,36,82,143,37,46,26,19,45,94,25,4,51,52,228,PG
1980,24,82,2349,296,566,0,2,296,564,139,167,124,436,560,131,45,162,103,283,731,C
1980,29,70,1494,201,438,0,4,201,434,110,137,25,57,82,457,59,11,164,180,512,PG
1980,31,81,1683,203,383,0,2,203,381,84,149,122,344,466,183,51,32,155,266,490,C
1980,24,24,298,59,138,0,9,59,129,24,34,18,34,52,19,4,9,19,27,142,SG
1980,24,76,2304,419,861,0,3,419,858,153,208,140,301,441,244,132,57,164,281,991,SF
1980,28,82,1966,369,727,5,29,364,698,131,161,142,244,386,189,54,12,129,186,874,SF
1980,23,52,988,159,348,1,3,158,345,28,45,55,68,123,107,24,15,64,97,347,SG
1980,24,82,3060,502,1063,27,110,475,953,223,338,151,388,539,832,265,35,359,260,1254,SG
1980,24,23,486,69,181,0,1,69,180,39,60,54,55,109,20,13,3,28,52,177,SF
1980,24,82,1918,379,727,0,1,379,726,184,269,209,321,530,92,53,15,151,244,942,C
1980,19,70,1661,391,833,1,4,390,829,168,242,174,332,506,98,61,34,137,178,951,PF
1980,24,7,51,9,17,0,1,9,16,9,11,3,2,5,0,3,3,2,8,27,SF
1980,28,82,2710,545,1064,0,0,545,1064,325,487,213,557,770,142,58,59,251,262,1415,PF
1980,27,81,1917,362,723,1,2,361,721,200,274,184,342,526,62,106,23,148,311,925,PF
1980,30,82,2670,489,940,0,3,489,937,277,329,225,433,658,192,53,53,138,211,1255,C
1980,30,82,2286,354,741,49,129,305,612,175,202,24,91,115,405,82,12,159,139,932,PG
1980,24,82,2123,287,514,0,0,287,514,157,220,283,491,774,76,54,244,99,322,731,C
1980,26,81,2588,502,1007,0,4,502,1003,330,465,293,544,837,184,101,139,233,317,1334,PF
1980,28,41,1331,284,630,1,9,283,621,178,239,76,149,225,173,72,20,148,113,747,SF
1980,24,79,1303,127,301,1,3,126,298,95,122,89,139,228,98,47,53,92,101,350,SF
1980,31,69,1860,276,688,2,11,274,677,85,118,51,115,166,250,47,23,163,197,639,SG
1980,24,76,2243,425,802,1,5,424,797,184,241,199,383,582,145,92,79,169,292,1035,PF
1980,22,62,1636,461,916,0,6,461,910,134,165,119,197,316,123,63,9,122,186,1056,SF
1980,27,65,1337,207,392,0,1,207,391,165,216,108,255,363,84,40,45,91,126,579,PF
1980,27,9,228,35,65,0,0,35,65,17,25,18,52,70,9,9,5,14,16,87,PF
1980,27,29,332,34,64,0,0,34,64,33,44,25,54,79,23,8,9,27,39,101,PF
1980,27,27,777,138,263,0,1,138,262,115,147,65,149,214,52,23,31,50,71,391,PF
1980,24,82,2793,470,989,0,1,470,988,235,292,198,710,908,279,68,77,202,232,1175,C
1980,30,77,2293,513,999,0,4,513,995,339,382,45,122,167,347,61,14,192,206,1365,PG
1980,36,82,1595,113,299,0,0,113,299,89,136,204,232,436,66,25,5,83,120,315,PF
1980,30,8,81,18,47,0,2,18,45,5,10,6,5,11,14,9,0,12,3,41,SG
1980,27,2,10,1,2,0,0,1,2,0,0,0,0,0,2,0,0,2,1,2,SG
1980,33,8,135,33,72,1,5,32,67,7,8,2,12,14,7,3,2,9,21,74,SG
1980,33,70,1988,352,819,22,76,330,743,93,107,92,153,245,93,59,15,72,188,819,SF
1980,27,51,1552,325,685,7,22,318,663,135,171,28,118,146,187,62,15,121,154,792,SG
1980,31,82,2677,599,1326,10,53,589,1273,233,283,93,163,256,363,125,7,200,190,1441,SG
1980,24,65,809,118,269,8,26,110,243,80,92,20,59,79,92,26,4,53,105,324,PG
1980,24,6,73,5,15,0,0,5,15,5,5,3,0,3,7,4,0,1,3,15,PG
1980,24,59,736,113,254,8,26,105,228,75,87,17,59,76,85,22,4,52,102,309,PG
1980,25,30,496,97,230,8,35,89,195,57,63,22,32,54,42,25,7,33,54,259,SF
1980,26,62,1051,121,315,17,71,104,244,40,52,56,65,121,259,75,1,95,110,299,PG
1980,27,82,2673,470,1002,21,68,449,934,200,239,75,167,242,426,136,17,282,294,1161,PG
1980,22,40,442,72,153,0,2,72,151,54,65,27,27,54,51,12,6,57,58,198,SG
1980,30,16,446,62,146,0,4,62,142,22,27,13,32,45,67,25,1,33,53,146,SF
1980,26,33,225,36,94,2,6,34,88,11,19,11,15,26,20,16,5,17,29,85,SG
1980,28,78,2754,418,895,90,239,328,656,130,162,76,112,188,335,147,25,141,246,1056,PG
1980,22,82,3029,566,1172,28,105,538,1067,500,597,143,186,329,515,114,20,348,262,1660,SG
1980,25,39,1239,289,617,7,19,282,598,254,335,56,118,174,124,39,38,116,106,839,SG
1980,31,62,1834,370,778,22,79,348,699,118,147,132,226,358,109,32,10,98,161,880,PF
1980,23,23,124,23,64,1,7,22,57,8,10,12,22,34,12,4,5,16,20,55,PF
1980,24,75,1159,171,421,4,26,167,395,60,84,33,56,89,116,60,4,65,113,406,SG
1980,29,67,1594,183,394,4,7,179,387,197,252,52,104,156,273,77,1,131,149,567,PG
1980,23,82,2670,430,925,2,12,428,913,143,187,228,399,627,129,107,220,175,237,1005,SF
1980,33,82,2973,327,637,1,2,326,635,139,209,334,760,1094,366,65,61,153,249,794,C
1980,28,82,2399,212,458,7,20,205,438,130,155,103,326,429,247,100,76,158,307,561,SF
1980,25,8,47,6,15,0,0,6,15,3,3,0,4,4,3,1,0,8,13,15,SG
1980,28,76,2422,258,568,1,9,257,559,195,243,78,209,287,607,155,12,157,202,712,PG
1980,25,70,844,139,274,0,0,139,274,48,64,64,106,170,53,21,4,50,102,326,SF
1980,27,14,337,81,161,0,0,81,161,32,54,28,98,126,34,8,38,37,37,194,C
1980,26,76,1243,110,242,1,3,109,239,49,71,33,58,91,285,43,2,112,68,270,PG
1980,28,80,2657,421,761,0,3,421,758,231,360,325,517,842,167,73,131,170,307,1073,PF
1980,24,75,1092,197,421,0,0,197,421,46,76,95,181,276,55,26,48,63,166,440,PF
1980,29,57,1124,164,378,0,0,164,378,63,91,83,125,208,54,34,17,86,136,391,SF
1980,27,20,298,38,79,0,0,38,79,12,16,28,52,80,9,3,11,20,39,88,C
1980,27,68,2347,569,1112,7,22,562,1090,145,181,114,272,386,145,84,45,112,230,1290,SF
1980,29,82,2665,692,1317,26,93,666,1224,382,443,46,141,187,416,119,35,207,162,1792,SG
1980,33,78,2052,336,706,1,6,335,700,97,114,42,139,181,239,88,13,157,186,770,PG
1980,26,9,106,13,24,0,0,13,24,10,13,0,9,9,5,5,0,8,8,36,SG
1980,23,50,553,58,114,0,0,58,114,10,35,56,111,167,24,8,17,36,97,126,C
1980,23,18,225,27,45,0,0,27,45,5,18,29,41,70,6,1,6,8,32,59,C
1980,23,32,328,31,69,0,0,31,69,5,17,27,70,97,18,7,11,28,65,67,C
1980,30,71,2146,210,496,0,1,210,495,83,152,138,271,409,213,76,52,167,241,503,PF
1980,25,75,2381,430,1030,7,34,423,996,166,222,85,231,316,243,93,27,193,194,1033,SF
1980,26,82,3111,726,1358,3,17,723,1341,189,234,176,349,525,250,129,28,157,220,1644,SF
1980,23,77,1794,232,519,0,12,232,507,42,60,21,85,106,183,100,11,107,166,506,PG
1980,23,82,2118,645,1343,42,128,603,1215,194,238,103,89,192,166,72,9,171,145,1526,SG
1980,26,82,2969,739,1533,7,36,732,1497,331,420,127,148,275,397,200,37,181,160,1816,PG
1980,25,82,2582,687,1384,7,37,680,1347,333,423,149,263,412,512,167,24,256,295,1714,PG
1980,22,57,556,104,267,0,4,104,263,58,90,65,56,121,36,19,8,49,73,266,SF
1980,28,58,1374,359,817,11,35,348,782,116,138,38,61,99,126,36,19,92,137,845,SG
1980,28,28,771,206,461,8,19,198,442,76,88,24,30,54,87,26,9,43,71,496,SG
1980,28,30,603,153,356,3,16,150,340,40,50,14,31,45,39,10,10,49,66,349,SG
1980,22,78,1447,219,457,1,9,218,448,96,127,122,207,329,72,32,62,68,189,535,SF
1980,24,16,143,7,25,0,0,7,25,3,6,6,10,16,12,2,0,8,11,17,SG
1980,23,5,59,2,14,0,0,2,14,4,6,2,1,3,11,4,1,8,3,8,SG
1980,27,80,2623,535,1116,38,102,497,1014,184,214,48,175,223,362,101,28,186,208,1292,SG
1980,25,76,1286,229,500,4,16,225,484,96,108,40,82,122,222,49,18,108,144,558,PG
1980,22,8,59,6,21,0,0,6,21,2,2,3,11,14,1,4,3,9,13,14,SF
1981,33,80,2976,836,1457,0,1,836,1456,423,552,197,624,821,272,59,228,249,244,2095,C
1981,26,39,298,25,59,0,1,25,58,13,22,20,28,48,19,7,3,8,34,63,SF
1981,26,10,39,1,3,0,0,1,3,2,3,1,7,8,1,1,0,2,5,4,SF
1981,26,29,259,24,56,0,1,24,55,11,19,19,21,40,18,6,3,6,29,59,SF
1981,26,75,2054,458,870,0,0,458,870,199,259,157,389,546,344,106,69,226,226,1115,C
1981,22,22,276,23,67,0,1,23,66,13,22,19,46,65,25,5,8,23,51,59,PF
1981,32,80,2820,382,766,0,9,382,757,342,419,36,140,176,618,75,18,265,201,1106,PG
1981,32,47,607,44,93,0,0,44,93,14,20,33,75,108,54,12,8,33,85,102,C
1981,23,82,2539,444,889,1,2,443,887,256,361,192,415,607,98,74,143,219,332,1145,PF
1981,26,82,2610,549,1186,7,32,542,1154,166,196,167,413,580,195,118,39,117,194,1271,SF
1981,29,76,2375,431,882,0,6,431,876,199,281,150,277,427,240,80,85,197,284,1061,SF
1981,24,77,1560,439,902,14,54,425,848,170,199,71,86,157,196,82,6,149,120,1062,SG
1981,26,28,313,26,60,0,2,26,58,53,81,33,60,93,15,3,11,31,56,105,PF
1981,26,59,1956,364,770,0,4,364,766,196,254,124,276,400,172,72,67,190,184,924,C
1981,31,73,1112,118,306,32,95,86,211,67,98,25,49,74,200,47,2,76,85,335,PG
1981,24,82,3239,719,1503,20,74,699,1429,283,328,191,704,895,451,161,63,289,239,1741,PF
1981,25,71,2593,710,1306,10,35,700,1271,317,455,119,139,258,233,93,18,173,172,1747,SG
1981,23,3,28,3,10,0,0,3,10,2,8,0,2,2,2,1,0,1,2,8,SG
1981,34,52,1146,160,371,11,39,149,332,75,94,17,67,84,161,33,8,111,126,406,SG
1981,23,44,757,121,313,0,0,121,313,45,55,24,51,75,37,23,16,69,79,287,SG
1981,23,82,1867,265,559,2,16,263,543,125,178,70,123,193,188,186,37,122,236,657,SG
1981,25,80,2595,319,817,57,169,262,648,107,132,66,132,198,452,136,17,162,194,802,PG
1981,29,78,1107,101,197,0,2,101,195,15,40,127,154,281,55,43,58,48,158,217,PF
1981,25,75,1452,275,631,1,7,274,624,91,114,34,52,86,148,61,34,92,95,642,SG
1981,25,29,548,95,246,1,3,94,243,26,34,13,20,33,55,34,9,38,42,217,SG
1981,25,46,904,180,385,0,4,180,381,65,80,21,32,53,93,27,25,54,53,425,SG
1981,27,77,2215,537,1102,3,21,534,1081,213,241,78,211,289,234,88,28,150,182,1290,SF
1981,29,82,2001,271,611,5,18,266,593,166,198,103,327,430,383,63,3,171,190,713,SF
1981,22,2,9,2,3,0,0,2,3,0,0,0,2,2,3,1,0,2,2,4,PG
1981,22,82,2479,488,1018,0,6,488,1012,226,320,210,232,442,208,99,31,163,234,1202,SF
1981,32,78,1986,505,1035,23,64,482,971,173,208,53,122,175,233,88,13,131,141,1206,SG
1981,25,2,5,0,3,0,0,0,3,2,5,1,1,2,0,0,0,1,2,2,C
1981,22,45,580,83,162,0,0,83,162,16,21,52,114,166,21,9,14,31,103,182,C
1981,26,82,2359,379,791,2,15,377,776,193,244,146,294,440,189,72,34,176,264,953,PF
1981,26,82,2384,471,956,1,6,470,950,149,203,88,210,298,384,197,3,236,271,1092,PG
1981,28,31,363,41,99,0,0,41,99,20,41,44,50,94,12,8,19,24,73,102,C
1981,30,58,1095,114,287,19,58,95,229,50,65,19,65,84,140,74,8,38,61,297,SG
1981,24,72,1360,216,451,9,20,207,431,120,157,74,103,177,113,29,17,61,126,561,SF
1981,33,21,128,13,39,1,5,12,34,25,35,2,10,12,28,5,0,17,13,52,PG
1981,32,47,657,87,234,0,7,87,227,34,54,22,39,61,58,15,2,41,53,208,SG
1981,32,8,77,7,28,0,0,7,28,2,4,4,5,9,9,1,0,9,10,16,SG
1981,32,39,580,80,206,0,7,80,199,32,50,18,34,52,49,14,2,32,43,192,SG
1981,25,81,2615,469,918,0,4,469,914,292,409,260,575,835,192,76,42,231,296,1230,PF
1981,30,41,655,97,216,1,14,96,202,53,67,26,57,83,56,30,18,47,74,248,SF
1981,22,82,2919,616,1254,0,2,616,1252,315,440,274,485,759,117,50,121,243,313,1547,C
1981,22,54,672,114,247,3,10,111,237,70,95,34,31,65,52,23,1,50,99,301,SF
1981,23,60,536,59,179,0,3,59,176,51,69,30,39,69,76,22,2,38,68,169,SG
1981,23,82,2925,619,1118,0,1,619,1117,408,518,161,452,613,111,48,83,200,259,1646,C
1981,29,77,1635,134,300,0,0,134,300,59,92,154,319,473,99,33,184,105,284,327,PF
1981,24,81,2415,310,581,3,8,307,573,140,178,67,178,245,560,193,39,174,231,763,PG
1981,30,9,82,11,33,1,3,10,30,6,6,1,7,8,7,0,0,4,10,29,SG
1981,31,82,2562,378,751,0,4,378,747,126,193,180,477,657,153,39,96,159,324,882,PF
1981,26,29,395,35,99,0,2,35,97,24,36,19,22,41,25,11,1,32,35,94,SG
1981,22,81,1845,360,811,0,6,360,805,211,272,129,139,268,190,104,25,174,259,931,SF
1981,22,47,1184,230,530,0,3,230,527,137,162,96,91,187,115,69,11,107,166,597,SF
1981,22,34,661,130,281,0,3,130,278,74,110,33,48,81,75,35,14,67,93,334,SF
1981,29,12,329,62,126,0,0,62,126,24,29,6,23,29,42,7,4,22,23,148,SG
1981,22,81,1980,383,819,6,25,377,794,132,180,96,140,236,297,141,36,176,197,904,SG
1981,24,79,2192,286,616,0,5,286,611,100,155,170,297,467,201,82,54,146,236,672,SF
1981,24,81,2625,321,654,4,19,317,635,117,149,121,215,336,332,133,78,164,249,763,SG
1981,24,71,1420,213,471,1,3,212,468,62,90,166,274,440,52,18,51,77,219,489,C
1981,24,82,1960,366,747,0,3,366,744,125,175,228,408,636,117,42,99,131,212,857,C
1981,32,66,1708,220,485,1,21,219,464,185,214,26,74,100,283,61,3,134,87,626,PG
1981,25,6,33,4,8,0,0,4,8,1,5,7,11,18,2,0,2,5,4,9,C
1981,24,74,1084,248,460,0,2,248,458,99,140,97,195,292,62,31,19,114,192,595,C
1981,23,52,528,93,205,0,1,93,204,33,64,51,104,155,25,20,23,29,68,219,C
1981,33,23,545,101,237,0,1,101,236,28,39,19,64,83,60,16,9,33,54,230,SF
1981,24,80,3417,909,1627,2,7,907,1620,632,784,192,317,509,322,109,18,282,245,2452,SF
1981,25,56,1686,230,410,3,17,227,393,163,204,29,122,151,385,52,11,123,156,626,PG
1981,25,76,2536,426,917,4,33,422,884,238,299,56,114,170,480,95,14,167,179,1094,PG
1981,22,2,10,1,5,0,0,1,5,1,5,2,2,4,0,0,1,0,0,3,PF
1981,22,1,2,1,1,0,0,1,1,0,0,0,1,1,0,0,0,0,0,2,PF
1981,22,1,8,0,4,0,0,0,4,1,5,2,1,3,0,0,1,0,0,1,PF
1981,26,64,817,139,314,2,8,137,306,94,158,47,72,119,47,36,11,61,98,374,SF
1981,26,78,2182,593,1101,7,17,586,1084,209,250,63,137,200,302,97,12,222,192,1402,SG
1981,24,76,2088,423,697,0,0,423,697,219,304,106,439,545,109,38,112,220,316,1065,C
1981,23,76,964,128,254,0,2,128,252,58,92,114,129,243,28,12,13,58,153,314,PF
1981,32,82,1243,146,320,2,6,144,314,77,111,79,186,265,118,48,53,88,176,371,C
1981,23,68,980,129,238,0,0,129,238,101,170,107,202,309,42,8,74,68,79,359,C
1981,26,29,253,20,70,0,0,20,70,13,25,23,65,88,9,9,1,14,47,53,SF
1981,26,79,1356,185,323,0,3,185,320,102,186,150,234,384,69,25,38,90,251,472,C
1981,26,67,2075,500,1096,0,7,500,1089,454,577,145,238,383,79,98,15,194,264,1454,SF
1981,22,76,1581,197,484,4,17,193,467,106,133,24,96,120,249,88,7,166,125,504,PG
1981,26,6,67,7,14,0,0,7,14,1,4,5,14,19,14,1,2,13,16,15,C
1981,24,18,337,74,161,2,6,72,155,18,27,15,24,39,30,12,4,25,19,168,SF
1981,24,32,114,30,73,6,10,24,63,13,14,2,3,5,6,5,0,10,8,79,SG
1981,26,74,1609,310,632,1,16,309,616,156,186,28,90,118,268,64,2,137,165,777,SG
1981,25,82,1427,146,354,0,2,146,352,79,121,133,168,301,81,66,29,56,141,371,SG
1981,22,40,458,33,101,0,1,33,100,5,9,8,27,35,54,18,2,37,54,71,PG
1981,25,81,2375,511,1004,0,3,511,1001,244,347,191,380,571,212,32,128,164,304,1266,C
1981,25,73,1320,214,419,1,2,213,417,121,202,104,157,261,129,34,16,119,175,550,C
1981,28,72,925,76,212,0,0,76,212,54,75,68,140,208,69,37,52,44,178,206,C
1981,27,81,3093,768,1555,3,5,765,1550,390,459,273,373,646,290,106,100,241,255,1929,SF
1981,30,82,2874,794,1524,4,18,790,1506,422,536,244,413,657,364,173,147,266,233,2014,SF
1981,25,71,911,134,291,2,14,132,277,50,64,22,65,87,167,34,4,72,114,320,PG
1981,27,45,279,38,79,0,0,38,79,20,30,29,33,62,10,6,7,20,29,96,C
1981,32,82,2723,314,707,36,109,278,598,64,87,72,91,163,295,100,23,127,212,728,SG
1981,28,64,996,100,224,0,3,100,221,22,24,74,90,164,84,15,12,49,100,222,SF
1981,24,66,2287,424,887,11,36,413,851,294,354,26,102,128,580,99,6,241,190,1153,PG
1981,27,65,2370,516,1157,5,31,511,1126,528,649,48,111,159,361,85,11,195,183,1565,SG
1981,22,15,248,24,66,0,1,24,65,12,16,13,29,42,28,10,1,23,25,60,SG
1981,30,77,1112,157,309,2,7,155,302,55,68,16,83,99,169,94,7,77,117,371,PG
1981,30,35,636,86,164,1,3,85,161,19,26,7,45,52,99,55,2,39,56,192,PG
1981,30,42,476,71,145,1,4,70,141,36,42,9,38,47,70,39,5,38,61,179,PG
1981,24,70,1638,188,415,1,3,187,412,50,62,85,179,264,132,50,10,90,167,427,SF
1981,27,27,252,41,111,0,4,41,107,27,40,30,37,67,15,10,9,15,41,109,SF
1981,27,16,123,19,51,0,3,19,48,19,29,13,16,29,6,3,6,7,24,57,SF
1981,27,11,129,22,60,0,1,22,59,8,11,17,21,38,9,7,3,8,17,52,SF
1981,28,82,2765,850,1729,9,35,841,1694,512,620,126,293,419,260,94,56,251,212,2221,SG
1981,31,82,2832,547,816,0,0,547,816,375,532,220,608,828,172,47,198,236,295,1469,C
1981,25,82,1506,285,511,4,11,281,500,98,110,27,61,88,108,72,5,62,126,672,PG
1981,21,56,1579,291,688,0,1,291,687,155,202,137,282,419,72,54,100,128,127,737,C
1981,25,73,1077,155,329,0,2,155,327,112,137,136,171,307,83,91,20,69,185,422,PF
1981,26,47,1307,176,366,0,1,176,365,70,97,30,86,116,235,75,1,83,123,422,PG
1981,23,82,2710,481,989,0,2,481,987,217,290,243,481,724,218,77,124,192,282,1179,PF
1981,27,75,2616,500,1103,45,136,455,967,244,290,67,152,219,300,68,17,144,161,1289,SG
1981,27,82,1930,166,325,0,0,166,325,170,253,184,321,505,249,77,38,132,207,502,PF
1981,22,81,2867,716,1544,10,52,706,1492,229,320,79,209,288,194,106,40,231,219,1671,SG
1981,27,82,1934,253,479,0,9,253,470,135,159,126,202,328,251,90,67,151,238,641,SF
1981,25,79,1584,260,486,0,0,260,486,75,101,31,175,206,205,60,15,88,155,595,SF
1981,23,1,5,1,3,0,0,1,3,1,2,2,1,3,0,0,0,1,1,3,PG
1981,23,74,1259,138,289,1,5,137,284,119,150,67,86,153,111,58,20,84,168,396,SF
1981,23,22,111,22,59,0,0,22,59,7,10,8,11,19,3,1,9,11,13,51,SG
1981,24,23,509,52,111,0,0,52,111,11,20,39,94,133,36,21,20,23,58,115,PF
1981,23,55,461,56,136,0,3,56,133,37,85,28,65,93,17,23,20,32,73,149,PF
1981,25,41,714,143,340,53,156,90,184,17,21,24,44,68,74,13,2,22,65,356,SG
1981,25,17,280,59,142,10,40,49,102,10,13,11,14,25,18,5,0,11,21,138,SG
1981,25,24,434,84,198,43,116,41,82,7,8,13,30,43,56,8,2,11,44,218,SG
1981,30,74,2309,333,637,1,4,332,633,222,278,165,396,561,168,73,32,161,289,889,C
1981,35,81,2931,584,1296,0,10,584,1286,271,439,235,554,789,98,68,171,189,300,1439,PF
1981,32,78,1631,149,396,0,7,149,389,79,101,120,228,348,122,104,72,81,196,377,PF
1981,25,82,1608,261,579,1,16,260,563,113,157,43,89,132,213,79,12,160,177,636,PG
1981,29,66,1411,137,332,0,3,137,329,78,95,30,74,104,307,53,4,93,111,352,SG
1981,24,80,2270,432,954,2,11,430,943,228,267,98,113,211,148,91,26,153,154,1094,SG
1981,26,72,1689,209,474,4,34,205,440,140,172,24,121,145,408,101,6,166,243,562,PG
1981,23,81,1750,246,576,2,24,244,552,183,264,89,139,228,202,129,26,188,251,677,PG
1981,27,75,1738,117,335,0,7,117,328,141,172,41,118,159,292,66,11,127,207,375,PG
1981,27,24,624,39,116,0,1,39,115,42,50,10,41,51,118,26,3,58,60,120,PG
1981,27,51,1114,78,219,0,6,78,213,99,122,31,77,108,174,40,8,69,147,255,PG
1981,24,41,295,47,111,1,3,46,108,35,49,9,20,29,23,21,1,31,44,130,SG
1981,27,82,2154,327,696,2,15,325,681,125,171,47,144,191,352,104,18,207,205,781,PG
1981,24,68,1599,221,480,0,3,221,477,130,186,120,338,458,104,33,19,120,226,572,PF
1981,24,80,2289,433,880,1,3,432,877,294,426,236,350,586,150,80,20,229,317,1161,PF
1981,28,53,490,27,70,0,0,27,70,1,2,48,79,127,35,28,35,44,106,55,C
1981,28,8,159,11,25,0,0,11,25,1,2,19,31,50,11,11,14,11,33,23,C
1981,28,45,331,16,45,0,0,16,45,0,0,29,48,77,24,17,21,33,73,32,C
1981,23,81,2434,461,942,1,5,460,937,150,212,45,93,138,394,58,7,179,148,1073,PG
1981,23,56,1892,385,789,1,4,384,785,128,185,33,66,99,277,45,6,148,113,899,PG
1981,23,25,542,76,153,0,1,76,152,22,27,12,27,39,117,13,1,31,35,174,PG
1981,32,80,2641,614,1220,2,12,612,1208,519,684,229,447,676,158,83,53,130,249,1749,C
1981,23,2,14,1,3,0,0,1,3,0,0,0,2,2,2,2,0,0,1,2,PG
1981,26,66,1108,187,440,0,1,187,439,179,220,83,147,230,65,44,31,87,123,553,SF
1981,24,81,1643,235,466,0,1,235,465,112,189,173,295,468,144,44,119,121,185,582,C
1981,26,79,2615,532,1220,11,51,521,1169,411,501,160,203,363,291,136,61,208,244,1486,PG
1981,25,75,2693,573,1136,6,20,567,1116,279,356,60,119,179,407,126,11,197,188,1431,SG
1981,32,82,1935,164,347,0,0,164,347,80,109,215,387,602,92,47,278,110,273,408,C
1981,24,43,930,182,394,0,5,182,389,93,122,99,179,278,86,47,23,85,120,457,PF
1981,33,80,2324,373,866,0,1,373,865,173,214,135,227,362,312,57,25,230,202,919,SF
1981,23,12,90,7,25,0,0,7,25,3,5,6,16,22,1,0,5,7,18,17,PF
1981,23,10,80,7,23,0,0,7,23,3,5,6,14,20,1,0,5,7,17,17,PF
1981,23,2,10,0,2,0,0,0,2,0,0,0,2,2,0,0,0,0,1,0,PF
1981,21,37,1371,312,587,3,17,309,570,171,225,101,219,320,317,127,27,143,100,798,SG
1981,24,76,2542,636,1153,0,9,636,1144,269,381,225,293,518,346,115,41,190,196,1541,SF
1981,28,82,2118,379,846,3,18,376,828,262,332,183,362,545,286,94,71,230,256,1023,PF
1981,31,40,372,87,158,1,6,86,152,27,31,8,47,55,30,20,2,25,45,202,SF
1981,23,79,1716,340,682,0,1,340,681,128,193,132,226,358,78,45,48,130,283,808,PF
1981,24,81,2311,419,785,1,5,418,780,214,270,193,173,366,341,78,20,216,198,1053,PG
1981,29,81,2046,407,755,0,3,407,752,282,347,142,293,435,226,95,74,149,226,1096,PF
1981,30,81,2639,218,485,0,0,218,485,148,193,200,613,813,122,53,134,168,271,584,C
1981,28,81,1574,245,507,0,0,245,507,125,161,127,274,401,99,40,36,126,200,615,PF
1981,24,60,950,189,357,0,4,189,353,146,218,92,171,263,43,36,81,101,185,524,PF
1981,27,68,1003,117,252,0,1,117,251,64,101,96,138,234,41,18,23,57,112,298,PF
1981,26,74,1226,150,352,6,22,144,330,87,127,30,68,98,241,98,8,143,165,393,PG
1981,26,14,239,30,73,3,10,27,63,24,32,5,13,18,46,24,1,23,29,87,PG
1981,26,60,987,120,279,3,12,117,267,63,95,25,55,80,195,74,7,120,136,306,PG
1981,24,30,207,29,75,0,0,29,75,10,17,23,19,42,11,11,5,17,35,68,SF
1981,24,62,666,92,216,9,28,83,188,45,51,29,64,93,59,16,2,30,84,238,SF
1981,21,16,199,37,81,0,1,37,80,43,62,28,39,67,5,6,1,16,44,117,PF
1981,27,81,1686,196,387,0,2,196,385,175,231,131,310,441,282,79,63,209,210,567,C
1981,23,25,654,120,285,0,2,120,283,68,106,53,67,120,45,34,29,78,89,308,SF
1981,28,77,2161,454,946,0,0,454,946,180,245,179,219,398,120,75,18,161,160,1088,SF
1981,22,41,353,52,141,0,0,52,141,14,18,7,26,33,45,11,6,30,33,118,SG
1981,22,29,247,38,96,0,0,38,96,4,5,7,17,24,35,9,5,22,24,80,SG
1981,22,12,106,14,45,0,0,14,45,10,13,0,9,9,10,2,1,8,9,38,SG
1981,24,81,2914,731,1244,2,6,729,1238,307,437,178,373,551,287,72,34,265,304,1771,SF
1981,23,81,2743,472,867,0,0,472,867,264,386,235,551,786,122,102,41,164,227,1208,PF
1981,28,82,2385,546,1025,3,19,543,1006,341,410,191,219,410,157,84,12,177,155,1436,SG
1981,25,82,1065,136,258,0,1,136,257,63,91,77,155,232,88,35,17,67,132,335,PF
1981,24,25,100,11,47,1,4,10,43,7,10,2,10,12,9,2,1,10,20,30,SG
1981,29,55,842,101,216,0,0,101,216,42,54,98,189,287,67,17,32,50,143,244,C
1981,26,82,1934,392,747,0,1,392,746,240,340,198,371,569,62,36,26,161,195,1024,PF
1981,32,82,2228,237,536,1,5,236,531,92,117,131,453,584,399,95,120,182,302,567,C
1981,25,82,2670,417,888,0,0,417,888,288,444,177,488,665,237,35,45,206,293,1122,C
1981,23,81,2460,337,670,0,0,337,670,117,153,266,427,693,216,56,78,132,332,791,C
1981,28,46,483,68,165,0,2,68,163,18,23,28,65,93,27,12,5,19,76,154,PF
1981,28,3,8,3,5,0,0,3,5,0,0,1,2,3,3,0,0,2,2,6,PF
1981,28,43,475,65,160,0,2,65,158,18,23,27,63,90,24,12,5,17,74,148,PF
1981,25,69,1086,164,327,0,1,164,326,62,116,152,225,377,27,19,6,65,135,390,PF
1981,32,67,1753,376,716,1,1,375,715,208,277,128,285,413,179,73,81,139,184,961,C
1981,28,3,19,5,8,0,0,5,8,2,4,2,2,4,1,1,0,1,6,12,C
1981,23,79,1686,258,548,2,17,256,531,124,149,30,104,134,384,97,15,189,160,642,PG
1981,28,82,1829,113,323,2,13,111,310,113,156,65,155,220,362,166,29,173,260,341,PG
1981,22,8,83,10,24,0,0,10,24,10,11,3,3,6,7,2,0,9,5,30,PG
1981,28,72,2186,245,547,0,2,245,545,147,205,161,293,454,159,34,25,145,269,637,C
1981,24,59,1750,441,957,2,11,439,946,160,184,95,102,197,106,95,22,151,164,1044,SG
1981,27,66,1919,222,506,4,24,218,482,107,145,34,120,154,464,83,2,185,140,555,PG
1981,28,68,2162,404,835,0,2,404,833,191,254,153,422,575,173,57,59,176,260,999,PF
1981,23,65,1682,279,606,0,9,279,597,80,125,92,138,230,163,56,7,70,117,638,SG
1981,23,3,16,1,6,0,0,1,6,1,2,0,1,1,1,1,0,0,3,3,SG
1981,23,62,1666,278,600,0,9,278,591,79,123,92,137,229,162,55,7,70,114,635,SG
1981,23,82,1469,272,532,12,51,260,481,107,119,44,88,132,160,76,5,95,120,663,PG
1981,22,52,696,111,219,0,0,111,219,27,40,67,148,215,25,21,44,38,134,249,PF
1981,25,80,3245,806,1545,1,3,805,1542,609,804,474,706,1180,141,83,150,308,223,2222,C
1981,21,79,2266,385,779,5,21,380,758,202,252,46,93,139,411,107,17,261,242,977,PG
1981,21,45,1161,224,449,5,15,219,434,99,129,30,37,67,199,46,10,149,120,552,PG
1981,21,34,1105,161,330,0,6,161,324,103,123,16,56,72,212,61,7,112,122,425,PG
1981,25,81,2730,441,750,0,1,441,749,352,450,222,303,525,219,79,68,180,256,1234,SF
1981,26,63,815,165,338,0,0,165,338,113,149,62,93,155,63,35,7,71,83,443,SF
1981,23,7,54,8,18,0,0,8,18,1,2,7,2,9,1,0,1,3,8,17,SF
1981,29,16,321,68,157,0,1,68,156,29,41,17,50,67,30,17,13,32,38,165,PF
1981,29,6,168,30,82,0,0,30,82,12,20,9,32,41,20,8,7,18,16,72,PF
1981,29,10,153,38,75,0,1,38,74,17,21,8,18,26,10,9,6,14,22,93,PF
1981,27,43,448,51,135,2,8,49,127,18,24,16,23,39,73,14,0,24,36,122,PG
1981,23,2,9,2,4,0,0,2,4,0,0,1,1,2,1,0,0,2,0,4,SG
1981,27,54,680,78,202,1,8,77,194,48,59,10,38,48,84,20,9,79,62,205,PG
1981,30,69,1845,348,768,0,7,348,761,207,385,164,364,528,210,99,28,221,242,903,PF
1981,23,82,1645,355,666,0,2,355,664,108,159,155,204,359,55,27,151,110,260,818,PF
1981,25,84,2166,327,645,2,12,325,633,162,188,36,148,184,360,99,11,158,231,818,PG
1981,25,35,1032,124,233,1,2,123,231,44,48,12,62,74,157,38,4,70,107,293,PG
1981,25,49,1134,203,412,1,10,202,402,118,140,24,86,110,203,61,7,88,124,525,PG
1981,28,79,1564,253,519,1,6,252,513,80,108,96,199,295,72,23,25,81,165,587,C
1981,31,2,11,0,4,0,0,0,4,0,0,0,0,0,2,0,0,0,0,0,SG
1981,27,74,1514,206,415,0,0,206,415,148,213,126,267,393,77,27,80,125,219,560,C
1981,22,8,53,4,9,0,1,4,8,0,0,2,5,7,5,4,0,8,5,8,SF
1981,22,5,34,2,6,0,1,2,5,0,0,1,3,4,4,3,0,4,2,4,SF
1981,22,3,19,2,3,0,0,2,3,0,0,1,2,3,1,1,0,4,3,4,SF
1981,25,82,3194,853,1791,4,9,849,1782,302,385,215,287,502,139,63,52,175,199,2012,SF
1981,33,72,1327,288,575,0,3,288,572,200,240,105,159,264,114,59,18,88,107,776,SF
1981,24,80,1815,224,458,0,1,224,457,120,200,141,277,418,135,38,73,160,267,568,C
1981,23,80,2417,400,739,2,9,398,730,320,398,186,220,406,264,90,37,145,156,1122,SG
1981,22,82,1578,249,520,1,19,248,501,105,172,58,138,196,373,120,22,154,178,604,PG
1981,23,71,1406,212,478,4,27,208,451,69,92,43,125,168,228,61,17,108,179,497,PG
1981,32,76,2014,528,1074,4,17,524,1057,206,215,33,54,87,222,111,6,129,209,1266,PG
1981,31,82,2809,517,935,0,0,517,935,244,307,295,722,1017,199,49,46,211,295,1278,C
1981,24,74,2111,395,794,4,8,391,786,200,283,149,282,431,159,73,18,163,188,994,SF
1981,22,19,149,25,77,2,8,23,69,7,11,9,6,15,10,5,1,10,18,59,SG
1981,32,79,2911,632,1272,10,30,622,1242,414,466,78,141,219,299,87,9,248,237,1688,SG
1981,22,67,1109,172,359,0,4,172,355,71,126,37,73,110,149,60,3,116,141,415,PG
1981,22,27,493,65,149,0,1,65,148,35,59,13,36,49,80,28,2,63,52,165,PG
1981,22,40,616,107,210,0,3,107,207,36,67,24,37,61,69,32,1,53,89,250,PG
1981,25,44,231,48,138,2,4,46,134,17,37,26,32,58,15,8,1,25,41,115,SF
1981,25,79,2962,576,1210,2,12,574,1198,196,252,64,168,232,696,146,11,285,226,1350,PG
1981,22,79,2473,365,751,5,18,360,733,135,212,179,299,478,252,86,27,146,243,870,SF
1981,24,82,2408,348,685,1,7,347,678,315,380,146,325,471,277,75,31,202,307,1012,SF
1981,23,4,21,2,6,0,0,2,6,0,0,3,2,5,0,0,2,2,3,4,C
1981,22,82,1787,348,709,0,6,348,703,163,202,172,189,361,132,55,25,123,153,859,SF
1981,31,79,1843,322,630,0,4,322,626,191,250,165,291,456,140,36,47,130,273,835,PF
1981,27,82,2298,635,1166,0,1,635,1165,282,397,245,532,777,144,81,214,191,310,1552,C
1981,25,73,1317,191,388,0,0,191,388,94,128,101,93,194,106,67,13,84,112,476,SG
1981,26,3,9,2,5,0,0,2,5,1,2,1,1,2,1,0,0,1,3,5,SF
1981,32,81,1659,262,517,0,3,262,514,75,153,111,280,391,105,28,72,89,182,599,PF
1981,23,79,2701,585,1092,2,30,583,1062,182,248,74,137,211,299,140,9,131,172,1354,SG
1981,29,77,1472,186,380,0,1,186,379,81,116,122,234,356,48,50,92,99,228,453,PF
1981,24,82,2269,474,965,8,28,466,937,224,267,90,156,246,184,65,15,165,262,1180,SG
1981,24,42,461,57,138,19,48,38,90,11,14,13,29,42,77,15,2,22,28,144,SG
1981,24,6,30,2,5,0,0,2,5,0,0,0,1,1,2,0,0,5,2,4,SG
1981,24,36,431,55,133,19,48,36,85,11,14,13,28,41,75,15,2,17,26,140,SG
1981,25,82,2808,324,614,3,6,321,608,126,162,160,469,629,161,67,174,122,342,777,PF
1981,30,81,2577,446,859,3,12,443,847,191,247,35,89,124,734,110,10,251,257,1086,PG
1981,24,5,29,2,7,0,0,2,7,0,0,0,0,0,3,2,1,2,3,4,SG
1981,22,25,153,21,57,0,0,21,57,13,28,17,13,30,17,7,1,26,33,55,SF
1981,22,80,2431,525,1162,3,31,522,1131,164,219,42,153,195,555,88,9,232,201,1217,PG
1981,32,66,838,64,152,0,0,64,152,29,62,73,144,217,52,24,13,74,194,157,C
1981,23,18,148,15,49,0,1,15,48,7,10,13,24,37,11,4,4,13,31,37,PF
1981,23,59,597,84,185,0,5,84,180,22,39,27,33,60,71,33,5,78,111,190,SG
1981,25,82,2963,536,1113,0,4,536,1109,229,303,164,419,583,344,163,66,198,325,1301,SF
1981,29,64,999,192,369,3,8,189,361,62,88,71,103,174,81,16,14,68,103,449,SF
1981,24,77,1313,227,464,0,1,227,463,84,108,83,93,176,152,36,10,110,102,538,SG
1981,25,79,3175,523,1116,23,102,500,1014,224,338,173,372,545,627,232,35,302,258,1293,SG
1981,25,26,350,54,144,0,0,54,144,19,29,18,50,68,20,11,0,28,52,127,SF
1981,25,82,1569,298,547,0,1,298,546,144,251,132,258,390,126,38,19,141,204,740,C
1981,20,63,1822,525,1070,1,1,524,1069,178,248,120,361,481,105,58,52,182,216,1229,PF
1981,29,82,3088,647,1280,0,0,647,1280,249,396,216,573,789,206,68,38,250,220,1543,PF
1981,22,81,1592,234,509,0,6,234,503,175,240,117,177,294,112,46,24,149,186,643,PF
1981,28,78,2016,392,826,1,6,391,820,218,281,168,365,533,118,75,9,187,275,1003,PF
1981,28,8,84,14,32,0,0,14,32,5,8,4,9,13,5,4,0,10,19,33,PF
1981,28,70,1932,378,794,1,6,377,788,213,273,164,356,520,113,71,9,177,256,970,PF
1981,31,84,2116,330,740,0,0,330,740,200,247,157,342,499,173,37,34,83,173,860,C
1981,31,11,372,37,98,0,0,37,98,29,36,27,58,85,44,7,6,14,21,103,C
1981,31,73,1744,293,642,0,0,293,642,171,211,130,284,414,129,30,28,69,152,757,C
1981,31,26,611,82,179,9,27,73,152,58,77,5,32,37,140,17,8,52,44,231,PG
1981,25,40,1044,116,210,0,1,116,209,46,57,102,184,286,35,29,117,57,151,278,C
1981,22,53,726,87,211,2,6,85,205,43,63,10,46,56,136,27,3,52,64,219,PG
1981,27,63,2128,426,808,0,1,426,807,256,355,231,403,634,161,76,119,178,258,1108,PF
1981,29,79,2865,508,1095,8,26,500,1069,268,343,109,244,353,257,99,8,212,248,1292,SF
1981,24,23,186,34,77,0,0,34,77,20,22,6,15,21,17,16,1,21,20,88,SF
1981,22,44,484,94,225,1,6,93,219,26,39,47,85,132,10,12,4,30,54,215,PF
1981,25,82,1423,173,348,1,6,172,342,97,127,101,167,268,114,60,70,77,124,444,SF
1981,23,55,586,100,219,0,1,100,218,35,58,59,79,138,27,18,5,61,128,235,SF
1981,25,14,440,73,174,0,0,73,174,36,55,31,47,78,35,22,3,41,48,182,PF
1981,23,79,2309,549,1157,3,17,546,1140,168,205,151,240,391,249,78,19,143,244,1269,SF
1981,28,24,527,56,131,0,0,56,131,55,76,34,54,88,24,21,9,42,49,167,PF
1981,28,22,519,56,128,0,0,56,128,53,73,33,54,87,24,21,9,41,46,165,PF
1981,28,2,8,0,3,0,0,0,3,2,3,1,0,1,0,0,0,1,3,2,PF
1981,24,47,450,34,95,0,5,34,90,25,32,11,32,43,70,23,1,28,38,93,PG
1981,25,82,2920,595,1311,0,5,595,1306,340,413,184,668,852,248,78,93,201,282,1530,C
1981,31,75,2055,476,997,0,2,476,995,374,440,44,187,231,285,51,12,159,129,1326,PG
1981,23,82,2578,304,594,0,0,304,594,177,301,433,561,994,93,70,63,146,316,785,PF
1981,28,76,2378,519,1057,4,18,515,1039,237,313,49,107,156,372,84,18,176,231,1279,SG
1981,32,82,2199,486,1043,1,28,485,1015,221,271,46,147,193,357,113,14,195,132,1194,SG
1981,25,1,20,2,5,0,0,2,5,4,4,1,2,3,3,0,0,3,6,8,PG
1981,28,71,1803,355,769,17,66,338,703,231,247,46,98,144,284,98,17,206,225,958,PG
1981,23,82,2317,404,866,1,10,403,856,375,423,142,155,297,232,117,20,172,230,1184,SF
1981,22,15,212,22,63,0,0,22,63,12,16,7,11,18,32,13,3,18,15,56,PG
1981,23,9,88,11,34,0,0,11,34,3,4,7,6,13,9,1,0,4,7,25,SF
1981,29,80,2312,310,591,44,115,266,476,146,185,58,93,151,440,118,23,111,212,810,PG
1981,24,26,504,80,160,0,6,80,154,28,42,43,73,116,70,27,13,57,68,188,SG
1981,23,82,2820,543,1097,18,90,525,1007,445,550,124,163,287,426,122,20,259,258,1549,SG
1981,26,77,2620,734,1451,10,39,724,1412,489,615,107,180,287,231,53,60,250,231,1967,SG
1981,26,79,2790,569,1151,0,1,569,1150,207,323,223,463,686,284,62,170,241,260,1345,C
1981,32,52,1264,263,563,12,51,251,512,65,82,78,130,208,81,19,6,58,121,603,PF
1981,23,75,1768,399,806,9,29,390,777,161,226,32,111,143,273,59,10,219,234,968,SG
1981,24,82,2549,476,895,0,8,476,887,148,250,198,369,567,136,112,180,163,215,1100,SF
1981,34,63,2032,225,429,2,4,223,425,55,86,207,466,673,170,52,36,97,171,507,C
1981,23,24,123,37,98,1,2,36,96,9,19,10,20,30,7,7,4,16,23,84,SF
1981,29,78,1426,100,245,2,8,98,237,98,117,48,154,202,129,38,50,108,214,300,SF
1981,22,51,1376,229,537,0,7,229,530,130,159,86,184,270,94,29,24,86,116,588,SF
1981,25,11,93,10,27,0,1,10,26,14,19,7,18,25,9,5,5,9,26,34,C
1981,29,41,1172,72,169,2,9,70,160,88,111,22,80,102,253,52,1,85,105,234,PG
1981,26,82,1796,290,626,0,3,290,623,109,169,105,210,315,122,53,15,115,168,689,SF
1981,27,61,821,90,218,0,1,90,217,26,33,13,35,48,208,32,2,80,45,206,PG
1981,29,73,2120,325,571,0,1,325,570,181,288,236,450,686,149,85,86,144,258,831,PF
1981,25,80,1812,340,747,1,2,339,745,119,159,158,295,453,129,46,61,129,283,800,PF
1981,25,11,307,51,117,0,0,51,117,17,23,25,59,84,16,5,7,21,37,119,PF
1981,25,69,1505,289,630,1,2,288,628,102,136,133,236,369,113,41,54,108,246,681,PF
1981,28,82,1708,159,341,1,4,158,337,104,163,162,303,465,72,27,97,103,187,423,C
1981,28,81,2902,685,1437,25,77,660,1360,140,204,128,305,433,226,97,46,161,294,1535,SF
1981,30,36,1078,221,500,6,25,215,475,153,184,11,57,68,148,46,14,78,70,601,SG
1981,34,13,236,36,82,0,0,36,82,11,18,3,18,21,37,11,1,18,21,83,PG
1981,27,16,208,23,65,0,1,23,64,15,16,1,10,11,20,9,1,12,23,61,SG
1981,27,4,43,9,18,0,0,9,18,4,4,0,0,0,2,4,0,3,7,22,SG
1981,27,12,165,14,47,0,1,14,46,11,12,1,10,11,18,5,1,9,16,39,SG
1981,24,48,688,83,180,0,1,83,179,28,56,58,156,214,26,20,9,56,122,194,C
1981,24,7,118,16,38,0,0,16,38,5,11,8,20,28,2,4,1,11,16,37,C
1981,24,3,8,1,3,0,0,1,3,0,0,2,1,3,0,1,0,0,6,2,C
1981,24,38,562,66,139,0,1,66,138,23,45,48,135,183,24,15,8,45,100,155,C
1981,23,47,782,149,306,2,6,147,300,50,65,29,77,106,68,47,6,48,98,350,SG
1981,31,49,1083,125,286,0,1,125,285,76,150,79,144,223,111,40,40,94,168,326,PF
1981,23,33,271,76,138,0,2,76,136,36,48,22,42,64,11,8,6,28,38,188,PF
1981,26,80,2238,330,715,1,10,329,705,137,163,86,196,282,272,102,23,175,170,798,SG
1981,27,81,3028,786,1495,1,13,785,1482,254,335,146,289,435,235,121,29,207,223,1827,SF
1981,22,48,540,85,184,0,1,85,183,29,42,36,60,96,30,25,12,34,86,199,SF
1981,25,56,1058,117,260,0,0,117,260,27,40,62,212,274,40,32,46,59,169,261,C
1981,24,82,1976,642,1381,48,141,594,1240,253,297,75,54,129,164,91,5,166,157,1585,SG
1981,26,79,2742,616,1335,16,68,600,1267,312,382,122,199,321,432,185,37,235,270,1560,PG
1981,23,67,1976,349,708,2,8,347,700,185,268,159,257,416,180,116,18,141,199,885,PF
1981,29,9,112,18,56,1,6,17,50,5,6,0,7,7,17,4,1,12,13,42,SG
1981,23,55,1145,150,287,0,0,150,287,49,64,74,153,227,64,18,31,74,102,349,SF
1981,28,69,1771,331,697,18,51,313,646,119,137,32,108,140,229,70,10,136,185,799,SG
1981,22,81,949,165,373,1,5,164,368,49,64,33,64,97,75,36,12,54,95,380,SG
1981,23,64,945,95,192,0,4,95,188,45,60,22,93,115,115,57,6,91,115,235,PG
1981,26,45,997,140,303,2,7,138,296,53,66,26,62,88,153,42,7,74,114,335,PG
1982,34,76,2677,753,1301,0,3,753,1298,312,442,172,487,659,225,63,207,230,224,1818,C
1982,27,79,2393,507,1027,0,1,507,1026,182,233,138,448,586,356,114,78,196,269,1196,C
1982,22,51,1468,381,820,25,71,356,749,168,247,89,160,249,164,37,22,135,152,955,SF
1982,22,53,564,79,221,5,17,74,204,56,65,25,31,56,87,37,3,53,86,219,SG
1982,33,68,2167,308,652,6,16,302,636,236,316,25,91,116,541,52,3,178,131,858,PG
1982,33,10,121,5,15,0,0,5,15,5,9,7,7,14,8,1,2,6,28,15,C
1982,23,1,7,1,1,0,0,1,1,0,0,0,0,0,0,0,0,2,2,2,C
1982,24,77,1468,261,505,0,0,261,505,137,224,127,264,391,65,42,83,139,270,659,PF
1982,24,10,180,31,65,0,0,31,65,4,11,17,31,48,13,3,7,19,42,66,PF
1982,24,67,1288,230,440,0,0,230,440,133,213,110,233,343,52,39,76,120,228,593,PF
1982,27,79,2946,621,1307,9,22,612,1285,235,283,136,497,633,250,137,22,119,204,1486,SF
1982,22,80,1700,311,652,0,8,311,644,145,212,157,254,411,147,55,17,106,199,767,SF
1982,30,82,2016,334,712,2,6,332,706,168,267,174,266,440,114,63,61,149,272,838,SF
1982,30,39,1037,178,406,1,3,177,403,101,153,87,127,214,68,38,24,85,139,458,SF
1982,30,43,979,156,306,1,3,155,303,67,114,87,139,226,46,25,37,64,133,380,SF
1982,25,75,1229,327,692,12,41,315,651,166,211,53,55,108,111,41,5,93,100,832,SG
1982,27,3,23,2,4,0,0,2,4,1,6,1,2,3,0,1,0,4,2,5,PF
1982,27,75,2467,405,802,3,11,402,791,127,158,219,434,653,159,66,98,160,214,940,C
1982,25,77,2923,711,1414,11,52,700,1362,328,380,200,637,837,447,143,66,254,244,1761,PF
1982,26,37,1025,225,480,0,10,225,470,74,127,30,67,97,124,30,5,64,74,524,SG
1982,22,82,1979,439,855,1,4,438,851,212,276,97,157,254,105,46,30,113,122,1091,SG
1982,23,49,546,102,222,4,18,98,204,18,28,14,27,41,68,23,2,54,57,226,SG
1982,22,39,331,54,103,0,1,54,102,29,48,31,34,65,11,12,5,28,37,137,SF
1982,22,51,339,55,122,0,1,55,121,42,62,12,26,38,22,14,6,37,61,152,SG
1982,24,64,937,125,281,1,4,124,277,74,100,30,57,87,80,78,10,71,115,325,SG
1982,23,10,176,21,52,0,0,21,52,11,12,14,19,33,6,5,4,13,17,53,PF
1982,26,81,1616,230,565,46,138,184,427,119,152,40,126,166,438,65,11,139,183,625,PG
1982,30,71,966,81,175,1,6,80,169,7,19,106,158,264,42,39,46,37,127,170,PF
1982,26,72,2319,569,1194,8,31,561,1163,211,260,55,106,161,188,82,30,125,151,1357,SG
1982,26,25,595,182,361,3,10,179,351,77,88,13,37,50,67,23,7,34,37,444,SG
1982,26,47,1724,387,833,5,21,382,812,134,172,42,69,111,121,59,23,91,114,913,SG
1982,28,41,924,209,433,4,9,205,424,89,103,37,88,125,109,28,3,64,91,511,SF
1982,30,82,2035,218,499,3,18,215,481,134,164,119,220,339,448,65,6,165,222,573,SF
1982,23,63,1027,165,364,9,32,156,332,61,84,61,59,120,156,49,13,83,123,400,SG
1982,23,82,2750,537,1066,0,7,537,1059,202,267,207,417,624,236,113,39,197,285,1276,SF
1982,33,82,1785,393,863,25,77,368,786,111,129,42,98,140,238,69,4,96,111,922,SG
1982,23,82,1260,192,418,0,0,192,418,86,122,136,228,364,19,36,29,84,243,470,C
1982,27,75,1988,341,701,8,30,333,671,194,247,79,195,274,189,78,29,183,250,884,SF
1982,27,70,2156,396,822,4,15,392,807,110,168,77,173,250,328,174,3,180,218,906,PG
1982,23,6,30,0,4,0,1,0,3,5,6,2,4,6,5,6,2,3,6,5,SG
1982,23,9,87,7,16,0,0,7,16,9,15,1,4,5,15,3,0,13,17,23,PG
1982,23,3,34,2,5,0,0,2,5,3,6,0,2,2,4,1,0,5,4,7,PG
1982,23,6,53,5,11,0,0,5,11,6,9,1,2,3,11,2,0,8,13,16,PG
1982,31,82,2529,312,685,73,189,239,496,100,123,46,177,223,407,164,27,95,176,797,PG
1982,26,74,1926,348,692,1,10,347,682,198,302,167,364,531,86,64,22,152,249,895,PF
1982,26,46,1482,271,524,1,9,270,515,145,220,114,280,394,63,58,16,112,180,688,PF
1982,26,28,444,77,168,0,1,77,167,53,82,53,84,137,23,6,6,40,69,207,PF
1982,31,56,1296,184,409,5,17,179,392,82,116,56,94,150,128,67,21,63,136,455,SF
1982,23,76,2627,527,1016,0,1,527,1015,235,323,210,423,633,64,64,127,206,265,1289,C
1982,23,75,1035,188,402,8,25,180,377,58,70,30,49,79,60,34,11,54,110,442,SG
1982,24,75,923,119,280,0,0,119,280,64,80,35,60,95,130,36,6,78,124,302,SG
1982,24,72,2060,390,694,0,0,390,694,257,337,116,305,421,87,48,65,166,208,1037,C
1982,30,80,1603,94,224,0,0,94,224,41,69,129,227,356,97,42,134,94,237,229,PF
1982,23,49,337,60,135,0,2,60,133,30,41,22,51,73,7,7,0,18,58,150,PF
1982,22,81,2682,554,1056,0,2,554,1054,284,458,211,350,561,146,58,46,220,341,1392,PF
1982,25,79,2498,352,676,6,22,346,654,171,220,51,197,248,667,209,33,184,247,881,PG
1982,32,59,867,74,171,0,0,74,171,36,46,39,146,185,64,15,32,41,114,184,C
1982,23,79,1609,334,653,1,12,333,641,121,169,101,95,196,148,89,24,135,195,790,SG
1982,23,82,2090,387,803,7,31,380,772,118,162,52,103,155,319,146,24,175,196,899,PG
1982,25,76,1298,151,358,0,2,151,356,89,134,112,189,301,100,37,23,80,174,391,PF
1982,24,1,11,1,2,0,0,1,2,0,0,1,1,2,0,0,0,1,2,2,C
1982,25,76,2197,383,741,2,17,381,724,139,171,84,185,269,230,120,61,151,216,907,SG
1982,25,76,1818,281,669,1,8,280,661,119,160,200,350,550,115,37,106,88,285,682,C
1982,26,18,118,16,38,0,0,16,38,5,6,3,2,5,9,4,2,4,19,37,SF
1982,25,82,2189,336,648,1,4,335,644,159,213,211,418,629,130,33,126,139,235,832,C
1982,33,55,1392,222,498,10,29,212,469,141,159,13,69,82,187,44,6,82,96,595,PG
1982,33,27,552,84,210,2,8,82,202,65,73,6,32,38,75,23,2,30,40,235,PG
1982,33,28,840,138,288,8,21,130,267,76,86,7,37,44,112,21,4,52,56,360,PG
1982,26,35,203,11,32,0,0,11,32,6,15,10,31,41,13,6,12,17,39,28,C
1982,25,78,1132,219,430,0,2,219,428,67,91,61,184,245,99,22,9,108,227,505,PF
1982,24,66,956,149,306,0,2,149,304,51,94,90,180,270,32,31,27,44,142,349,PF
1982,34,11,174,21,55,0,0,21,55,10,17,4,13,17,13,5,2,11,25,52,SF
1982,25,81,3222,904,1586,1,3,903,1583,648,818,231,283,514,324,95,14,299,252,2457,SF
1982,26,82,2614,397,771,14,49,383,722,185,230,35,191,226,509,73,6,159,218,993,PG
1982,23,54,575,88,184,0,2,88,182,30,37,54,79,133,31,10,13,43,89,206,SF
1982,26,82,2664,538,1153,5,27,533,1126,315,394,72,106,178,346,76,11,186,176,1396,SG
1982,27,7,67,10,25,0,0,10,25,3,6,7,6,13,4,0,0,5,8,23,SF
1982,27,55,1182,350,669,3,16,347,653,91,111,21,82,103,162,46,3,112,104,794,SF
1982,25,48,1124,207,367,0,2,207,365,114,164,68,237,305,55,19,55,96,193,528,C
1982,24,48,356,39,83,0,1,39,82,14,39,29,50,79,14,4,6,26,65,92,PF
1982,23,30,607,62,121,0,0,62,121,26,40,47,86,133,42,35,8,35,81,150,PF
1982,33,74,999,92,200,0,1,92,199,38,54,63,125,188,87,49,30,44,131,222,C
1982,23,33,221,29,79,0,4,29,75,15,23,6,9,15,34,8,2,17,40,73,PG
1982,24,82,1710,255,419,0,0,255,419,151,240,138,352,490,51,27,139,115,186,661,C
1982,25,64,1031,181,389,18,59,163,330,67,102,27,63,90,146,48,9,92,147,447,SG
1982,27,63,1093,70,140,0,0,70,140,32,80,111,179,290,35,15,38,55,210,172,C
1982,27,70,2040,465,957,4,12,461,945,364,491,169,206,375,96,64,3,178,250,1298,SF
1982,23,81,1973,358,757,8,27,350,730,150,189,30,119,149,419,110,1,174,150,874,PG
1982,25,21,146,34,77,0,1,34,76,4,12,6,9,15,12,3,1,2,9,72,SG
1982,27,70,1315,206,450,33,86,173,364,75,106,24,80,104,227,45,3,80,161,520,SG
1982,26,82,2519,258,504,0,1,258,503,153,215,211,348,559,188,135,36,123,210,669,SG
1982,23,79,1056,121,268,3,11,118,257,27,37,14,70,84,157,20,4,72,143,272,PG
1982,22,32,103,17,37,2,4,15,33,7,9,3,9,12,15,2,0,7,19,43,SF
1982,22,42,291,65,150,0,9,65,141,20,27,10,17,27,45,16,5,24,37,150,PG
1982,26,77,2539,528,1033,0,4,528,1029,232,339,189,392,581,123,24,117,162,347,1288,C
1982,29,81,2100,300,652,0,0,300,652,135,170,167,274,441,100,92,92,136,280,735,C
1982,28,82,3015,855,1553,0,8,855,1545,372,443,210,348,558,433,87,120,261,261,2082,SF
1982,31,81,2789,780,1428,3,11,777,1417,411,539,220,337,557,319,161,141,214,229,1974,SF
1982,26,22,270,35,86,0,6,35,80,13,20,5,17,22,42,13,0,26,36,83,PG
1982,26,14,196,24,51,0,2,24,49,8,12,3,9,12,22,9,0,15,26,56,PG
1982,26,8,74,11,35,0,4,11,31,5,8,2,8,10,20,4,0,11,10,27,PG
1982,28,43,202,19,49,0,0,19,49,19,30,12,30,42,8,5,7,13,23,57,C
1982,33,76,1591,188,450,20,63,168,387,39,56,52,56,108,142,42,10,52,143,435,SG
1982,29,21,201,9,24,0,1,9,23,5,6,14,21,35,11,8,0,15,30,23,SF
1982,25,72,1952,285,649,7,32,278,617,136,166,24,81,105,451,63,1,194,160,713,PG
1982,28,78,2796,650,1452,10,56,640,1396,479,647,118,130,248,419,71,8,208,222,1789,SG
1982,31,75,1793,185,373,0,5,185,368,51,65,37,152,189,261,121,28,126,173,421,PG
1982,25,51,858,105,242,3,10,102,232,17,26,27,67,94,76,32,6,38,94,230,SF
1982,29,79,2817,993,1987,10,36,983,1951,555,642,138,254,392,187,77,45,210,215,2551,SG
1982,32,82,2796,546,837,1,1,545,836,424,552,224,611,835,136,49,220,227,287,1517,C
1982,26,49,833,158,291,1,2,157,289,59,67,5,56,61,87,26,3,27,80,376,SG
1982,22,64,740,119,270,0,0,119,270,97,118,70,116,186,41,17,48,56,69,335,C
1982,26,80,1699,250,495,0,3,250,492,160,217,140,283,423,152,92,36,100,229,660,SF
1982,27,81,2822,500,1015,0,8,500,1007,202,264,85,158,243,630,185,9,198,183,1202,PG
1982,24,82,2914,480,1014,0,3,480,1011,240,291,192,594,786,262,70,93,180,292,1200,PF
1982,28,71,2164,376,857,28,82,348,775,165,193,57,138,195,149,44,23,96,151,945,SG
1982,28,23,459,32,66,0,0,32,66,24,37,29,66,95,54,20,8,40,67,88,PF
1982,23,80,2597,689,1429,15,52,674,1377,189,271,128,177,305,187,95,34,193,213,1582,SG
1982,28,59,1377,173,322,3,6,170,316,78,104,101,158,259,125,75,41,88,162,427,SF
1982,26,81,1892,420,822,2,14,418,808,188,229,55,127,182,276,72,39,148,191,1030,SG
1982,23,68,845,83,166,1,1,82,165,52,76,51,135,186,59,13,30,73,163,219,C
1982,26,4,25,3,7,0,0,3,7,1,1,2,2,4,8,3,0,1,7,7,PG
1982,24,81,1974,167,357,0,4,167,353,138,176,99,167,266,183,81,30,106,250,472,SF
1982,24,38,310,62,136,0,5,62,131,18,29,14,20,34,20,9,4,20,32,142,SG
1982,25,82,1814,179,369,0,1,179,368,64,93,153,317,470,110,58,67,78,192,422,SF
1982,24,68,1433,184,370,0,1,184,369,96,153,127,212,339,54,55,82,92,229,464,PF
1982,26,68,787,144,382,71,214,73,168,31,37,13,40,53,104,30,3,36,94,390,SG
1982,31,49,1317,178,370,4,10,174,360,96,126,89,231,320,142,36,34,87,156,456,PF
1982,36,82,3032,519,1100,0,5,519,1095,280,422,267,480,747,144,62,104,208,287,1318,PF
1982,26,35,487,54,111,0,0,54,111,32,53,39,78,117,28,4,20,19,71,140,C
1982,26,9,75,8,18,0,0,8,18,7,12,7,10,17,4,1,2,2,17,23,C
1982,26,26,412,46,93,0,0,46,93,25,41,32,68,100,24,3,18,17,54,117,C
1982,32,76,2086,395,829,0,3,395,826,219,260,144,278,422,64,45,68,175,249,1009,PF
1982,26,82,1844,353,705,2,12,351,693,125,172,47,105,152,252,82,11,150,199,833,PG
1982,30,75,1721,183,403,0,2,183,401,105,150,33,105,138,306,55,7,105,120,471,SG
1982,25,30,269,39,106,0,1,39,105,7,8,10,11,21,23,8,2,12,25,85,SG
1982,27,76,1696,202,468,4,21,198,447,161,197,23,121,144,395,72,6,156,263,569,PG
1982,28,40,723,53,126,0,2,53,124,39,55,12,40,52,106,21,5,66,88,145,PG
1982,28,21,243,19,37,0,0,19,37,17,23,6,19,25,25,5,2,14,37,55,PG
1982,28,19,480,34,89,0,2,34,87,22,32,6,21,27,81,16,3,52,51,90,PG
1982,25,14,194,27,78,0,3,27,75,3,6,6,7,13,18,11,1,8,13,57,SG
1982,25,13,185,27,73,0,3,27,70,3,4,6,7,13,16,11,1,7,12,57,SG
1982,25,1,9,0,5,0,0,0,5,0,2,0,0,0,2,0,0,1,1,0,SG
1982,28,81,2257,380,797,2,16,378,781,132,188,35,152,187,316,103,20,146,198,894,PG
1982,25,77,1372,204,414,3,13,201,401,116,199,119,276,395,65,26,19,111,230,527,PF
1982,25,83,1839,326,665,0,4,326,661,191,280,187,286,473,91,65,19,161,292,843,SF
1982,25,52,1104,207,410,0,3,207,407,106,163,101,171,272,67,38,16,99,176,520,SF
1982,25,31,735,119,255,0,1,119,254,85,117,86,115,201,24,27,3,62,116,323,SF
1982,24,78,2409,325,672,3,10,322,662,153,200,53,97,150,590,70,11,171,169,806,PG
1982,33,81,2472,651,1236,4,6,647,1230,546,655,174,434,608,179,67,55,169,245,1852,C
1982,22,49,478,79,172,0,0,79,172,38,49,35,28,63,27,14,3,24,48,196,SG
1982,22,11,66,10,26,0,0,10,26,6,10,7,5,12,5,3,0,6,5,26,SG
1982,22,38,412,69,146,0,0,69,146,32,39,28,23,51,22,11,3,18,43,170,SG
1982,25,7,65,11,20,0,0,11,20,3,6,8,4,12,7,3,3,7,13,25,SG
1982,25,79,1979,312,641,0,0,312,641,123,189,184,387,571,127,60,112,138,241,747,C
1982,27,80,2937,577,1228,8,42,569,1186,399,495,142,268,410,369,105,55,233,253,1561,SG
1982,26,68,2314,455,1011,7,30,448,981,294,385,63,128,191,358,102,16,186,188,1211,SG
1982,22,74,1517,295,643,1,11,294,632,99,149,128,194,322,109,50,14,97,210,690,SF
1982,23,79,2027,336,812,17,79,319,733,153,204,34,113,147,380,76,7,160,196,842,PG
1982,33,75,1578,91,195,0,0,91,195,43,64,152,302,454,79,20,234,92,259,225,C
1982,25,59,720,120,291,0,2,120,289,60,80,72,145,217,40,36,25,68,147,300,PF
1982,34,14,187,22,45,0,0,22,45,15,20,3,15,18,29,4,3,17,20,59,SF
1982,22,78,2991,556,1036,6,29,550,1007,329,433,252,499,751,743,208,34,286,223,1447,SG
1982,25,60,1900,404,760,0,4,404,756,182,260,153,211,364,213,59,35,145,142,990,SF
1982,29,76,1934,372,757,1,7,371,750,233,291,133,321,454,215,72,45,191,240,978,PF
1982,32,26,150,27,54,1,3,26,51,6,7,7,15,22,10,13,3,13,28,61,SF
1982,24,75,1904,351,662,0,1,351,661,118,156,140,311,451,73,33,60,100,257,820,PF
1982,24,21,504,94,194,0,0,94,194,32,40,43,94,137,20,7,16,26,67,220,PF
1982,24,23,617,94,175,0,0,94,175,35,44,43,82,125,22,6,17,24,73,223,PF
1982,24,31,783,163,293,0,1,163,292,51,72,54,135,189,31,20,27,50,117,377,PF
1982,24,78,1741,395,644,0,0,395,644,212,330,152,307,459,91,39,89,197,372,1002,C
1982,25,74,1295,217,444,3,12,214,432,107,142,82,77,159,171,56,25,96,101,544,SG
1982,25,7,104,9,22,0,1,9,21,9,12,7,8,15,11,6,2,5,8,27,SG
1982,25,67,1191,208,422,3,11,205,411,98,130,75,69,144,160,50,23,91,93,517,SG
1982,30,76,2181,416,737,0,3,416,734,263,333,109,284,393,189,99,112,145,211,1095,PF
1982,31,81,2446,231,465,0,3,231,462,179,219,164,544,708,100,38,146,155,301,641,C
1982,29,78,2040,303,572,1,1,302,571,172,238,156,351,507,114,49,36,155,217,779,PF
1982,25,48,802,142,259,1,2,141,257,90,129,70,137,207,40,28,92,66,149,375,PF
1982,28,60,746,113,213,0,3,113,210,42,77,80,122,202,25,20,29,50,100,268,PF
1982,27,58,608,89,208,1,9,88,199,43,54,4,39,43,131,62,1,66,98,222,PG
1982,25,30,251,31,81,1,10,30,71,16,26,14,20,34,14,6,5,9,33,79,SF
1982,22,35,248,26,49,0,0,26,49,29,42,26,35,61,14,4,3,16,55,81,PF
1982,28,81,1892,236,505,0,1,236,504,167,223,168,329,497,293,64,71,244,292,639,C
1982,24,60,741,116,271,0,3,116,268,105,160,80,113,193,57,18,21,84,131,337,SF
1982,24,11,183,35,86,0,3,35,83,27,41,13,26,39,12,5,7,22,32,97,SF
1982,24,49,558,81,185,0,0,81,185,78,119,67,87,154,45,13,14,62,99,240,SF
1982,29,60,1036,192,412,0,0,192,412,50,88,72,108,180,65,30,7,82,71,434,PF
1982,22,76,1694,391,812,3,13,388,799,133,171,105,207,312,142,64,36,180,261,918,SF
1982,25,79,2861,740,1307,1,5,739,1302,352,499,140,329,469,282,78,23,267,285,1833,SF
1982,24,80,2609,383,752,0,0,383,752,201,285,162,361,523,173,84,29,155,221,967,SF
1982,29,81,1803,378,764,9,32,369,732,233,282,97,160,257,118,63,14,137,132,998,SF
1982,26,40,550,102,183,0,0,102,183,17,25,33,49,82,23,14,11,21,74,221,SF
1982,26,56,549,55,133,0,0,55,133,33,42,36,72,108,51,19,11,26,62,143,PF
1982,30,21,237,20,48,0,0,20,48,9,17,20,46,66,18,3,6,18,51,49,C
1982,27,26,821,153,267,0,0,153,267,65,98,64,146,210,33,12,10,43,80,371,PF
1982,33,56,670,67,154,0,1,67,153,27,37,20,87,107,77,22,38,56,139,161,C
1982,33,2,20,3,5,0,0,3,5,0,2,0,4,4,4,2,1,2,2,6,C
1982,33,54,650,64,149,0,1,64,148,27,35,20,83,103,73,20,37,54,137,155,C
1982,26,47,909,113,269,0,2,113,267,86,166,63,147,210,49,17,17,82,138,312,C
1982,24,80,1829,265,536,4,13,261,523,184,232,234,383,617,100,39,64,121,296,718,C
1982,24,50,894,119,253,3,6,116,247,93,120,124,153,277,45,22,30,61,170,334,C
1982,24,30,935,146,283,1,7,145,276,91,112,110,230,340,55,17,34,60,126,384,C
1982,29,63,764,86,197,1,7,85,190,34,42,55,123,178,37,18,16,48,123,207,PF
1982,29,42,493,60,139,1,6,59,133,21,28,36,91,127,24,12,10,38,80,142,PF
1982,29,21,271,26,58,0,1,26,57,13,14,19,32,51,13,6,6,10,43,65,PF
1982,22,54,617,100,196,0,1,100,195,50,61,24,40,64,28,16,1,45,83,250,SF
1982,26,75,1134,144,329,0,2,144,327,33,65,164,237,401,32,10,7,49,134,321,PF
1982,33,74,1986,407,729,0,2,407,727,182,242,92,296,388,219,72,56,166,211,996,C
1982,24,79,2150,370,793,9,31,361,762,115,135,49,119,168,457,150,15,153,182,864,PG
1982,26,2,10,1,2,0,0,1,2,0,4,0,1,1,2,0,0,0,3,2,C
1982,29,81,1467,88,246,18,59,70,187,84,119,35,120,155,312,116,20,123,221,278,PG
1982,23,75,2252,329,657,4,8,325,649,208,256,75,138,213,362,80,14,185,158,870,PG
1982,23,80,1186,149,287,0,0,149,287,64,123,108,279,387,84,18,118,129,239,362,C
1982,22,16,95,25,45,0,0,25,45,7,11,9,7,16,6,5,1,14,20,57,SG
1982,29,74,1047,108,285,2,4,106,281,69,91,60,103,163,67,15,7,59,175,287,PF
1982,22,71,1139,208,448,0,11,208,437,77,107,69,126,195,88,35,30,68,147,493,SF
1982,25,69,2211,637,1294,2,15,635,1279,238,275,95,162,257,148,65,25,167,173,1514,SG
1982,28,79,1940,263,618,2,22,261,596,138,176,40,126,166,551,95,6,156,105,666,PG
1982,29,80,2671,505,1001,0,3,505,998,253,349,274,629,903,179,68,70,173,309,1263,PF
1982,24,13,150,19,59,0,2,19,57,6,8,8,10,18,14,5,1,4,6,44,SG
1982,23,79,1516,210,484,0,3,210,481,134,173,113,150,263,47,40,20,112,225,554,SF
1982,24,82,2845,486,945,39,100,447,845,152,169,78,183,261,384,143,9,125,185,1163,PG
1982,23,80,2664,414,816,0,3,414,813,148,234,149,555,704,150,57,138,162,349,976,PF
1982,26,81,3398,945,1822,0,6,945,1816,630,827,558,630,1188,142,76,125,294,208,2520,C
1982,22,47,837,131,298,2,8,129,290,60,79,19,39,58,139,53,2,63,129,324,PG
1982,26,78,2590,397,724,0,3,397,721,357,478,218,281,499,183,79,49,174,263,1151,SF
1982,27,65,1187,212,417,0,4,212,413,159,193,85,133,218,133,50,6,92,151,583,SF
1982,30,41,746,151,330,0,5,151,325,90,126,45,114,159,32,22,36,51,109,392,C
1982,25,8,23,9,13,0,0,9,13,3,5,1,3,4,3,2,0,3,3,21,SG
1982,22,30,335,34,84,0,0,34,84,27,41,41,59,100,20,6,8,21,52,95,PF
1982,28,20,349,52,125,1,5,51,120,29,36,6,11,17,39,8,3,22,44,134,PG
1982,22,39,352,80,172,0,4,80,168,31,53,34,15,49,16,18,3,34,59,191,SF
1982,31,76,1341,141,378,0,3,141,375,72,159,93,305,398,204,96,28,131,198,354,PF
1982,24,82,2332,465,875,0,0,465,875,187,248,191,365,556,91,30,185,137,264,1117,PF
1982,23,36,237,28,87,0,2,28,85,11,17,18,11,29,14,10,2,20,45,67,SG
1982,26,81,1963,369,699,0,17,369,682,137,170,29,113,142,338,69,16,115,186,875,PG
1982,29,73,1792,291,572,1,3,290,569,140,170,102,234,336,129,25,24,124,202,723,C
1982,28,18,380,47,91,0,0,47,91,31,40,25,63,88,17,13,21,25,68,125,C
1982,26,84,3063,753,1477,0,7,753,1470,220,302,244,346,590,82,60,43,153,277,1726,SF
1982,26,27,973,229,504,0,6,229,498,72,100,71,70,141,39,27,15,55,77,530,SF
1982,26,57,2090,524,973,0,1,524,972,148,202,173,276,449,43,33,28,98,200,1196,SF
1982,34,75,1235,202,399,1,4,201,395,136,172,92,133,225,93,42,17,67,86,541,SF
1982,25,67,868,84,193,0,3,84,190,48,63,59,149,208,35,33,40,55,171,216,C
1982,25,39,523,49,111,0,1,49,110,25,33,35,87,122,24,13,23,39,103,123,C
1982,25,28,345,35,82,0,2,35,80,23,30,24,62,86,11,20,17,16,68,93,C
1982,24,80,2980,556,1063,1,14,555,1049,468,573,221,313,534,382,138,22,208,206,1581,SG
1982,23,79,2294,309,667,1,21,308,646,122,182,62,213,275,762,163,12,175,254,741,PG
1982,24,4,70,19,38,1,5,18,33,6,8,1,3,4,15,6,1,5,15,45,PG
1982,33,64,1204,277,648,1,16,276,632,100,110,20,41,61,163,43,1,82,142,655,PG
1982,22,80,1186,227,436,0,1,227,435,75,117,95,161,256,82,42,71,104,169,529,PF
1982,32,21,575,101,175,1,1,100,174,59,79,46,146,192,30,6,9,48,64,262,C
1982,25,75,2599,515,894,2,8,513,886,294,392,193,420,613,150,62,36,140,175,1326,SF
1982,33,76,1507,286,615,7,23,279,592,126,147,36,55,91,170,33,3,104,194,705,SG
1982,23,80,1322,252,555,0,5,252,550,85,150,67,94,161,89,66,4,101,184,589,SG
1982,23,63,1085,137,297,0,0,137,297,63,108,92,203,295,61,17,82,56,190,337,C
1982,26,82,3024,628,1274,3,12,625,1262,181,224,38,138,176,652,132,7,238,264,1440,PG
1982,23,80,2018,383,778,8,23,375,755,135,189,111,194,305,192,83,13,147,175,909,SF
1982,25,68,2098,333,705,2,12,331,693,273,338,118,321,439,202,57,29,139,253,941,PF
1982,24,22,124,13,36,0,0,13,36,8,14,7,17,24,3,2,10,6,28,34,C
1982,23,80,1951,357,719,1,8,356,711,203,254,127,204,331,134,56,26,137,182,918,SF
1982,32,74,1599,299,636,1,2,298,634,181,226,142,230,372,127,41,37,137,259,780,PF
1982,28,80,2534,669,1235,0,0,669,1235,252,355,288,578,866,140,68,192,221,267,1590,C
1982,26,71,899,116,245,0,0,116,245,48,72,73,104,177,89,39,11,51,101,280,SF
1982,33,65,807,89,226,0,0,89,226,34,65,54,126,180,41,15,22,45,99,212,C
1982,24,82,2756,662,1258,8,35,654,1223,220,287,75,146,221,276,129,12,144,159,1552,SG
1982,30,69,1037,114,251,0,1,114,250,61,79,90,139,229,28,29,47,57,164,289,PF
1982,25,81,1183,233,507,5,31,228,476,85,109,61,93,154,114,36,8,66,152,556,SG
1982,25,27,566,104,214,4,13,100,201,36,45,28,43,71,53,16,2,33,61,248,SG
1982,25,54,617,129,293,1,18,128,275,49,64,33,50,83,61,20,6,33,91,308,SG
1982,26,82,1698,220,428,3,10,217,418,97,120,117,294,411,94,51,65,69,235,540,PF
1982,22,43,369,54,100,2,3,52,97,35,69,13,16,29,57,16,2,42,65,145,SG
1982,25,49,637,77,177,0,2,77,175,38,64,37,43,80,40,18,2,25,74,192,SF
1982,23,64,1131,118,228,0,1,118,227,59,117,116,232,348,56,60,76,77,167,295,PF
1982,23,78,2418,504,1095,3,38,501,1057,242,318,39,147,186,555,97,4,229,169,1253,PG
1982,24,40,262,51,116,1,1,50,115,21,36,18,47,65,26,10,16,37,59,124,PF
1982,26,77,2913,437,958,1,10,436,948,160,214,175,336,511,314,115,48,157,297,1035,SF
1982,30,47,483,32,88,0,2,32,86,10,16,39,73,112,22,11,11,20,56,74,PF
1982,30,13,145,9,28,0,1,9,27,3,4,8,27,35,7,1,4,6,16,21,PF
1982,30,34,338,23,60,0,1,23,59,7,12,31,46,77,15,10,7,14,40,53,PF
1982,25,77,1040,140,310,2,2,138,308,69,88,55,63,118,109,36,9,79,109,351,SG
1982,26,82,3044,619,1343,19,101,600,1242,212,303,177,388,565,572,213,41,291,317,1469,PG
1982,26,80,1186,185,375,0,2,185,373,84,157,114,181,295,68,27,14,92,183,454,C
1982,21,68,2175,518,1143,0,4,518,1139,222,313,174,435,609,120,88,103,149,222,1258,PF
1982,21,38,1229,322,708,0,3,322,705,125,180,83,239,322,71,46,60,86,120,769,PF
1982,21,30,946,196,435,0,1,196,434,97,133,91,196,287,49,42,43,63,102,489,PF
1982,26,3,29,3,9,0,0,3,9,4,4,3,0,3,0,0,0,1,1,10,SF
1982,30,74,2745,579,1128,1,1,578,1127,255,371,202,519,721,179,42,28,202,215,1414,PF
1982,29,56,651,131,294,0,0,131,294,61,75,56,88,144,49,37,5,83,156,323,PF
1982,32,12,257,48,106,0,0,48,106,48,55,14,49,63,32,3,4,13,29,144,C
1982,32,39,501,68,150,23,52,45,98,28,38,4,19,23,89,15,2,29,40,187,SG
1982,26,79,2018,202,346,0,0,202,346,79,129,168,443,611,59,35,224,79,285,483,C
1982,23,79,1259,203,403,3,15,200,388,79,96,12,86,98,226,60,13,89,103,488,PG
1982,28,61,2217,424,910,1,5,423,905,285,375,227,494,721,162,64,93,183,210,1134,PF
1982,23,82,2214,420,749,1,3,419,746,342,455,253,509,762,134,44,58,237,319,1183,C
1982,30,77,2358,410,858,25,57,385,801,228,294,86,150,236,284,77,12,195,221,1073,SF
1982,23,3,24,1,5,0,0,1,5,1,2,2,3,5,0,1,1,2,3,3,PF
1982,22,82,1623,252,524,0,1,252,523,140,185,131,296,427,146,46,72,151,292,644,C
1982,26,81,1740,189,380,0,2,189,378,108,148,97,197,294,149,59,70,98,169,486,SF
1982,24,4,21,2,6,0,0,2,6,1,2,1,2,3,0,1,0,0,3,5,SF
1982,26,81,2667,508,1046,0,8,508,1038,188,240,161,348,509,252,99,43,199,317,1204,PF
1982,24,76,1782,456,935,6,28,450,907,177,221,123,143,266,209,65,10,122,220,1095,SF
1982,25,51,800,91,194,1,9,90,185,29,38,14,41,55,117,33,1,42,63,212,PG
1982,26,82,3049,581,1212,2,13,579,1199,447,523,223,815,1038,277,102,107,213,268,1611,C
1982,32,67,1447,251,573,0,5,251,568,246,286,26,83,109,222,40,6,107,109,748,SG
1982,23,72,858,86,169,0,0,86,169,39,85,72,110,182,46,22,51,47,185,211,PF
1982,24,74,2213,220,412,0,1,220,411,88,159,279,534,813,83,65,54,105,291,528,PF
1982,29,74,2042,340,761,5,27,335,734,163,223,51,135,186,307,67,27,155,213,848,SG
1982,29,48,1446,253,575,5,24,248,551,123,168,34,83,117,233,45,19,116,151,634,SG
1982,29,26,596,87,186,0,3,87,183,40,55,17,52,69,74,22,8,39,62,214,SG
1982,33,82,2033,348,748,3,11,345,737,122,151,53,102,155,255,91,1,124,199,821,SG
1982,26,17,316,52,110,2,10,50,100,10,12,1,13,14,44,10,1,14,35,116,PG
1982,29,80,1938,363,801,19,76,344,725,195,254,37,105,142,301,73,18,217,238,940,SG
1982,24,82,1755,270,564,8,24,262,540,279,327,99,111,210,206,86,9,111,140,827,SG
1982,23,82,2610,366,730,1,15,365,715,124,148,53,171,224,424,87,13,145,240,857,PG
1982,22,4,37,7,11,0,0,7,11,0,2,2,4,6,4,2,0,4,7,14,SF
1982,30,7,90,14,34,1,2,13,32,1,2,2,5,7,7,1,0,9,6,30,SG
1982,30,41,1274,165,328,23,63,142,265,90,110,26,70,96,229,47,9,82,113,443,PG
1982,25,13,60,3,15,0,3,3,12,3,4,5,7,12,8,3,1,5,15,9,SG
1982,24,82,2838,560,1194,25,100,535,1094,363,449,115,197,312,476,87,16,277,243,1508,SG
1982,20,72,2433,453,1068,17,59,436,1009,302,429,57,152,209,565,150,17,299,253,1225,PG
1982,27,61,1246,313,644,4,14,309,630,276,339,57,91,148,117,34,29,142,149,906,SG
1982,27,79,3129,681,1303,0,0,681,1303,280,446,258,663,921,319,69,107,245,233,1642,C
1982,23,64,607,100,202,0,2,100,200,19,35,50,76,126,33,12,16,45,83,219,PF
1982,23,12,115,20,44,0,1,20,43,4,8,11,16,27,8,4,2,12,19,44,PF
1982,23,52,492,80,158,0,1,80,157,15,27,39,60,99,25,8,14,33,64,175,PF
1982,24,77,1909,511,979,25,59,486,920,227,306,43,91,134,283,64,17,214,269,1274,SG
1982,26,14,95,11,41,2,9,9,32,11,20,2,11,13,10,3,0,6,18,35,SG
1982,22,82,3077,636,1281,5,22,631,1259,495,621,219,224,443,270,89,16,280,241,1772,SF
1982,22,80,1996,282,639,0,4,282,635,97,138,143,158,301,189,75,2,116,182,661,SF
1982,25,82,1989,336,643,1,4,335,639,142,192,154,339,493,126,77,160,121,182,815,PF
1982,22,82,1387,187,453,0,9,187,444,152,200,48,101,149,270,94,3,127,187,526,PG
1982,30,41,452,41,82,0,2,41,80,62,76,17,31,48,32,12,13,29,63,144,SF
1982,23,82,2775,706,1260,1,13,705,1247,347,405,149,312,461,247,52,29,189,217,1760,PF
1982,22,71,1207,149,296,0,0,149,296,51,72,106,148,254,52,42,22,55,215,349,PF
1982,22,81,2626,719,1448,1,4,718,1444,293,409,182,383,565,176,89,22,194,308,1732,PF
1982,23,77,1075,143,262,0,1,143,261,89,148,71,127,198,56,28,21,68,150,375,SF
1982,30,77,1861,156,378,3,9,153,369,141,194,31,119,150,398,120,6,107,179,456,PG
1982,27,70,1965,302,629,0,2,302,627,90,134,108,197,305,218,36,28,111,215,694,SF
1982,30,20,418,38,78,0,0,38,78,24,41,40,77,117,29,9,16,19,56,100,PF
1982,26,18,313,50,115,0,2,50,113,9,15,32,43,75,15,8,2,35,51,109,PF
1982,29,82,1883,199,405,0,0,199,405,108,170,184,306,490,99,22,91,90,211,506,C
1982,29,54,1638,260,589,5,23,255,566,66,90,128,176,304,133,73,14,73,189,591,SF
1982,31,18,451,86,194,2,8,84,186,36,47,9,13,22,100,19,8,47,61,210,SG
1982,25,72,2214,406,726,0,0,406,726,184,241,231,433,664,102,48,44,141,290,996,C
1982,24,23,266,25,71,0,1,25,70,4,7,13,27,40,19,12,1,14,31,54,SG
1982,24,61,1013,203,359,0,5,203,354,98,141,67,115,182,52,40,16,71,127,504,PF
1982,27,65,1805,284,679,3,18,281,661,145,185,60,190,250,237,92,25,138,188,716,SF
1982,28,82,2906,744,1417,0,4,744,1413,246,336,153,240,393,143,89,24,164,240,1734,SF
1982,23,57,862,128,266,0,1,128,265,58,80,62,97,159,64,30,18,62,112,314,SF
1982,26,82,2274,314,718,0,3,314,715,137,176,120,491,611,90,32,77,134,248,765,C
1982,21,82,2825,513,881,0,1,513,880,242,388,347,658,1005,107,84,84,235,285,1268,PF
1982,25,60,997,276,623,28,94,248,529,140,166,23,39,62,86,29,0,107,103,720,SG
1982,25,37,808,234,513,24,74,210,439,118,140,21,29,50,67,23,0,89,85,610,SG
1982,25,23,189,42,110,4,20,38,90,22,26,2,10,12,19,6,0,18,18,110,SG
1982,28,80,2876,773,1592,9,40,764,1552,320,436,92,152,244,549,172,36,197,163,1875,PG
1982,23,82,2277,407,854,2,7,405,847,126,188,175,430,605,139,53,178,137,200,942,C
1982,27,82,2732,639,1383,9,54,630,1329,387,465,117,208,325,488,199,43,290,302,1674,SG
1982,22,59,1073,154,277,0,0,154,277,49,89,91,217,308,38,45,76,64,156,357,PF
1982,24,60,1521,349,628,2,9,347,619,131,173,100,127,227,142,77,16,114,153,831,SF
1982,24,69,1475,240,464,3,7,237,457,56,77,107,157,264,75,31,59,78,146,539,SF
1982,29,61,1829,404,806,36,93,368,713,123,156,51,119,170,253,57,9,118,187,967,SG
1982,22,46,493,49,84,1,2,48,82,33,40,29,33,62,38,17,4,35,74,132,SF
1982,23,48,930,179,381,3,24,176,357,93,119,51,83,134,58,31,9,71,108,454,SG
1982,23,19,238,36,105,0,6,36,99,20,28,22,22,44,11,9,1,11,34,92,SG
1982,23,29,692,143,276,3,18,140,258,73,91,29,61,90,47,22,8,60,74,362,SG
1982,22,42,342,55,120,0,1,55,119,34,52,22,43,65,9,8,6,15,37,144,SF
1982,23,83,2331,538,1069,7,25,531,1044,221,286,102,145,247,222,142,35,153,220,1304,SG
1982,23,7,145,30,68,0,1,30,67,23,32,5,8,13,16,7,2,9,21,83,SG
1982,23,76,2186,508,1001,7,24,501,977,198,254,97,137,234,206,135,33,144,199,1221,SG
1982,22,75,1188,202,394,0,3,202,391,144,206,82,145,227,81,23,24,107,152,548,SF
1982,24,5,22,2,5,0,0,2,5,0,0,1,0,1,3,0,0,2,3,4,PG
1982,27,1,6,0,1,0,0,0,1,0,0,0,0,0,0,0,0,1,2,0,PG
1982,23,10,70,14,26,0,0,14,26,5,7,13,14,27,3,1,2,2,7,33,PF
1983,35,79,2554,722,1228,0,2,722,1226,278,371,167,425,592,200,61,170,200,220,1722,C
1983,28,80,2447,477,981,1,3,476,978,180,217,161,387,548,376,114,74,242,287,1135,C
1983,23,81,2784,767,1589,16,76,751,1513,429,589,191,317,508,332,80,26,261,247,1979,SF
1983,23,80,2048,357,720,5,29,352,691,72,97,83,131,214,251,109,6,98,259,791,SG
1983,22,5,33,7,14,0,0,7,14,7,10,0,2,2,3,1,0,5,7,21,PG
1983,22,65,1202,190,379,0,4,190,375,100,175,119,175,294,67,63,21,79,153,480,SF
1983,22,13,48,8,22,0,1,8,21,1,3,4,8,12,1,1,0,5,6,17,SF
1983,22,52,1154,182,357,0,3,182,354,99,172,115,167,282,66,62,21,74,147,463,SF
1983,22,78,1274,174,431,7,19,167,412,48,69,111,161,272,120,57,26,93,170,403,C
1983,34,66,1811,235,553,5,24,230,529,220,296,25,66,91,409,38,4,163,110,695,PG
1983,22,68,990,161,373,0,14,161,359,64,84,17,79,96,167,54,5,118,74,386,PG
1983,25,75,1765,385,774,0,1,385,773,226,322,171,303,474,67,43,60,196,271,996,PF
1983,25,6,50,9,18,0,0,9,18,2,2,3,3,6,2,1,1,6,15,20,PF
1983,25,69,1715,376,756,0,1,376,755,224,320,168,300,468,65,42,59,190,256,976,PF
1983,28,78,2840,603,1274,13,37,590,1237,182,233,123,385,508,262,135,25,157,176,1401,SF
1983,23,81,2722,505,919,0,5,505,914,196,278,222,390,612,279,78,21,171,229,1206,PF
1983,26,19,304,55,145,2,5,53,140,11,22,11,8,19,14,14,3,12,19,123,SG
1983,26,15,277,53,129,2,5,51,124,10,20,10,8,18,14,13,3,12,18,118,SG
1983,26,4,27,2,16,0,0,2,16,1,2,1,0,1,0,1,0,0,1,5,SG
1983,26,54,558,85,191,0,3,85,188,8,17,45,74,119,29,15,13,28,56,178,C
1983,28,21,599,85,182,0,1,85,181,38,50,53,102,155,49,14,17,35,61,208,C
1983,26,79,2982,747,1481,22,77,725,1404,351,418,193,677,870,458,148,71,240,197,1867,PF
1983,27,62,1885,426,834,2,6,424,828,82,145,53,97,150,239,85,16,114,155,936,SG
1983,23,75,2349,513,1042,3,15,510,1027,297,381,108,185,293,185,37,29,118,116,1326,SG
1983,23,51,532,69,176,0,3,69,173,46,90,30,48,78,28,32,27,42,84,184,SG
1983,25,58,683,82,159,1,5,81,154,36,45,27,78,105,106,49,10,59,91,201,SG
1983,24,62,680,131,308,0,1,131,307,76,108,73,100,173,46,27,26,45,81,338,PF
1983,27,15,140,14,42,1,8,13,34,10,13,3,16,19,23,7,0,14,20,39,PG
1983,27,74,1964,344,807,7,18,337,789,142,170,59,85,144,96,90,25,97,123,837,SG
1983,27,21,563,98,245,0,3,98,242,44,51,9,28,37,27,20,6,25,27,240,SG
1983,27,53,1401,246,562,7,15,239,547,98,119,50,57,107,69,70,19,72,96,597,SG
1983,29,70,1855,421,856,1,13,420,843,164,196,44,202,246,207,40,9,122,155,1007,SF
1983,31,37,371,44,99,6,13,38,86,10,14,24,35,59,70,6,1,31,46,104,SF
1983,24,58,466,91,213,3,13,88,200,34,43,33,29,62,66,26,9,43,79,219,SG
1983,24,82,2457,402,830,5,15,397,815,193,277,239,282,521,262,112,39,177,297,1002,SF
1983,34,80,1432,371,714,14,32,357,682,58,72,32,65,97,242,59,13,110,98,814,PG
1983,24,76,1048,167,349,0,3,167,346,65,105,91,175,266,25,13,26,82,172,399,C
1983,24,50,743,118,245,0,2,118,243,40,65,56,122,178,16,8,21,60,126,276,C
1983,24,26,305,49,104,0,1,49,103,25,40,35,53,88,9,5,5,22,46,123,C
1983,28,81,2055,344,768,8,36,336,732,116,165,88,189,277,186,82,30,177,258,812,SF
1983,28,72,1565,248,561,0,4,248,557,74,117,62,125,187,275,108,5,159,195,570,SG
1983,32,41,643,72,182,9,35,63,147,41,46,19,35,54,115,44,2,25,60,194,PG
1983,26,80,1436,157,374,6,26,151,348,71,95,75,116,191,179,41,6,73,149,391,SF
1983,27,82,2331,362,717,2,6,360,711,255,366,182,407,589,116,62,42,185,306,981,PF
1983,32,77,883,135,315,3,19,132,296,60,81,51,86,137,71,48,10,79,140,333,SF
1983,24,79,2988,785,1529,0,3,785,1526,337,469,220,468,688,169,108,155,285,260,1907,C
1983,24,81,1716,354,706,17,51,337,655,124,154,62,88,150,194,78,13,118,207,849,SG
1983,25,82,2468,455,804,0,0,455,804,380,511,185,405,590,136,41,127,204,315,1290,C
1983,31,74,1554,90,197,0,0,90,197,62,92,132,276,408,77,26,148,83,224,242,C
1983,23,79,2665,519,1099,0,8,519,1091,353,488,218,301,519,192,79,57,234,333,1391,PF
1983,26,79,2465,404,745,1,6,403,739,181,240,53,156,209,543,184,31,179,182,990,PG
1983,24,65,1575,332,635,0,6,332,629,101,136,116,94,210,132,87,30,146,166,765,SF
1983,23,75,1416,145,303,0,4,145,299,79,113,69,152,221,253,116,7,99,141,369,PG
1983,24,82,2625,443,986,8,38,435,948,186,242,73,167,240,448,194,48,238,213,1080,PG
1983,26,75,1333,148,304,0,3,148,301,79,104,119,216,335,102,39,31,105,181,375,PF
1983,26,45,551,61,142,0,2,61,140,41,54,44,85,129,58,12,13,56,89,163,PF
1983,26,30,782,87,162,0,1,87,161,38,50,75,131,206,44,27,18,49,92,212,PF
1983,25,20,333,37,72,0,0,37,72,16,29,42,44,86,17,9,20,32,49,90,C
1983,25,2,11,1,4,0,0,1,4,0,0,2,0,2,0,1,1,3,3,2,C
1983,25,5,47,5,9,0,0,5,9,5,9,4,9,13,2,0,0,6,7,15,C
1983,25,13,275,31,59,0,0,31,59,11,20,36,35,71,15,8,19,23,39,73,C
1983,26,82,2148,266,497,5,21,261,476,102,130,82,192,274,315,115,50,128,208,639,SG
1983,26,80,2099,320,723,0,5,320,718,135,197,214,397,611,116,27,136,162,318,775,C
1983,26,82,2496,457,920,0,2,457,918,232,322,243,474,717,154,47,109,228,242,1146,C
1983,34,40,1014,136,306,0,2,136,304,52,63,73,201,274,82,30,15,44,137,324,PF
1983,27,7,78,13,37,0,2,13,35,3,6,7,3,10,6,0,1,9,16,29,SG
1983,34,66,922,169,375,6,31,163,344,68,76,14,65,79,127,27,0,44,44,412,PG
1983,27,14,148,14,34,0,0,14,34,3,5,18,30,48,7,3,5,5,25,31,C
1983,26,81,2317,433,878,0,1,433,877,148,196,225,443,668,144,57,35,162,296,1014,C
1983,21,70,2531,684,1309,0,1,684,1308,292,412,303,441,744,177,129,62,204,294,1660,PF
1983,25,73,987,108,258,0,0,108,258,33,67,84,185,269,43,37,24,76,144,249,C
1983,22,76,2081,470,1008,5,25,465,983,206,282,87,173,260,280,72,10,205,248,1151,SG
1983,26,22,887,233,402,0,0,233,402,210,248,58,82,140,105,20,0,81,62,676,SF
1983,27,79,2323,359,628,11,43,348,585,186,220,34,164,198,565,80,11,143,176,915,PG
1983,24,74,1161,251,534,2,10,249,524,56,89,83,130,213,73,32,22,91,122,560,SF
1983,27,53,1465,258,567,5,18,253,549,164,206,37,91,128,315,43,7,114,100,685,SG
1983,26,8,28,4,10,0,0,4,10,6,10,3,7,10,0,0,4,0,4,14,PF
1983,28,80,2491,665,1289,7,23,658,1266,184,225,63,134,197,397,117,12,188,186,1521,SG
1983,26,81,2093,401,669,0,0,401,669,166,257,127,293,420,114,67,152,281,379,968,C
1983,24,22,224,11,34,0,0,11,34,6,9,20,32,52,6,16,1,5,27,28,PF
1983,34,8,34,1,5,0,0,1,5,0,2,2,6,8,6,1,0,1,6,2,C
1983,25,82,1789,289,496,0,0,289,496,150,218,131,370,501,97,19,101,132,171,728,C
1983,26,3,12,1,6,1,2,0,4,2,2,0,1,1,1,0,0,0,0,5,SG
1983,28,5,46,2,3,0,0,2,3,0,2,3,4,7,0,0,3,1,13,4,C
1983,28,44,1206,318,671,0,5,318,666,296,392,98,137,235,97,35,7,135,152,932,SF
1983,24,75,2690,599,1218,2,16,597,1202,310,378,44,163,207,610,126,10,272,207,1510,PG
1983,26,5,49,9,19,0,0,9,19,0,0,0,3,3,5,2,1,9,5,18,SG
1983,28,79,1619,213,510,67,194,146,316,120,154,18,116,134,437,74,4,160,210,613,PG
1983,27,82,2640,254,527,0,1,254,526,119,163,231,384,615,189,147,25,113,218,627,SG
1983,24,82,1433,163,360,0,13,163,347,43,54,38,69,107,200,66,5,96,203,369,PG
1983,26,81,1528,146,353,0,1,146,352,59,90,86,376,462,112,24,275,140,257,351,C
1983,23,82,1588,280,575,1,8,279,567,200,247,34,88,122,210,51,3,152,116,761,PG
1983,22,32,309,48,139,0,2,48,137,16,27,20,19,39,22,11,6,20,41,112,SG
1983,23,81,1266,228,483,0,8,228,475,86,113,23,62,85,221,81,6,110,119,542,PG
1983,27,31,667,128,263,0,0,128,263,69,108,56,99,155,40,12,19,49,110,325,C
1983,27,15,382,73,150,0,0,73,150,38,61,37,59,96,13,7,14,30,61,184,C
1983,27,16,285,55,113,0,0,55,113,31,47,19,40,59,27,5,5,19,49,141,C
1983,30,74,975,97,244,0,1,97,243,54,84,81,157,238,39,44,38,83,125,248,C
1983,23,54,369,38,94,0,0,38,94,5,16,43,61,104,11,7,17,24,95,81,C
1983,29,82,2988,959,1857,2,12,957,1845,406,490,263,338,601,397,116,126,263,235,2326,SF
1983,32,72,2421,605,1170,2,7,603,1163,330,435,173,318,491,263,112,131,196,202,1542,SF
1983,27,42,695,115,243,0,9,115,234,33,41,4,54,58,113,23,3,71,94,263,SG
1983,25,53,699,110,206,0,2,110,204,41,53,71,109,180,47,19,12,43,99,261,PF
1983,22,76,1248,226,527,10,25,216,502,150,180,56,81,137,138,58,17,106,134,612,PG
1983,22,43,494,92,216,4,14,88,202,38,45,16,26,42,67,19,9,40,56,226,PG
1983,22,33,754,134,311,6,11,128,300,112,135,40,55,95,71,39,8,66,78,386,PG
1983,26,77,1610,213,445,1,9,212,436,97,123,18,85,103,290,52,3,134,190,524,PG
1983,26,7,163,20,35,0,1,20,34,7,10,0,7,7,38,6,0,21,22,47,PG
1983,26,70,1447,193,410,1,8,192,402,90,113,18,78,96,252,46,3,113,168,477,PG
1983,29,73,2638,649,1423,15,45,634,1378,430,583,92,109,201,290,97,15,209,241,1743,SG
1983,29,19,700,164,364,0,3,164,361,106,149,22,22,44,89,15,3,50,66,434,SG
1983,29,54,1938,485,1059,15,42,470,1017,324,434,70,87,157,201,82,12,159,175,1309,SG
1983,22,75,1411,170,319,0,3,170,316,129,174,141,265,406,103,48,70,81,245,469,C
1983,26,4,34,4,11,0,1,4,10,2,2,3,4,7,3,0,0,3,4,10,SF
1983,30,78,2830,757,1553,12,33,745,1520,517,606,111,246,357,264,88,67,247,243,2043,SG
1983,33,82,2797,556,888,0,6,556,882,367,496,299,685,984,126,40,192,254,273,1479,C
1983,27,73,1124,230,444,0,1,230,443,74,89,16,74,90,125,30,9,52,132,534,SG
1983,23,80,1255,213,426,0,1,213,425,175,225,154,228,382,61,35,116,126,118,601,C
1983,27,76,1130,134,294,0,3,134,291,82,114,108,193,301,100,80,9,49,161,350,PF
1983,28,78,2783,464,942,2,13,462,929,185,232,62,161,223,697,220,4,222,154,1115,PG
1983,25,79,2355,312,686,0,4,312,682,165,233,217,548,765,151,54,90,154,261,789,PF
1983,21,9,26,7,13,0,0,7,13,5,6,2,4,6,0,0,1,2,4,19,SF
1983,29,41,756,114,294,15,38,99,256,54,69,18,31,49,49,18,7,27,61,297,SF
1983,29,53,956,60,116,0,0,60,116,53,76,77,139,216,86,33,25,68,153,173,PF
1983,24,77,2787,752,1554,38,132,714,1422,167,246,100,204,304,270,138,33,252,184,1709,SG
1983,29,27,373,35,82,1,3,34,79,12,19,32,34,66,34,22,7,24,69,83,SF
1983,27,77,1422,167,377,0,4,167,373,81,98,42,121,163,136,40,10,84,172,415,SF
1983,25,82,1547,187,437,1,7,186,430,125,160,80,156,236,268,75,15,144,220,500,SF
1983,27,6,139,19,44,1,9,18,35,0,0,3,8,11,21,2,0,9,14,39,SG
1983,22,21,98,8,22,0,1,8,21,7,14,10,21,31,1,5,0,6,31,23,C
1983,22,10,42,5,16,0,2,5,14,4,6,5,5,10,2,1,1,3,3,14,PF
1983,32,77,1416,163,390,5,21,158,369,69,94,81,280,361,95,38,14,107,189,400,PF
1983,32,46,860,91,244,2,14,89,230,46,62,53,175,228,59,29,8,73,110,230,PF
1983,32,31,556,72,146,3,7,69,139,23,32,28,105,133,36,9,6,34,79,170,PF
1983,37,81,2302,424,890,2,4,422,886,196,287,199,417,616,158,50,81,200,232,1046,PF
1983,27,65,1058,104,217,0,1,104,216,29,51,102,134,236,36,17,41,49,215,237,C
1983,33,38,775,125,312,0,1,125,311,63,87,77,106,183,30,12,27,67,94,313,PF
1983,27,82,1551,286,618,3,16,283,602,96,133,57,67,124,195,95,3,128,190,671,PG
1983,31,51,789,107,263,0,2,107,261,45,57,18,51,69,138,37,2,50,57,259,SG
1983,23,82,2196,313,698,13,41,300,657,209,264,159,207,366,175,66,65,127,248,848,SF
1983,25,82,1155,100,217,1,5,99,212,63,136,45,105,150,153,85,34,106,205,264,SG
1983,29,14,169,14,26,0,0,14,26,18,22,5,15,20,27,9,0,13,20,46,PG
1983,22,76,2022,318,704,20,90,298,614,94,130,53,69,122,275,82,4,161,192,750,SG
1983,29,56,1844,313,717,3,21,310,696,129,179,30,98,128,373,111,14,198,155,758,PG
1983,26,82,1953,288,597,0,2,288,595,204,296,222,249,471,89,87,8,158,271,780,SF
1983,25,80,2716,401,832,4,12,397,820,168,245,41,118,159,487,74,4,195,215,974,PG
1983,26,80,1612,163,353,0,2,163,351,78,113,117,212,329,83,32,44,133,238,404,PF
1983,34,80,2431,661,1296,4,19,657,1277,400,479,151,445,596,223,83,43,174,227,1726,C
1983,23,78,1309,199,426,2,13,197,413,92,126,87,92,179,105,64,11,83,132,492,SG
1983,26,48,447,53,135,0,2,53,133,38,48,40,29,69,24,22,4,25,62,144,SG
1983,26,83,1914,299,581,0,1,299,580,111,180,190,334,524,139,67,92,124,221,709,C
1983,26,51,1216,208,399,0,1,208,398,77,122,115,204,319,115,51,63,88,137,493,C
1983,26,32,698,91,182,0,0,91,182,34,58,75,130,205,24,16,29,36,84,216,C
1983,28,77,2551,398,861,5,31,393,830,292,369,92,243,335,388,97,39,204,204,1093,PG
1983,27,61,1813,389,858,14,41,375,817,186,237,26,98,124,318,61,6,156,138,978,SG
1983,23,82,2933,677,1370,20,71,657,1299,247,317,191,310,501,216,70,20,181,259,1621,SF
1983,24,68,2324,321,786,14,61,307,725,196,261,46,132,178,549,110,6,238,170,852,PG
1983,34,37,461,25,57,0,0,25,57,14,19,44,73,117,17,10,59,19,69,64,C
1983,26,82,2297,409,858,7,38,402,820,126,172,176,369,545,220,77,53,242,279,951,SF
1983,23,79,2907,511,933,0,21,511,912,304,380,214,469,683,829,176,47,301,200,1326,SG
1983,26,80,2853,723,1420,4,20,719,1400,264,359,196,366,562,363,100,56,196,211,1714,SF
1983,30,78,2053,391,921,3,36,388,885,312,380,163,331,494,255,82,46,238,288,1097,PF
1983,30,6,153,30,66,0,2,30,64,7,9,9,16,25,11,1,2,12,22,67,PF
1983,30,42,1001,199,496,2,17,197,479,164,201,66,158,224,144,56,21,121,135,564,PF
1983,30,30,899,162,359,1,17,161,342,141,170,88,157,245,100,25,23,105,131,466,PF
1983,25,79,1541,247,509,1,4,246,505,95,130,107,184,291,71,26,43,104,232,590,SF
1983,25,50,992,178,355,1,4,177,351,73,100,75,126,201,48,18,26,69,150,430,SF
1983,25,29,549,69,154,0,0,69,154,22,30,32,58,90,23,8,17,35,82,160,SF
1983,25,79,1544,371,595,0,0,371,595,186,324,140,258,398,95,40,83,180,323,928,C
1983,26,82,2511,520,1013,11,40,509,973,245,315,167,186,353,301,93,49,152,263,1296,SG
1983,22,7,54,2,10,0,0,2,10,3,5,4,12,16,1,1,1,4,9,7,C
1983,22,16,137,9,20,0,0,9,20,6,15,11,19,30,10,2,6,11,24,24,PF
1983,31,74,1749,250,460,0,1,250,459,165,208,102,242,344,142,85,91,109,199,665,PF
1983,32,82,2440,307,677,0,2,307,675,162,206,222,446,668,138,46,131,171,278,776,C
1983,30,81,1164,148,325,0,1,148,324,79,123,84,225,309,62,31,23,101,172,375,PF
1983,30,49,673,86,193,0,0,86,193,47,75,56,139,195,40,18,14,66,90,219,PF
1983,30,32,491,62,132,0,1,62,131,32,48,28,86,114,22,13,9,35,82,156,PF
1983,26,77,1658,237,479,2,9,235,470,201,286,136,312,448,89,42,108,146,267,677,PF
1983,26,49,1036,145,294,2,6,143,288,117,172,80,191,271,69,28,77,103,160,409,PF
1983,26,28,622,92,185,0,3,92,182,84,114,56,121,177,20,14,31,43,107,268,PF
1983,23,9,85,17,37,0,0,17,37,6,6,10,7,17,4,3,0,6,14,40,SF
1983,29,60,878,142,311,0,2,142,309,56,102,114,149,263,39,22,22,83,104,340,PF
1983,28,35,333,40,132,3,16,37,116,11,17,8,18,26,80,31,1,54,52,94,PG
1983,26,34,309,39,88,2,8,37,80,25,30,18,25,43,17,15,2,17,39,105,SF
1983,29,70,1345,130,293,0,0,130,293,142,175,131,273,404,138,54,39,118,221,402,C
1983,29,38,565,59,141,0,0,59,141,55,70,61,111,172,59,21,18,53,115,173,C
1983,29,32,780,71,152,0,0,71,152,87,105,70,162,232,79,33,21,65,106,229,C
1983,21,81,2761,680,1420,4,18,676,1402,261,352,340,520,860,223,141,43,217,298,1625,PF
1983,25,80,1507,247,450,0,3,247,447,173,257,158,245,403,97,52,35,149,243,667,SF
1983,30,48,770,119,257,0,1,119,256,42,57,66,81,147,39,23,9,47,64,280,PF
1983,30,5,25,2,6,0,0,2,6,0,0,1,3,4,0,1,0,2,2,4,PF
1983,30,11,121,17,39,0,0,17,39,7,11,13,13,26,5,1,0,6,13,41,PF
1983,30,32,624,100,212,0,1,100,211,35,46,52,65,117,34,21,9,39,49,235,PF
1983,23,79,2447,582,1226,6,23,576,1203,176,227,157,299,456,291,95,41,245,278,1346,SF
1983,26,68,2207,603,1142,0,6,603,1136,280,388,99,227,326,195,90,13,197,233,1486,SF
1983,25,58,995,104,225,0,0,104,225,73,96,91,149,240,58,28,11,65,94,281,SF
1983,30,80,2262,512,984,3,19,509,965,343,408,152,172,324,192,66,8,193,143,1370,SG
1983,22,17,201,23,51,0,1,23,50,21,25,18,44,62,9,9,2,8,21,67,PF
1983,27,54,458,44,104,0,1,44,103,14,16,41,47,88,37,15,6,22,63,102,C
1983,34,60,1232,111,264,2,9,109,255,29,37,62,169,231,118,29,25,98,209,253,C
1983,25,82,2871,436,877,2,13,434,864,245,310,282,711,993,263,51,118,176,320,1119,C
1983,23,59,690,107,252,1,6,106,246,42,52,25,51,76,58,20,3,38,67,257,SF
1983,27,39,356,43,102,0,0,43,102,12,25,55,73,128,12,8,4,20,48,98,PF
1983,34,39,978,163,332,0,1,163,331,91,133,58,142,200,105,34,24,82,125,417,C
1983,25,79,2602,439,1059,42,175,397,884,247,297,64,131,195,530,165,14,198,215,1167,PG
1983,24,65,1437,202,446,0,5,202,441,124,171,46,126,172,332,51,6,134,121,528,PG
1983,22,81,2020,256,594,5,15,251,579,116,159,85,140,225,426,153,15,137,179,633,PG
1983,22,62,879,131,270,0,1,131,269,84,147,104,128,232,52,23,36,73,125,346,PF
1983,24,7,53,4,6,0,0,4,6,0,4,1,11,12,4,1,3,5,16,8,PF
1983,24,80,1885,272,514,0,0,272,514,130,242,168,400,568,111,50,177,186,328,674,PF
1983,23,73,1350,293,566,1,4,292,562,100,139,77,183,260,130,61,31,118,109,687,SG
1983,30,15,206,19,50,0,1,19,49,11,17,19,27,46,21,6,6,6,24,49,C
1983,23,66,818,138,300,5,9,133,291,53,80,37,88,125,72,29,8,64,98,334,SF
1983,26,70,1485,312,692,2,7,310,685,111,146,56,124,180,105,44,12,144,130,737,SG
1983,29,35,386,62,131,0,5,62,126,21,42,8,21,29,102,25,1,47,18,145,PG
1983,30,77,2586,495,1045,1,3,494,1042,278,356,201,598,799,219,56,43,221,274,1269,PF
1983,24,73,1171,170,360,0,4,170,356,101,131,85,105,190,71,41,10,89,189,441,SF
1983,25,82,1836,328,634,23,76,305,558,129,148,41,124,165,278,64,8,90,130,808,PG
1983,23,14,56,4,16,0,1,4,15,4,8,2,8,10,2,2,0,2,5,12,SF
1983,24,82,3023,376,768,0,3,376,765,146,254,171,608,779,115,86,148,170,335,898,PF
1983,27,78,2922,654,1305,0,1,654,1304,600,788,445,749,1194,101,89,157,264,206,1908,C
1983,23,64,1187,171,424,14,48,157,376,86,112,25,66,91,249,60,8,123,129,442,PG
1983,27,79,2252,331,663,0,1,331,662,280,345,185,237,422,186,65,39,165,202,942,SF
1983,28,9,155,21,50,0,0,21,50,17,21,10,16,26,12,5,2,13,24,59,SF
1983,31,47,1019,292,562,0,1,292,561,119,163,76,171,247,39,40,40,68,153,703,C
1983,23,56,505,58,126,0,2,58,124,47,61,54,65,119,24,8,11,40,84,163,PF
1983,23,14,130,13,29,0,0,13,29,14,18,15,15,30,4,2,4,8,26,40,PF
1983,23,42,375,45,97,0,2,45,95,33,43,39,50,89,20,6,7,32,58,123,PF
1983,23,39,381,69,163,1,7,68,156,17,23,33,20,53,26,11,5,27,50,156,SF
1983,25,82,2345,483,893,0,1,483,892,193,269,215,338,553,104,34,192,159,241,1159,PF
1983,27,68,1559,266,546,0,7,266,539,136,167,21,100,121,288,39,5,101,142,668,PG
1983,30,61,1364,198,424,0,1,198,423,108,133,57,160,217,76,17,24,80,143,504,C
1983,23,36,182,29,64,0,0,29,64,20,45,34,42,76,7,3,3,36,42,78,C
1983,29,78,1706,258,453,0,0,258,453,102,163,150,274,424,64,47,86,118,285,618,C
1983,27,80,2803,686,1342,0,3,686,1339,219,289,188,349,537,98,57,52,126,248,1591,SF
1983,35,58,809,137,283,1,4,136,279,75,88,38,99,137,70,33,3,45,71,350,SF
1983,35,57,792,133,273,1,4,132,269,74,87,37,99,136,68,33,3,45,70,341,SF
1983,35,1,17,4,10,0,0,4,10,1,1,1,0,1,2,0,0,0,1,9,SF
1983,26,73,1128,119,260,0,1,119,259,50,68,76,184,260,49,21,44,67,223,288,C
1983,26,23,539,55,121,0,0,55,121,16,26,47,91,138,26,12,23,27,85,126,C
1983,26,50,589,64,139,0,1,64,138,34,42,29,93,122,23,9,21,40,138,162,C
1983,25,76,2710,606,1156,1,10,605,1146,499,604,192,245,437,300,113,23,197,180,1712,SG
1983,24,77,2552,394,841,5,22,389,819,148,199,65,212,277,753,194,32,226,247,941,PG
1983,25,37,642,81,190,6,23,75,167,42,56,15,40,55,73,22,1,46,72,210,PG
1983,22,8,46,7,24,0,0,7,24,1,4,6,11,17,7,2,0,2,7,15,SG
1983,34,64,1423,337,754,4,14,333,740,138,150,34,40,74,158,59,4,89,163,816,PG
1983,23,82,2914,588,1069,1,3,587,1066,193,287,239,471,710,197,99,217,190,254,1370,PF
1983,33,7,51,6,20,0,0,6,20,4,4,2,11,13,1,1,0,3,1,16,C
1983,26,80,2879,644,1187,3,20,641,1167,339,428,214,385,599,171,63,29,203,184,1630,SF
1983,24,22,210,38,73,0,2,38,71,9,14,6,16,22,28,5,0,22,36,85,SG
1983,22,82,1643,147,247,0,0,147,247,70,114,170,315,485,62,68,12,51,247,364,PF
1983,23,6,64,11,15,0,0,11,15,1,4,6,11,17,0,1,12,7,14,23,C
1983,24,9,148,26,59,0,1,26,58,11,17,8,18,26,11,6,0,11,17,63,SG
1983,24,81,1515,174,355,1,1,173,354,77,140,157,247,404,115,24,111,66,287,426,C
1983,27,79,2711,533,1123,0,13,533,1110,125,168,61,144,205,566,104,4,237,176,1191,PG
1983,22,30,311,26,63,0,0,26,63,14,30,25,44,69,24,13,2,33,61,66,C
1983,24,46,803,136,259,2,9,134,250,34,48,42,72,114,82,42,11,62,67,308,SF
1983,26,80,1817,251,522,2,12,249,510,194,248,108,250,358,131,50,9,152,246,698,PF
1983,25,16,171,31,58,0,0,31,58,12,22,18,29,47,5,5,13,13,30,74,C
1983,24,82,1666,274,593,0,2,274,591,140,175,94,134,228,94,64,24,93,134,688,SF
1983,33,49,725,81,192,0,0,81,192,45,66,66,120,186,44,12,14,48,115,207,C
1983,29,78,2459,619,1125,0,1,619,1124,271,388,260,567,827,141,79,148,185,222,1509,C
1983,34,64,820,101,227,0,0,101,227,27,59,64,136,200,61,17,18,47,109,229,C
1983,34,57,695,89,200,0,0,89,200,26,57,54,113,167,57,12,12,41,95,204,C
1983,34,7,125,12,27,0,0,12,27,1,2,10,23,33,4,5,6,6,14,25,C
1983,25,81,2740,682,1323,4,25,678,1298,388,478,68,106,174,231,140,17,156,160,1756,SG
1983,31,6,29,6,16,0,0,6,16,0,0,2,6,8,1,0,0,2,3,12,PF
1983,31,2,9,2,6,0,0,2,6,0,0,0,0,0,1,0,0,0,0,4,PF
1983,31,4,20,4,10,0,0,4,10,0,0,2,6,8,0,0,0,2,3,8,PF
1983,26,62,599,120,267,3,14,117,253,43,56,39,45,84,60,30,8,49,92,286,SG
1983,21,48,416,56,138,0,2,56,136,40,59,27,50,77,29,14,8,50,58,152,SF
1983,23,39,265,33,88,1,7,32,81,18,32,15,20,35,14,8,4,18,42,85,SG
1983,24,28,170,19,40,0,1,19,39,25,37,13,18,31,7,2,7,22,41,63,PF
1983,27,75,2331,329,697,1,5,328,692,166,221,155,366,521,168,64,116,100,264,825,PF
1983,32,11,210,21,40,0,0,21,40,5,6,2,3,5,46,10,0,21,30,47,PG
1983,24,79,1528,213,466,1,9,212,457,105,176,83,198,281,207,99,47,162,174,532,SG
1983,23,54,439,84,172,4,18,80,154,30,73,12,35,47,104,34,4,74,78,202,SG
1983,26,34,292,33,83,0,1,33,82,29,43,25,19,44,22,10,1,25,35,95,SF
1983,24,78,1806,235,413,0,2,235,411,114,166,164,367,531,90,105,63,145,233,584,PF
1983,24,76,1607,343,746,2,16,341,730,152,199,44,103,147,280,58,4,129,109,840,PG
1983,25,45,433,70,153,0,1,70,152,33,51,37,89,126,39,24,19,50,83,173,PF
1983,26,77,1755,259,559,0,6,259,553,71,111,98,149,247,168,71,18,99,164,589,SG
1983,27,64,2076,346,815,8,51,338,764,106,163,113,182,295,432,182,24,244,240,806,PG
1983,27,33,1074,176,427,4,31,172,396,55,87,45,100,145,245,101,9,137,124,411,PG
1983,27,31,1002,170,388,4,20,166,368,51,76,68,82,150,187,81,15,107,116,395,PG
1983,27,59,855,100,214,0,0,100,214,45,78,79,140,219,65,13,8,72,131,245,C
1983,22,77,2601,587,1230,0,5,587,1225,213,301,190,666,856,145,61,58,224,272,1387,PF
1983,22,35,147,35,97,1,11,34,86,30,45,6,11,17,21,4,2,13,18,101,SG
1983,31,81,2426,326,706,0,0,326,706,118,201,199,458,657,145,57,24,190,241,770,PF
1983,33,61,711,96,251,0,1,96,250,92,118,34,117,151,53,10,9,45,61,284,C
1983,27,80,2472,261,512,0,1,261,511,98,135,210,533,743,75,49,343,95,294,620,C
1983,24,82,2130,266,572,10,33,256,539,78,105,23,115,138,455,98,5,141,142,620,PG
1983,29,77,2811,561,1193,5,27,556,1166,337,450,259,621,880,225,60,115,245,239,1464,PF
1983,24,79,2862,580,1051,1,3,579,1048,375,544,293,578,871,234,74,77,297,312,1536,C
1983,22,68,757,67,184,2,18,65,166,47,58,19,54,73,131,16,1,92,71,183,PG
1983,22,26,393,76,157,0,2,76,155,31,43,31,63,94,19,18,6,28,57,183,SF
1983,23,82,2284,342,749,0,1,342,748,228,295,200,435,635,205,54,98,253,325,912,C
1983,23,50,1638,231,514,0,1,231,513,157,195,137,312,449,165,39,68,195,216,619,C
1983,23,32,646,111,235,0,0,111,235,71,100,63,123,186,40,15,30,58,109,293,C
1983,22,77,1222,207,435,1,4,206,431,61,83,96,159,255,59,25,23,81,192,476,PF
1983,22,46,702,106,207,0,1,106,206,21,28,52,102,154,32,13,9,46,118,233,PF
1983,22,31,520,101,228,1,3,100,225,40,55,44,57,101,27,12,14,35,74,243,PF
1983,27,81,1139,124,259,0,2,124,257,81,110,60,164,224,97,48,31,64,133,329,SF
1983,27,82,2572,437,915,1,6,436,909,141,187,158,337,495,237,75,72,172,310,1016,PF
1983,23,64,1624,171,421,1,13,170,408,52,80,43,106,149,311,96,14,104,112,395,PG
1983,25,67,2397,589,1209,4,15,585,1194,255,308,145,209,354,228,94,14,194,242,1437,SF
1983,26,78,2435,316,661,3,18,313,643,92,107,33,122,155,433,104,2,138,185,727,PG
1983,27,75,2564,484,1043,0,8,484,1035,400,478,213,645,858,233,87,65,190,263,1368,C
1983,22,63,515,89,238,9,41,80,197,38,59,34,34,68,52,36,7,42,93,225,SG
1983,21,27,154,21,51,0,2,21,49,17,25,10,28,38,2,0,4,11,40,59,SF
1983,24,4,18,3,4,0,0,3,4,2,4,0,5,5,0,0,0,0,4,8,PF
1983,25,49,1433,180,306,0,0,180,306,53,99,209,276,485,46,36,20,83,186,413,PF
1983,30,79,1238,175,400,3,8,172,392,101,133,27,103,130,216,44,8,102,113,454,SG
1983,34,80,1406,273,565,3,18,270,547,114,131,37,59,96,206,56,0,98,139,663,SG
1983,34,65,1264,244,499,3,16,241,483,101,117,35,53,88,192,54,0,89,122,592,SG
1983,34,15,142,29,66,0,2,29,64,13,14,2,6,8,14,2,0,9,17,71,SG
1983,27,12,68,7,24,0,2,7,22,9,10,1,5,6,8,5,0,6,13,23,PG
1983,27,5,43,2,13,0,1,2,12,7,8,1,2,3,6,4,0,3,7,11,PG
1983,27,7,25,5,11,0,1,5,10,2,2,0,3,3,2,1,0,3,6,12,PG
1983,30,41,1438,234,534,23,55,211,479,154,185,35,67,102,218,61,14,147,158,645,SG
1983,25,48,722,91,197,2,10,89,187,88,113,27,57,84,78,27,3,55,59,272,SG
1983,24,81,2428,392,810,5,22,387,788,147,199,61,169,230,397,107,5,197,255,936,PG
1983,24,49,1548,264,512,3,15,261,497,84,113,39,102,141,238,70,1,126,162,615,PG
1983,24,32,880,128,298,2,7,126,291,63,86,22,67,89,159,37,4,71,93,321,PG
1983,23,9,39,8,20,0,0,8,20,5,7,2,7,9,3,1,2,2,3,21,SF
1983,23,62,606,84,176,1,7,83,169,76,100,25,48,73,68,26,3,55,92,245,SG
1983,23,44,774,64,160,0,1,64,159,30,46,25,53,78,110,40,15,60,82,158,SG
1983,22,31,321,37,102,0,0,37,102,21,32,19,17,36,41,20,2,30,54,95,SG
1983,22,73,1708,332,776,10,29,322,747,87,125,74,120,194,150,53,18,137,171,761,SG
1983,26,55,514,39,106,0,2,39,104,10,15,27,72,99,46,24,13,20,79,88,SG
1983,25,82,2856,749,1567,21,91,728,1476,434,542,91,209,300,484,143,17,321,281,1953,PG
1983,22,49,521,74,170,1,7,73,163,45,78,28,44,72,36,19,4,48,93,194,SF
1983,21,81,3093,725,1537,36,125,689,1412,368,518,105,223,328,634,199,29,326,318,1854,PG
1983,22,44,520,43,137,0,0,43,137,36,46,41,79,120,34,12,7,31,92,122,PF
1983,28,75,2155,445,925,2,10,443,915,298,380,96,174,270,222,47,33,163,142,1190,SG
1983,21,71,987,147,287,0,1,147,286,89,137,133,242,375,33,40,61,96,186,383,C
1983,28,80,3017,505,1033,0,1,505,1032,249,401,183,570,753,380,68,110,281,213,1259,C
1983,22,52,526,76,181,0,1,76,180,16,28,41,89,130,18,8,30,22,76,168,C
1983,22,15,44,7,23,0,1,7,22,2,6,4,5,9,2,0,2,4,8,16,C
1983,22,37,482,69,158,0,0,69,158,14,22,37,84,121,16,8,28,18,68,152,C
1983,24,73,1107,157,314,0,3,157,311,52,103,72,170,242,50,26,47,83,153,366,PF
1983,24,45,712,100,190,0,2,100,188,24,44,46,105,151,31,16,24,51,97,224,PF
1983,24,28,395,57,124,0,1,57,123,28,59,26,65,91,19,10,23,32,56,142,PF
1983,25,81,2474,626,1250,22,76,604,1174,324,411,42,183,225,365,80,17,271,255,1598,SG
1983,23,55,516,105,234,9,25,96,209,28,38,30,35,65,31,19,5,33,81,247,SF
1983,23,58,2252,565,1156,14,37,551,1119,392,464,126,138,264,237,67,20,187,157,1536,SF
1983,23,78,1830,299,647,14,30,285,617,43,64,75,141,216,195,56,6,70,235,655,SG
1983,23,59,879,96,238,2,3,94,235,20,30,68,84,152,88,47,0,59,75,214,SF
1983,26,82,2543,421,880,2,15,419,865,146,196,180,360,540,157,103,160,120,221,990,SF
1983,23,47,1298,209,460,0,1,209,459,169,213,34,83,117,293,101,5,131,139,587,PG
1983,31,13,63,5,14,0,0,5,14,5,6,2,11,13,5,2,2,3,9,15,SF
1983,24,82,2909,841,1537,15,51,826,1486,489,559,124,313,437,203,66,38,177,198,2186,PF
1983,23,48,527,87,171,0,1,87,170,21,31,44,52,96,32,18,9,40,95,195,PF
1983,23,81,2726,622,1272,0,3,622,1269,269,343,217,375,592,212,70,45,188,295,1513,PF
1983,24,82,2054,226,429,0,1,226,428,115,209,177,248,425,120,53,49,102,254,567,SF
1983,31,79,1388,114,250,2,12,112,238,116,149,30,106,136,264,78,3,104,134,346,PG
1983,28,82,2251,362,806,1,4,361,802,72,116,137,236,373,199,37,22,144,202,797,SF
1983,30,33,1099,200,379,0,0,200,379,65,117,75,248,323,120,34,119,105,113,465,C
1983,23,43,727,65,171,0,5,65,166,42,57,15,54,69,126,21,8,71,103,172,PG
1983,30,82,1472,168,331,0,1,168,330,106,180,176,267,443,49,35,131,102,210,442,C
1983,30,75,1793,374,788,10,32,364,756,85,107,98,184,282,117,43,17,126,228,843,SF
1983,30,35,1290,280,583,9,22,271,561,65,77,69,139,208,86,23,11,94,145,634,SF
1983,30,40,503,94,205,1,10,93,195,20,30,29,45,74,31,20,6,32,83,209,SF
1983,32,80,1978,318,693,14,48,304,645,148,184,19,96,115,439,87,16,196,180,798,SG
1983,23,65,626,127,234,0,1,127,233,70,109,47,58,105,30,16,2,51,54,324,SF
1983,26,46,905,164,306,0,0,164,306,72,87,105,156,261,42,21,15,65,139,400,C
1983,28,77,1702,213,511,0,4,213,507,93,124,62,180,242,189,68,16,160,157,519,SF
1983,29,80,2552,684,1290,0,6,684,1284,203,268,146,197,343,182,65,17,150,221,1571,SF
1983,24,9,129,11,34,0,1,11,33,12,15,9,10,19,10,3,1,5,22,34,SF
1983,23,82,2697,601,1220,2,11,599,1209,230,337,226,252,478,129,84,63,180,210,1434,SF
1983,27,81,2307,389,816,0,3,389,813,156,200,154,442,596,132,41,42,186,251,934,C
1983,22,82,2961,536,912,0,4,536,908,324,523,365,662,1027,125,91,110,246,270,1396,PF
1983,26,18,210,36,101,2,7,34,94,18,25,3,14,17,10,6,1,12,30,92,SG
1983,29,80,2761,660,1384,2,43,658,1341,278,370,72,133,205,643,182,26,230,117,1600,PG
1983,24,78,2513,580,1163,0,7,580,1156,155,220,151,432,583,262,54,171,229,230,1315,C
1983,28,72,2170,419,1068,15,74,404,994,256,333,93,234,327,569,120,26,335,248,1109,PG
1983,25,44,346,56,135,0,3,56,132,35,53,15,23,38,37,20,4,38,42,147,SG
1983,21,74,1443,191,468,2,15,189,453,131,174,37,99,136,361,89,12,185,221,515,PG
1983,23,75,1533,252,479,0,1,252,478,123,171,153,240,393,45,71,89,101,244,627,PF
1983,25,68,1385,314,647,2,19,312,628,176,259,94,196,290,133,73,3,133,166,806,PF
1983,25,62,1146,147,324,6,14,141,310,43,55,63,138,201,64,25,17,61,139,343,SF
1983,25,52,1062,136,295,6,13,130,282,41,53,61,129,190,56,24,16,56,123,319,SF
1983,25,10,84,11,29,0,1,11,28,2,2,2,9,11,8,1,1,5,16,24,SF
1983,30,57,1361,255,587,22,68,233,519,73,85,35,75,110,156,45,4,81,132,605,SG
1983,24,76,1822,343,740,15,50,328,690,124,161,96,140,236,134,55,36,111,188,825,SF
1983,24,81,2426,584,1154,7,33,577,1121,298,377,84,164,248,254,137,59,174,203,1473,SG
1983,23,57,1627,361,622,0,3,361,619,217,340,122,176,298,97,38,44,157,177,939,SF
1983,21,77,1970,447,772,1,4,446,768,138,221,157,242,399,132,91,64,178,221,1033,SF
1983,29,7,30,1,5,0,0,1,5,0,0,3,5,8,1,1,3,4,9,2,C
1984,36,80,2622,716,1238,0,1,716,1237,285,394,169,418,587,211,55,143,221,211,1717,C
1984,29,70,1452,269,582,0,4,269,578,132,160,118,201,319,219,73,31,117,195,670,C
1984,24,79,2900,925,1765,15,56,910,1709,465,621,161,308,469,358,80,22,285,246,2330,SF
1984,24,71,1154,166,361,6,22,160,339,46,56,29,87,116,162,41,4,70,143,384,SG
1984,23,48,311,55,130,0,3,55,127,12,29,38,25,63,22,15,9,20,28,122,SF
1984,23,78,1380,272,638,3,19,269,619,116,150,136,270,406,193,46,28,109,183,663,PF
1984,35,46,1038,136,279,4,18,132,261,64,101,16,60,76,160,33,0,78,78,340,PG
1984,22,7,28,6,13,0,0,6,13,0,0,2,1,3,1,1,1,3,7,12,SF
1984,23,76,1712,257,607,2,17,255,590,157,198,49,107,156,333,78,4,170,113,673,PG
1984,26,73,1174,254,517,0,1,254,516,138,192,104,190,294,79,33,40,101,197,646,PF
1984,22,81,2009,302,590,0,0,302,590,88,117,115,349,464,129,38,122,105,193,692,PF
1984,29,82,2701,510,1061,2,15,508,1046,166,208,140,348,488,290,94,35,142,214,1188,SF
1984,24,80,2600,424,747,1,6,423,741,200,270,204,378,582,254,105,23,166,256,1049,PF
1984,27,4,31,5,10,0,0,5,10,0,0,1,3,4,3,0,3,4,5,10,C
1984,29,82,1734,248,451,0,1,248,450,83,101,117,292,409,130,71,53,79,230,579,C
1984,27,79,3028,758,1542,18,73,740,1469,374,421,181,615,796,520,144,69,237,197,1908,PF
1984,28,69,2168,583,1147,5,20,578,1127,194,319,74,96,170,266,86,17,170,180,1365,SG
1984,24,81,3025,721,1320,1,11,720,1309,372,458,124,249,373,288,56,37,169,127,1815,SG
1984,30,38,261,28,52,1,1,27,51,16,21,28,36,64,16,9,0,13,58,73,PF
1984,24,8,39,3,7,0,0,3,7,5,7,0,3,3,5,0,1,8,6,11,SG
1984,28,82,1428,213,521,15,51,198,470,120,137,41,102,143,252,84,6,109,155,561,PG
1984,23,57,472,68,177,0,0,68,177,32,46,48,61,109,17,11,38,35,98,168,C
1984,28,53,992,179,403,3,14,176,389,52,67,22,41,63,50,24,21,40,64,413,SG
1984,28,13,210,27,58,0,1,27,57,11,17,5,8,13,6,6,5,7,10,65,SG
1984,28,40,782,152,345,3,13,149,332,41,50,17,33,50,44,18,16,33,54,348,SG
1984,30,81,2431,509,1094,6,31,503,1063,196,243,80,252,332,265,53,14,148,224,1220,SF
1984,25,47,1405,213,445,0,5,213,440,104,151,142,200,342,88,50,14,78,125,530,SF
1984,35,71,1129,258,506,9,34,249,472,77,86,14,48,62,194,49,2,70,84,602,SG
1984,25,68,785,94,201,0,0,94,201,48,65,67,114,181,29,18,23,53,161,236,C
1984,24,29,317,52,133,0,0,52,133,14,33,37,43,80,13,9,11,16,48,118,C
1984,29,79,1249,138,323,0,6,138,317,48,74,41,96,137,214,84,3,100,187,324,PG
1984,33,76,1327,150,352,18,59,132,293,63,80,29,87,116,303,86,1,87,62,381,PG
1984,28,82,2455,518,923,0,5,518,918,247,367,208,434,642,157,68,33,202,274,1283,PF
1984,33,60,585,70,171,3,15,67,156,42,48,26,49,75,49,17,4,46,67,185,SF
1984,25,80,2962,663,1390,0,1,663,1389,313,433,235,401,636,198,103,142,268,244,1639,C
1984,25,73,2045,413,862,15,46,398,816,136,178,70,83,153,206,128,13,141,211,977,SG
1984,22,55,688,145,316,5,19,140,297,47,61,38,48,86,71,19,4,42,81,342,SG
1984,26,77,2487,453,808,0,1,453,807,404,502,195,454,649,107,44,97,200,262,1310,C
1984,32,69,1156,61,153,0,1,61,152,22,42,89,182,271,43,25,81,57,172,144,PF
1984,24,82,2570,554,1110,0,12,554,1098,375,469,219,313,532,133,47,51,192,309,1483,PF
1984,27,75,2494,386,702,8,20,378,682,170,232,44,161,205,478,171,20,182,196,950,PG
1984,23,31,127,19,52,0,2,19,50,16,18,7,10,17,17,8,1,12,13,54,SG
1984,25,61,957,187,387,1,5,186,382,65,89,62,67,129,67,43,14,80,119,440,SG
1984,23,48,446,81,163,0,3,81,160,56,91,19,37,56,38,23,18,46,49,218,SF
1984,24,82,2573,360,730,1,6,359,724,186,259,132,173,305,401,162,12,143,176,907,SG
1984,25,82,1870,304,687,11,46,293,641,95,126,51,105,156,356,164,36,142,184,714,PG
1984,27,81,1950,188,387,1,2,187,385,94,130,174,310,484,123,68,47,91,282,471,C
1984,27,82,2387,273,549,38,121,235,428,155,185,53,209,262,482,113,67,148,267,739,SG
1984,27,81,1662,304,663,0,7,304,656,185,230,176,300,476,76,26,106,110,247,793,C
1984,27,82,2674,385,824,3,9,382,815,231,275,169,406,575,202,58,120,175,227,1004,C
1984,35,15,215,20,52,1,6,19,46,12,16,5,15,20,38,8,0,10,11,53,PG
1984,35,6,107,11,30,1,6,10,24,7,11,2,7,9,17,5,0,4,7,30,PG
1984,35,9,108,9,22,0,0,9,22,5,5,3,8,11,21,3,0,6,4,23,PG
1984,28,7,23,1,8,0,0,1,8,3,6,6,3,9,1,1,1,4,4,5,C
1984,22,45,354,64,112,0,0,64,112,38,91,35,47,82,22,12,7,19,58,166,C
1984,27,80,2492,452,915,0,2,452,913,141,190,151,507,658,158,64,23,146,282,1045,PF
1984,22,81,2907,737,1491,0,3,737,1488,380,528,323,454,777,139,92,57,218,298,1854,PF
1984,26,73,907,81,177,0,1,81,176,31,59,86,201,287,36,24,31,55,143,193,C
1984,23,82,2449,583,1229,4,32,579,1197,321,396,61,174,235,254,109,11,220,218,1491,SG
1984,27,79,2984,802,1438,1,4,801,1434,813,946,179,269,448,310,61,4,263,201,2418,SF
1984,28,81,2665,345,651,7,38,338,613,199,238,41,146,187,561,94,13,166,218,896,PG
1984,25,46,467,103,218,1,9,102,209,24,39,34,69,103,30,14,10,36,58,231,SF
1984,28,75,2079,354,800,0,8,354,792,217,256,53,86,139,326,62,6,134,146,925,PG
1984,29,78,2546,652,1274,20,87,632,1187,233,270,38,164,202,429,107,12,213,202,1557,SG
1984,27,81,2417,507,855,2,5,505,850,341,464,159,382,541,123,60,136,231,386,1357,C
1984,23,75,1174,180,408,0,6,180,402,95,133,90,98,188,176,38,12,96,154,455,SF
1984,25,43,413,36,99,3,10,33,89,15,24,37,64,101,45,23,8,29,83,90,PF
1984,26,82,2525,360,604,0,0,360,604,249,327,165,484,649,90,40,139,171,214,969,C
1984,29,81,1797,511,1067,6,22,505,1045,402,517,146,192,338,135,88,2,192,208,1430,SF
1984,25,73,2363,474,1026,3,10,471,1016,243,313,33,113,146,558,121,10,194,170,1194,PG
1984,21,82,1408,252,559,1,4,251,555,123,169,112,123,235,153,107,29,123,209,628,SG
1984,29,17,404,70,127,19,45,51,82,32,40,6,22,28,78,12,1,36,51,191,PG
1984,28,80,2705,174,370,0,1,174,369,106,145,195,379,574,228,173,32,97,233,454,SG
1984,27,82,2139,194,416,0,1,194,415,73,123,148,447,595,113,25,351,98,303,461,C
1984,24,80,1034,132,293,0,6,132,287,92,132,29,56,85,200,33,5,93,90,356,PG
1984,23,55,622,158,321,0,0,158,321,94,126,46,42,88,34,26,7,61,83,410,SG
1984,23,40,521,135,274,0,0,135,274,76,101,40,30,70,27,22,6,45,67,346,SG
1984,23,15,101,23,47,0,0,23,47,18,25,6,12,18,7,4,1,16,16,64,SG
1984,24,60,654,84,221,0,1,84,220,34,48,12,47,59,90,31,5,46,78,202,PG
1984,28,72,1897,438,817,0,1,438,816,183,254,108,240,348,184,23,30,140,254,1059,C
1984,22,7,63,11,27,0,0,11,27,1,1,4,5,9,6,3,0,3,13,23,SG
1984,23,67,1059,225,493,12,29,213,464,87,121,106,144,250,56,41,9,78,118,549,SF
1984,31,65,832,64,157,0,0,64,157,27,38,62,103,165,30,29,30,46,153,155,PF
1984,24,46,360,33,83,0,0,33,83,14,23,27,70,97,11,9,3,24,68,80,C
1984,30,82,2870,907,1714,1,7,906,1707,352,427,216,248,464,406,83,95,222,252,2167,SF
1984,33,77,2683,678,1324,7,21,671,1303,364,483,190,342,532,309,141,139,230,217,1727,SF
1984,28,78,1687,243,564,32,89,211,475,111,131,23,115,138,288,61,4,117,175,629,PG
1984,30,32,402,29,52,0,0,29,52,25,34,29,57,86,11,16,8,19,49,83,PF
1984,23,77,2555,484,1045,8,45,476,1000,315,386,87,184,271,269,103,31,196,216,1291,PG
1984,27,81,2020,236,470,2,15,234,455,98,117,28,109,137,410,59,8,135,243,572,PG
1984,23,80,1424,260,580,22,84,238,496,122,155,39,81,120,172,54,9,108,193,664,PG
1984,30,75,2375,626,1407,22,69,604,1338,395,504,89,128,217,226,94,8,154,214,1669,SG
1984,23,80,1529,141,299,0,2,141,297,129,176,123,208,331,128,44,66,68,217,411,PF
1984,27,41,478,78,152,2,6,76,146,30,39,24,47,71,31,12,2,34,62,188,SF
1984,24,33,267,52,102,0,0,52,102,27,34,35,42,77,10,8,6,11,40,131,PF
1984,31,76,2584,765,1561,10,24,755,1537,427,507,106,207,313,220,79,47,224,219,1967,SG
1984,23,32,229,21,55,0,0,21,55,11,17,29,37,66,9,5,7,14,30,53,PF
1984,34,64,2034,351,556,0,3,351,553,280,390,213,449,662,70,36,132,149,229,982,C
1984,28,81,1503,312,554,1,2,311,552,56,70,17,87,104,171,46,5,63,146,681,SG
1984,24,82,1655,237,462,0,3,237,459,147,184,161,272,433,92,37,70,120,162,621,C
1984,22,56,738,97,226,4,13,93,213,53,70,8,47,55,134,24,0,57,97,251,PG
1984,29,81,2768,439,904,2,17,437,887,192,234,56,174,230,748,215,13,172,155,1072,PG
1984,23,49,667,100,228,0,0,100,228,55,77,58,116,174,25,18,17,60,128,255,PF
1984,26,78,2718,369,753,0,1,369,752,213,289,214,572,786,139,67,72,149,265,951,PF
1984,30,64,923,178,395,15,53,163,342,75,84,30,51,81,75,27,4,45,95,446,SG
1984,25,82,2650,697,1423,91,252,606,1171,151,217,95,243,338,283,114,23,243,202,1636,SG
1984,28,76,1119,166,362,2,9,164,353,64,83,24,97,121,108,43,7,71,151,398,SG
1984,23,55,419,65,145,0,8,65,137,18,28,13,35,48,44,15,4,35,62,148,SG
1984,26,80,1469,132,306,3,12,129,294,167,207,66,139,205,252,68,19,109,255,434,SF
1984,22,82,1712,200,451,3,26,197,425,66,98,53,119,172,239,95,21,111,143,469,PG
1984,23,68,1135,111,237,1,4,110,233,82,104,96,174,270,46,40,36,66,220,305,PF
1984,33,79,1153,114,237,1,4,113,233,61,78,50,170,220,99,24,16,52,144,290,PF
1984,38,81,994,158,389,0,2,158,387,86,132,87,173,260,71,16,28,82,123,402,PF
1984,28,43,253,26,50,0,0,26,50,5,14,19,43,62,13,5,18,13,52,57,C
1984,28,78,2088,376,718,20,57,356,661,136,177,68,79,147,300,117,14,161,209,908,PG
1984,24,78,1577,193,432,1,22,192,410,113,156,87,119,206,116,49,29,76,161,500,SF
1984,26,29,512,18,52,0,2,18,50,10,29,16,50,66,51,40,11,38,84,46,PG
1984,30,15,181,14,46,0,0,14,46,17,21,2,8,10,35,7,0,14,30,45,PG
1984,22,80,1858,184,371,0,0,184,371,69,117,175,324,499,69,31,145,109,306,437,SF
1984,23,76,1571,258,573,10,46,248,527,66,88,22,64,86,116,58,1,85,166,592,SG
1984,30,32,216,24,63,0,2,24,61,11,13,4,18,22,62,13,1,24,26,59,PG
1984,27,80,1799,321,628,0,1,321,627,221,299,172,208,380,86,71,6,115,244,863,SF
1984,26,77,2041,348,699,2,11,346,688,110,154,32,64,96,413,38,1,145,126,808,PG
1984,27,78,1532,149,322,0,2,149,320,97,131,91,219,310,95,36,55,124,222,395,PF
1984,35,76,2076,569,1153,4,19,565,1134,364,428,112,401,513,173,60,44,122,182,1506,C
1984,24,2,10,1,4,0,0,1,4,4,4,1,0,1,0,0,0,1,3,6,SG
1984,27,25,176,20,50,1,1,19,49,14,22,6,6,12,14,8,2,12,24,55,SG
1984,27,80,1721,193,412,0,0,193,412,69,113,131,267,398,55,35,65,95,205,455,C
1984,29,80,2665,384,878,4,32,380,846,281,330,87,193,280,338,93,57,172,251,1053,SG
1984,28,67,1893,353,798,16,43,337,755,164,213,31,115,146,374,58,7,173,155,886,SG
1984,24,82,2920,753,1552,20,64,733,1488,268,331,165,290,455,296,76,21,213,266,1794,SF
1984,25,82,2686,392,840,11,43,381,797,187,252,58,126,184,567,96,6,191,174,982,PG
1984,27,81,2073,411,884,11,47,400,837,223,270,139,321,460,195,82,49,186,256,1056,SF
1984,24,67,2567,441,780,6,29,435,751,290,358,99,392,491,875,150,49,306,169,1178,PG
1984,27,74,2715,646,1288,2,13,644,1275,241,340,173,307,480,315,115,45,180,194,1535,SF
1984,31,78,2122,359,852,5,29,354,823,339,432,198,320,518,219,101,30,216,290,1062,PF
1984,26,72,818,127,256,0,1,127,255,92,126,53,85,138,40,24,18,59,141,346,PF
1984,26,81,1487,302,540,0,0,302,540,165,287,162,256,418,81,37,69,164,307,769,C
1984,26,50,893,189,342,0,0,189,342,101,177,94,158,252,63,22,48,105,188,479,C
1984,26,31,594,113,198,0,0,113,198,64,110,68,98,166,18,15,21,59,119,290,C
1984,27,82,1909,426,901,4,19,422,882,207,275,130,107,237,271,44,19,135,196,1063,SG
1984,32,75,1761,226,432,0,1,226,431,167,213,92,231,323,187,107,103,101,199,619,PF
1984,33,81,2506,318,633,1,3,317,630,164,196,168,414,582,156,46,80,158,335,801,C
1984,26,1,3,0,1,0,0,0,1,1,4,0,0,0,0,0,0,0,1,1,PF
1984,27,81,1770,322,644,6,19,316,625,176,242,143,306,449,85,64,107,125,298,826,PF
1984,24,4,18,0,3,0,0,0,3,1,4,0,0,0,0,1,0,2,0,1,SF
1984,30,57,473,70,130,0,0,70,130,30,49,33,82,115,28,14,14,30,63,170,PF
1984,22,6,16,3,6,0,1,3,5,1,2,2,0,2,5,0,0,2,2,7,PG
1984,29,16,210,17,49,0,3,17,46,8,12,3,14,17,44,25,0,26,37,42,PG
1984,29,13,183,13,41,0,3,13,38,7,10,3,10,13,39,21,0,18,32,33,PG
1984,29,3,27,4,8,0,0,4,8,1,2,0,4,4,5,4,0,8,5,9,PG
1984,30,75,1674,132,264,0,0,132,264,124,162,140,350,490,157,55,29,148,273,388,C
1984,22,79,2676,619,1193,7,21,612,1172,261,340,230,489,719,234,121,28,218,242,1506,PF
1984,26,80,1783,313,603,2,6,311,597,250,356,188,203,391,91,68,31,195,249,878,SF
1984,24,79,2103,465,946,3,22,462,924,232,295,125,263,388,203,91,33,208,258,1165,SF
1984,27,77,2667,795,1391,0,4,795,1387,437,561,123,271,394,164,75,17,197,273,2027,SF
1984,26,77,2086,233,448,0,2,233,446,136,206,134,336,470,179,54,24,127,159,602,SF
1984,22,35,197,30,66,0,0,30,66,5,16,27,35,62,7,1,5,20,42,65,C
1984,31,75,1885,358,729,4,14,354,715,243,283,89,166,255,160,54,6,155,122,963,SF
1984,23,59,678,64,132,1,7,63,125,91,112,64,102,166,46,15,5,39,71,220,PF
1984,22,15,119,10,37,0,0,10,37,8,12,7,16,23,8,1,1,15,18,28,PF
1984,22,7,28,4,12,0,0,4,12,3,6,3,5,8,4,0,0,2,3,11,PF
1984,22,3,40,1,8,0,0,1,8,1,2,1,5,6,2,1,1,5,7,3,PF
1984,22,5,51,5,17,0,0,5,17,4,4,3,6,9,2,0,0,8,8,14,PF
1984,29,34,324,41,108,0,1,41,107,22,34,35,52,87,7,4,6,22,46,104,PF
1984,26,82,2864,553,1044,0,11,553,1033,316,365,329,674,1003,149,49,84,151,273,1422,C
1984,24,64,660,128,261,2,13,126,248,60,67,23,40,63,51,22,4,52,67,318,SF
1984,28,35,335,19,51,0,0,19,51,15,26,42,77,119,10,6,3,21,32,53,PF
1984,35,72,2007,392,685,0,3,392,682,194,274,141,314,455,186,58,51,163,228,978,C
1984,26,82,2009,349,731,11,71,338,660,238,286,31,86,117,459,107,12,184,199,947,PG
1984,25,43,687,78,188,1,5,77,183,75,87,20,26,46,168,30,6,72,59,232,PG
1984,23,81,2010,313,701,3,15,310,686,159,214,96,122,218,372,135,31,125,178,788,PG
1984,23,80,1746,229,436,0,3,229,433,125,186,234,311,545,109,44,78,77,281,583,PF
1984,25,3,14,1,1,0,0,1,1,0,2,3,1,4,1,0,0,1,6,2,PF
1984,25,82,1955,256,512,0,0,256,512,114,182,156,447,603,110,41,140,153,327,626,PF
1984,24,82,2578,610,1182,3,13,607,1169,235,298,128,167,295,321,102,44,245,211,1458,SG
1984,23,2,14,2,2,0,0,2,2,0,0,0,3,3,0,0,0,2,5,4,C
1984,24,11,137,19,43,1,3,18,40,9,13,7,11,18,14,3,5,11,16,48,SF
1984,24,10,133,19,43,1,3,18,40,9,13,7,11,18,14,3,5,11,15,48,SF
1984,27,82,2514,545,1155,1,5,544,1150,243,275,139,150,289,205,93,18,143,199,1334,SG
1984,24,78,1238,107,259,2,18,105,241,108,139,30,92,122,269,93,5,106,112,324,PG
1984,30,63,1807,275,595,19,69,256,526,120,157,23,157,180,673,92,5,147,123,689,PG
1984,31,75,2309,451,908,0,5,451,903,293,383,208,517,725,203,55,39,177,235,1195,PF
1984,25,8,65,12,30,0,0,12,30,11,13,5,6,11,3,1,0,6,17,35,SF
1984,26,82,2402,357,713,23,70,334,643,95,114,49,137,186,353,123,6,116,181,832,PG
1984,25,82,2701,307,605,0,0,307,605,125,192,169,569,738,131,62,123,142,358,739,PF
1984,22,81,1976,408,918,24,74,384,844,142,172,57,98,155,151,23,13,110,162,982,SG
1984,28,71,2613,532,1101,0,4,532,1097,545,727,352,598,950,96,71,110,250,188,1609,C
1984,23,57,469,50,126,3,13,47,113,18,23,23,36,59,47,25,2,23,63,121,SF
1984,24,20,388,61,131,1,8,60,123,27,36,7,20,27,83,16,3,40,45,150,PG
1984,24,6,96,16,30,0,1,16,29,18,22,1,3,4,21,5,1,10,13,50,PG
1984,24,14,292,45,101,1,7,44,94,9,14,6,17,23,62,11,2,30,32,100,PG
1984,28,80,2502,317,596,1,6,316,590,320,425,201,260,461,205,63,24,203,224,955,SF
1984,32,70,1456,352,748,0,5,352,743,212,264,82,207,289,74,42,50,127,182,916,C
1984,22,79,2081,335,672,1,4,334,668,182,249,173,277,450,176,53,54,120,205,853,SF
1984,23,47,520,47,121,0,0,47,121,35,50,45,70,115,44,11,19,34,73,129,PF
1984,24,57,611,85,197,0,3,85,194,38,56,63,92,155,37,14,2,49,77,208,PF
1984,24,77,1425,347,584,2,12,345,572,61,113,117,76,193,81,49,6,111,176,757,SF
1984,26,82,2577,587,1055,1,3,586,1052,336,439,208,402,610,104,23,126,150,243,1511,PF
1984,25,61,923,152,371,3,17,149,354,80,98,30,65,95,114,46,5,62,133,387,SG
1984,28,80,843,136,305,0,2,136,303,39,46,7,47,54,161,27,0,48,84,311,PG
1984,31,62,1294,222,447,1,6,221,441,127,156,64,135,199,73,14,17,70,162,572,C
1984,24,70,1037,157,253,0,0,157,253,74,157,137,180,317,31,14,12,89,138,388,C
1984,30,73,1501,193,363,0,0,193,363,94,123,111,242,353,51,35,61,83,247,480,C
1984,23,39,332,49,90,0,0,49,90,21,39,40,73,113,19,21,11,21,46,119,PF
1984,27,2,8,2,3,0,0,2,3,0,0,2,3,5,1,0,1,0,5,4,PF
1984,28,79,2853,779,1597,6,14,773,1583,275,353,188,382,570,93,62,73,141,251,1839,SF
1984,27,68,838,102,213,1,3,101,210,50,72,51,115,166,44,11,29,44,168,255,C
1984,26,79,3075,560,1125,5,18,555,1107,529,624,215,313,528,358,108,27,217,204,1654,SG
1984,25,59,1650,231,518,28,87,203,431,105,139,37,141,178,566,123,20,143,168,595,PG
1984,24,82,2899,601,1044,0,7,601,1037,249,352,227,451,678,214,86,174,177,274,1451,PF
1984,34,69,829,124,253,0,1,124,252,63,91,81,183,264,27,25,7,68,150,311,C
1984,27,79,2638,500,857,2,17,498,840,275,345,166,310,476,179,69,22,166,218,1277,SF
1984,23,71,960,63,126,0,0,63,126,48,60,73,149,222,50,41,9,33,138,174,PF
1984,25,82,2284,272,523,1,4,271,519,101,162,182,331,513,176,41,144,98,283,646,C
1984,28,82,3053,587,1270,11,46,576,1224,206,271,56,147,203,914,94,4,257,180,1391,PG
1984,23,79,1157,124,246,0,0,124,246,104,149,82,175,257,76,30,34,114,231,352,C
1984,25,73,1191,186,385,5,28,181,357,53,87,71,104,175,95,34,11,75,148,430,SF
1984,27,81,2160,249,504,0,1,249,503,261,318,119,326,445,192,50,28,166,291,759,PF
1984,26,64,870,110,218,0,0,110,218,39,66,75,158,233,33,15,76,83,139,259,C
1984,25,78,1640,262,572,0,0,262,572,173,211,101,127,228,61,66,17,95,142,697,SF
1984,30,80,2867,623,1140,0,0,623,1140,274,368,243,614,857,139,55,116,184,266,1520,C
1984,35,40,486,36,88,0,0,36,88,17,33,35,78,113,18,8,7,22,57,89,C
1984,26,81,2686,680,1322,17,59,663,1263,345,410,68,105,173,251,122,10,142,165,1722,SG
1984,23,49,458,61,137,4,22,57,115,16,26,4,29,33,149,10,2,32,47,142,PG
1984,27,13,87,11,35,2,5,9,30,4,4,2,9,11,11,1,0,6,11,28,SG
1984,27,3,11,2,4,1,1,1,3,2,2,0,2,2,2,0,0,1,1,7,SG
1984,27,10,76,9,31,1,4,8,27,2,2,2,7,9,9,1,0,5,10,21,SG
1984,24,69,1280,268,570,0,9,268,561,149,173,59,76,135,60,27,13,81,143,685,SG
1984,22,7,65,7,13,0,0,7,13,6,10,0,10,10,3,2,1,5,11,20,SF
1984,23,18,78,12,26,0,0,12,26,6,6,6,10,16,5,1,3,6,22,30,C
1984,25,69,989,126,209,0,2,126,207,69,101,76,138,214,70,16,22,81,129,321,PF
1984,28,51,858,75,171,1,5,74,166,34,43,57,125,182,49,20,33,28,114,185,PF
1984,25,81,1730,276,528,2,9,274,519,120,200,102,180,282,252,86,50,157,241,674,SG
1984,25,47,743,63,113,0,0,63,113,42,66,82,184,266,34,30,14,56,108,168,PF
1984,25,80,1937,304,700,7,32,297,668,145,183,28,99,127,483,91,6,141,182,760,PG
1984,23,28,196,21,58,0,0,21,58,6,10,9,24,33,29,9,2,19,31,48,SF
1984,28,64,1936,406,857,2,8,404,849,81,123,97,244,341,217,88,30,92,243,895,SF
1984,27,69,1571,221,473,0,4,221,469,79,103,62,103,165,155,49,23,100,145,521,SG
1984,28,48,1285,243,528,14,58,229,470,76,108,56,116,172,214,103,20,118,156,576,PG
1984,22,81,1938,250,541,2,12,248,529,255,325,72,148,220,314,127,30,174,286,757,PG
1984,28,19,197,34,91,0,0,34,91,13,18,20,31,51,13,5,1,17,43,81,SF
1984,23,79,1531,214,399,1,4,213,395,144,172,102,202,304,98,52,38,100,219,573,PF
1984,28,61,856,140,257,1,1,139,256,61,88,80,118,198,65,20,14,77,120,342,C
1984,23,73,2402,533,1185,1,2,532,1183,234,334,156,597,753,185,51,32,187,195,1301,C
1984,32,65,2135,284,581,0,0,284,581,133,206,171,374,545,94,43,27,160,217,701,PF
1984,34,31,340,35,96,0,0,35,96,22,26,15,43,58,20,3,2,12,36,92,C
1984,34,19,141,13,40,0,0,13,40,11,13,1,20,21,13,0,1,11,13,37,C
1984,34,4,37,4,8,0,0,4,8,0,0,2,6,8,1,0,0,1,8,8,C
1984,34,8,162,18,48,0,0,18,48,11,13,12,17,29,6,3,1,0,15,47,C
1984,28,77,2351,274,529,0,0,274,529,118,190,200,393,593,62,35,277,101,297,666,C
1984,25,68,1022,161,351,4,33,157,318,67,94,21,72,93,193,55,8,63,77,393,PG
1984,25,3,15,2,5,0,1,2,4,2,4,0,1,1,1,0,0,0,1,6,PG
1984,25,65,1007,159,346,4,32,155,314,65,90,21,71,92,192,55,8,63,76,387,PG
1984,30,73,2610,503,1038,0,11,503,1027,374,486,206,515,721,184,61,74,205,221,1380,PF
1984,25,75,3082,599,1035,1,7,598,1028,466,636,265,657,922,296,68,72,342,285,1665,C
1984,23,16,119,14,42,1,2,13,40,12,13,6,13,19,22,4,0,9,25,41,PG
1984,23,82,2693,716,1369,1,4,715,1365,287,434,293,620,913,163,70,197,294,339,1720,C
1984,23,50,586,97,203,0,0,97,203,29,42,40,63,103,44,23,12,44,101,223,SF
1984,25,2,13,3,5,0,0,3,5,0,2,0,3,3,0,1,0,2,1,6,PF
1984,24,82,1420,183,371,0,2,183,369,215,272,145,288,433,91,32,60,119,308,581,C
1984,28,65,735,55,124,1,2,54,122,56,72,29,71,100,48,19,20,42,85,167,SF
1984,22,74,1637,334,690,8,34,326,656,112,139,50,114,164,177,81,19,116,174,788,SG
1984,28,79,2101,371,779,1,5,370,774,107,140,140,241,381,179,76,55,165,279,850,PF
1984,26,79,2945,714,1509,22,72,692,1437,353,445,184,254,438,246,103,11,228,252,1803,SF
1984,27,80,2497,397,746,6,20,391,726,117,135,44,127,171,457,90,8,144,179,917,PG
1984,28,82,2993,576,1155,0,2,576,1153,411,480,225,686,911,327,95,92,236,301,1563,C
1984,22,61,1297,238,436,1,6,237,430,123,163,54,116,170,82,33,22,78,165,600,SG
1984,26,75,2091,244,436,0,0,244,436,94,168,282,390,672,72,61,22,124,274,582,PF
1984,31,81,2624,508,1115,29,111,479,1004,221,264,51,128,179,377,117,17,222,278,1266,SG
1984,26,7,54,7,16,1,2,6,14,9,13,5,2,7,5,6,0,4,8,24,SG
1984,25,79,2436,350,738,10,39,340,699,108,131,48,141,189,539,100,8,210,230,818,PG
1984,24,38,363,44,82,0,2,44,80,36,50,16,45,61,30,12,4,34,55,124,SF
1984,24,61,857,148,314,0,3,148,311,134,161,43,79,122,79,34,6,83,93,430,SG
1984,23,81,2426,392,816,3,16,389,800,183,243,116,446,562,170,73,67,161,303,970,C
1984,22,73,1284,217,488,9,37,208,451,64,72,23,68,91,239,29,1,81,81,507,PG
1984,22,40,469,109,214,0,3,109,211,40,47,21,25,46,46,20,0,32,46,258,SG
1984,23,68,616,148,315,7,27,141,288,37,44,28,50,78,63,13,4,62,81,340,SG
1984,26,61,1498,262,625,7,42,255,583,214,281,50,79,129,352,50,12,156,171,745,PG
1984,26,31,601,92,237,3,15,89,222,84,108,21,25,46,142,21,3,59,78,271,PG
1984,26,30,897,170,388,4,27,166,361,130,173,29,54,83,210,29,9,97,93,474,PG
1984,23,46,291,31,72,0,1,31,71,15,31,9,22,31,27,10,3,19,44,77,SF
1984,22,82,3007,669,1448,22,65,647,1383,388,529,103,224,327,914,204,33,307,324,1748,PG
1984,23,72,1219,187,403,1,11,186,392,80,110,59,90,149,130,60,6,69,115,455,SG
1984,29,19,349,89,165,0,1,89,164,62,73,18,26,44,13,10,13,27,30,240,SG
1984,22,80,1915,333,637,0,0,333,637,160,223,260,449,709,86,71,145,168,327,826,C
1984,29,79,2648,487,929,0,2,487,927,266,399,235,453,688,308,84,108,235,237,1240,C
1984,22,82,1731,309,662,9,39,300,623,115,149,120,192,312,122,70,37,73,192,742,SF
1984,22,45,464,62,148,1,8,61,140,23,28,17,23,40,41,13,2,33,65,148,PG
1984,23,72,730,108,254,0,2,108,252,41,63,75,109,184,24,12,60,51,176,257,C
1984,25,49,475,64,121,0,1,64,120,23,45,45,53,98,26,12,20,26,88,151,PF
1984,26,78,2556,593,1125,12,38,581,1087,390,465,57,136,193,373,70,23,297,251,1588,SG
1984,24,4,19,4,8,0,0,4,8,0,0,0,1,1,1,1,2,1,4,8,SF
1984,24,2,2,1,1,0,0,1,1,0,0,0,0,0,0,0,0,0,1,2,SF
1984,24,2,17,3,7,0,0,3,7,0,0,0,1,1,1,1,2,1,3,6,SF
1984,24,76,2493,595,1296,2,17,593,1279,426,523,119,187,306,228,65,17,190,190,1618,SF
1984,24,63,1228,225,450,6,16,219,434,25,33,43,87,130,138,63,8,54,124,481,SG
1984,24,47,536,54,150,1,9,53,141,28,34,42,51,93,59,26,0,29,40,137,SF
1984,27,82,1602,313,691,2,13,311,678,94,132,104,181,285,76,63,59,78,151,722,SF
1984,24,68,1893,251,561,0,3,251,558,194,246,49,78,127,395,107,6,149,179,696,PG
1984,25,78,2734,895,1603,11,30,884,1573,494,580,84,289,373,238,53,50,156,187,2295,PF
1984,24,43,327,50,100,0,1,50,99,17,25,27,34,61,20,22,11,21,75,117,PF
1984,24,61,1421,252,579,0,1,252,578,168,215,81,166,247,114,30,10,113,159,672,SF
1984,25,80,2174,258,495,0,1,258,494,153,236,150,245,395,132,51,54,121,263,669,SF
1984,23,78,1040,123,238,0,1,123,237,31,51,64,163,227,60,24,85,65,164,277,C
1984,22,82,1324,216,518,4,15,212,503,208,263,74,93,167,284,127,15,194,202,644,PG
1984,32,34,378,32,90,2,5,30,85,24,27,8,23,31,81,20,3,31,37,90,PG
1984,29,58,612,118,241,2,6,116,235,6,18,26,66,92,55,17,4,33,65,244,SF
1984,31,55,1476,288,518,0,2,288,516,92,154,132,345,477,183,45,88,177,153,668,C
1984,24,32,254,27,66,1,3,26,63,8,16,5,17,22,43,9,3,20,37,63,PG
1984,31,76,1290,112,239,0,0,112,239,66,117,146,220,366,53,34,100,85,187,290,C
1984,31,68,916,148,333,2,13,146,320,29,35,41,98,139,67,27,7,43,107,327,SF
1984,23,8,38,2,9,0,0,2,9,4,4,4,7,11,0,0,2,2,5,8,PF
1984,23,34,202,15,42,0,0,15,42,7,22,19,27,46,13,1,15,12,55,37,C
1984,33,59,865,144,313,7,26,137,287,117,142,8,35,43,148,41,6,77,69,412,SG
1984,21,80,2159,261,556,0,2,261,554,146,200,63,134,197,662,119,17,268,223,668,PG
1984,24,36,372,80,170,0,0,80,170,26,47,37,37,74,15,15,3,24,31,186,SF
1984,24,22,308,69,144,0,0,69,144,24,42,30,32,62,14,13,2,18,25,162,SF
1984,24,8,45,7,17,0,0,7,17,2,5,5,3,8,1,2,1,5,3,16,SF
1984,24,6,19,4,9,0,0,4,9,0,0,2,2,4,0,0,0,1,3,8,SF
1984,27,70,921,144,294,0,0,144,294,88,107,94,151,245,19,17,12,59,159,376,C
1984,24,82,2123,399,890,7,29,392,861,213,287,138,190,328,187,106,11,139,278,1018,SG
1984,30,75,2507,542,1055,2,8,540,1047,208,280,130,210,340,214,72,41,137,205,1294,SF
1984,24,81,2961,684,1429,0,11,684,1418,382,496,254,328,582,126,117,87,215,197,1750,SF
1984,28,81,1734,249,520,0,3,249,517,134,182,109,346,455,73,27,42,109,205,632,C
1984,23,81,3003,495,926,0,4,495,922,284,498,355,645,1000,130,81,125,237,298,1274,PF
1984,30,80,2818,598,1306,4,25,594,1281,297,396,67,137,204,675,189,25,232,151,1497,PG
1984,25,69,2279,411,860,0,4,411,856,207,295,154,400,554,215,60,108,207,193,1029,C
1984,22,19,200,25,58,0,1,25,57,25,32,4,9,13,43,8,4,22,42,75,SG
1984,29,76,2230,418,939,25,81,393,858,263,318,67,200,267,449,162,26,219,274,1124,SG
1984,22,79,1924,309,671,15,47,294,624,171,209,54,140,194,464,84,5,169,268,804,PG
1984,24,77,1434,204,431,0,1,204,430,92,140,121,218,339,62,68,106,99,209,500,PF
1984,24,7,59,11,26,0,0,11,26,6,7,4,9,13,2,6,3,3,6,28,PF
1984,24,70,1375,193,405,0,1,193,404,86,133,117,209,326,60,62,103,96,203,472,PF
1984,26,13,258,34,114,1,9,33,105,36,46,19,31,50,16,14,1,18,33,105,SF
1984,26,67,936,124,258,0,7,124,251,55,63,75,118,193,56,23,24,53,106,303,SF
1984,24,6,26,0,2,0,1,0,1,1,2,1,0,1,3,0,0,3,5,1,PG
1984,24,78,1071,160,318,2,5,158,313,28,46,14,57,71,71,17,0,32,82,350,SG
1984,25,81,2236,467,945,3,21,464,924,223,271,94,181,275,166,64,32,126,207,1160,SG
1984,25,71,1838,389,816,2,8,387,808,247,302,62,113,175,175,83,28,115,174,1027,SG
1984,24,75,2544,570,1086,1,2,569,1084,303,424,130,239,369,136,71,60,188,253,1444,SF
1984,22,82,2415,495,890,0,6,495,884,195,257,157,358,515,207,77,70,181,244,1185,PF
1985,37,79,2630,723,1207,0,1,723,1206,289,395,162,460,622,249,63,162,197,238,1735,C
1985,30,82,2136,476,915,0,0,476,915,250,283,153,347,500,308,115,48,197,254,1202,PF
1985,25,80,2699,794,1569,27,85,767,1484,440,580,188,289,477,249,60,24,253,250,2055,SF
1985,25,75,2564,419,792,15,56,404,736,118,136,76,192,268,399,122,6,149,228,971,SG
1985,25,74,1114,161,337,0,1,161,336,55,75,87,183,270,36,15,15,72,171,377,C
1985,24,44,457,61,149,0,2,61,147,27,45,29,53,82,21,29,9,32,70,149,SF
1985,26,36,520,84,195,1,2,83,193,41,50,39,49,88,34,9,7,34,40,210,SF
1985,24,81,2401,338,693,3,26,335,667,125,167,54,237,291,697,129,5,207,132,804,PG
1985,27,74,1297,156,349,0,1,156,348,73,108,122,222,344,39,30,50,100,286,385,PF
1985,23,80,2481,507,1034,1,1,506,1033,197,234,153,372,525,138,51,105,152,215,1212,PF
1985,30,82,2664,469,978,14,46,455,932,120,151,150,381,531,208,100,33,106,221,1072,SF
1985,25,82,2091,289,493,1,3,288,490,199,257,133,312,445,234,65,13,140,220,778,SF
1985,24,75,1404,209,445,0,0,209,445,91,192,108,222,330,39,38,40,141,279,509,PF
1985,21,82,2347,427,783,1,6,426,777,293,400,266,437,703,155,95,80,209,301,1148,PF
1985,30,72,1401,201,397,0,3,201,394,76,94,103,221,324,93,53,44,68,207,478,C
1985,28,80,3161,918,1760,56,131,862,1629,403,457,164,678,842,531,129,98,248,208,2295,SF
1985,29,56,1842,495,968,4,21,491,947,161,259,60,88,148,232,84,7,117,145,1155,SG
1985,25,81,2834,625,1230,6,20,619,1210,342,413,107,193,300,289,61,16,162,96,1598,SG
1985,21,60,551,87,237,0,2,87,235,28,55,42,54,96,26,25,3,44,55,202,SF
1985,23,76,2216,299,557,0,0,299,557,160,225,207,449,656,215,55,203,172,278,758,C
1985,27,73,1232,142,299,20,64,122,235,54,79,34,100,134,173,96,21,84,152,358,SG
1985,29,56,746,106,250,6,26,100,224,69,82,11,47,58,122,47,4,54,76,287,PG
1985,24,78,1083,162,317,0,0,162,317,89,127,92,164,256,40,21,82,63,179,413,C
1985,29,20,326,62,118,0,2,62,116,23,25,9,12,21,17,6,6,9,23,147,SG
1985,29,9,81,13,34,0,0,13,34,7,7,1,2,3,6,1,1,4,8,33,SG
1985,29,11,245,49,84,0,2,49,82,16,18,8,10,18,11,5,5,5,15,114,SG
1985,25,78,1115,150,305,0,4,150,301,85,127,76,184,260,100,34,15,100,171,385,C
1985,31,80,2042,460,990,14,39,446,951,181,206,55,175,230,171,47,18,116,128,1115,SF
1985,26,69,814,78,192,0,0,78,192,39,68,76,147,223,25,19,22,51,117,195,C
1985,24,82,1586,214,465,0,6,214,459,116,171,146,142,288,159,59,12,116,212,544,SF
1985,25,56,860,67,148,0,0,67,148,30,44,74,167,241,84,21,24,46,110,164,C
1985,30,75,858,74,193,0,1,74,192,32,50,26,61,87,148,63,2,67,142,180,PG
1985,22,47,418,72,188,0,1,72,187,53,77,10,18,28,20,21,4,33,76,197,SG
1985,34,65,939,82,203,31,87,51,116,23,30,21,40,61,203,38,1,45,75,218,PG
1985,23,75,1610,216,398,0,0,216,398,101,137,126,266,392,51,41,32,81,164,533,PF
1985,22,56,625,130,262,0,1,130,261,56,70,41,48,89,24,28,3,69,107,316,SF
1985,25,38,179,26,67,0,2,26,65,15,17,8,13,21,25,3,0,19,21,67,SG
1985,23,62,1195,198,375,2,6,196,369,101,128,79,153,232,80,29,78,108,219,499,PF
1985,29,48,1120,190,363,0,3,190,360,118,164,90,233,323,56,25,17,100,141,498,PF
1985,34,47,397,62,149,9,23,53,126,17,17,21,22,43,24,21,6,24,44,150,SF
1985,26,69,1279,214,476,11,43,203,433,109,134,36,59,95,167,57,5,109,151,548,SG
1985,23,11,66,4,23,0,3,4,20,1,1,1,2,3,4,1,0,8,4,9,SG
1985,33,70,1049,72,149,0,1,72,148,59,89,89,173,262,14,15,57,55,162,203,C
1985,25,53,653,28,86,0,0,28,86,22,39,53,113,166,19,12,42,45,123,78,C
1985,25,81,2923,629,1302,6,22,623,1280,475,571,164,415,579,209,70,57,260,312,1739,PF
1985,28,78,2616,422,741,6,26,416,715,175,199,54,163,217,497,169,24,155,184,1025,PG
1985,24,62,562,64,152,0,5,64,147,41,53,29,40,69,48,35,2,42,66,169,SG
1985,26,11,91,12,34,0,0,12,34,8,9,10,9,19,7,7,4,8,5,32,SG
1985,22,78,1462,216,477,26,74,190,403,98,130,40,110,150,243,75,9,112,142,556,PG
1985,25,79,2258,246,546,4,20,242,526,144,192,87,159,246,369,161,13,138,136,640,PG
1985,26,58,1063,212,453,2,23,210,430,47,54,21,71,92,160,74,10,75,96,473,PG
1985,28,72,1288,138,279,0,1,138,278,47,64,122,192,314,62,30,23,48,203,323,PF
1985,28,18,440,46,105,0,1,46,104,17,27,41,63,104,23,5,9,16,53,109,PF
1985,28,54,848,92,174,0,0,92,174,30,37,81,129,210,39,25,14,32,150,214,PF
1985,27,3,45,7,15,0,0,7,15,3,6,3,6,9,2,2,1,0,7,17,C
1985,28,82,2189,276,593,35,123,241,470,115,133,56,199,255,429,93,49,156,208,702,SG
1985,28,80,2031,404,856,0,2,404,854,161,235,229,402,631,86,28,197,149,304,969,C
1985,28,82,2062,276,568,0,1,276,567,149,200,130,292,422,140,32,64,124,189,701,C
1985,36,4,115,7,17,0,2,7,15,4,6,2,12,14,22,3,0,11,5,18,PG
1985,28,63,2069,410,797,0,4,410,793,177,227,139,379,518,109,50,17,166,247,997,C
1985,23,79,2722,759,1532,0,1,759,1531,343,463,244,472,716,228,117,67,190,264,1861,PF
1985,27,81,1642,207,428,0,3,207,425,82,144,169,250,419,83,56,42,114,216,496,C
1985,24,79,2101,525,1111,7,30,518,1081,205,251,57,151,208,191,71,5,154,192,1262,SG
1985,28,55,1971,512,964,0,0,512,964,438,545,148,175,323,186,57,8,171,133,1462,SF
1985,29,82,2539,310,614,47,115,263,499,158,178,39,154,193,581,91,10,123,219,825,PG
1985,26,61,774,153,356,1,10,152,346,51,62,59,94,153,51,22,5,54,113,358,SF
1985,26,4,28,2,10,0,0,2,10,3,4,2,2,4,1,1,0,2,3,7,SF
1985,26,57,746,151,346,1,10,150,336,48,58,57,92,149,50,21,5,52,110,351,SF
1985,29,76,1920,337,791,12,46,325,745,255,300,35,84,119,426,43,4,152,136,941,PG
1985,30,23,570,139,309,3,10,136,299,64,73,6,29,35,98,18,0,50,42,345,SG
1985,28,39,972,192,339,0,1,192,338,143,201,55,126,181,45,14,35,93,171,527,C
1985,24,80,1573,258,504,1,7,257,497,178,249,93,179,272,240,53,19,134,164,695,SF
1985,27,82,2392,351,551,0,0,351,551,227,303,168,500,668,48,28,130,206,217,929,C
1985,30,19,463,107,260,0,4,107,256,94,122,36,46,82,35,22,2,42,65,308,SF
1985,26,72,2373,457,913,7,28,450,885,154,194,39,125,164,484,93,8,179,147,1075,PG
1985,22,80,2555,573,1161,8,37,565,1124,223,294,217,259,476,441,177,68,223,265,1377,SG
1985,30,19,433,64,135,16,47,48,88,25,29,6,25,31,85,15,3,40,55,169,PG
1985,29,81,2290,175,358,0,2,175,356,84,116,169,216,385,153,140,14,65,213,434,SG
1985,24,59,756,114,274,0,3,114,271,72,102,49,75,124,80,19,10,77,106,300,SF
1985,28,82,2813,302,673,0,0,302,673,190,267,207,720,927,124,36,456,206,312,794,C
1985,25,3,37,3,6,0,0,3,6,5,6,0,0,0,4,0,0,4,6,11,PG
1985,22,10,143,4,13,0,0,4,13,3,8,8,18,26,10,5,4,3,39,11,SF
1985,25,16,198,36,66,0,0,36,66,19,24,3,11,14,38,17,0,17,10,91,PG
1985,29,70,1787,384,766,0,3,384,763,276,370,95,292,387,153,26,52,162,237,1044,C
1985,23,45,189,34,69,0,3,34,66,19,30,8,17,25,26,11,3,22,26,87,SG
1985,24,72,1314,274,603,42,109,232,494,77,104,100,138,238,56,46,7,58,131,667,SF
1985,25,11,82,8,20,0,0,8,20,5,9,12,18,30,0,2,5,2,5,21,C
1985,25,7,76,7,16,0,0,7,16,5,9,10,17,27,0,2,4,1,4,19,C
1985,25,3,3,1,2,0,0,1,2,0,0,1,1,2,0,0,0,1,1,2,C
1985,25,1,3,0,2,0,0,0,2,0,0,1,0,1,0,0,1,0,0,0,C
1985,31,81,2924,939,1812,1,5,938,1807,383,462,203,255,458,344,101,46,251,259,2262,SF
1985,34,78,2535,610,1236,3,14,607,1222,338,442,172,242,414,233,135,109,208,199,1561,SF
1985,29,81,1437,323,661,57,157,266,504,113,131,26,93,119,231,65,12,130,174,816,SG
1985,22,51,535,84,191,0,0,84,191,27,36,41,43,84,38,9,10,32,84,195,SF
1985,22,80,2486,433,922,0,4,433,918,260,339,148,175,323,247,99,8,197,232,1126,PG
1985,24,82,2873,610,1372,42,143,568,1229,336,415,62,140,202,406,134,41,251,226,1598,SG
1985,28,25,290,14,47,0,4,14,43,16,18,3,24,27,61,6,1,17,33,44,PG
1985,24,79,1318,286,636,41,126,245,510,83,110,27,53,80,186,61,0,117,171,696,PG
1985,31,71,2249,609,1328,71,193,538,1135,308,411,61,150,211,320,75,16,139,163,1597,SG
1985,24,65,1123,149,310,0,2,149,308,120,174,98,188,286,67,28,15,92,196,418,PF
1985,32,72,2091,600,1182,0,10,600,1172,324,384,79,155,234,178,66,48,198,208,1524,SG
1985,35,81,2756,532,854,0,2,532,852,484,646,231,615,846,131,40,173,241,306,1548,C
1985,29,60,1126,228,388,0,2,228,386,62,76,20,61,81,122,27,0,55,74,518,SG
1985,25,81,2418,380,818,0,1,380,817,276,328,229,404,633,158,38,92,136,135,1036,C
1985,22,63,682,110,287,2,9,108,278,37,49,26,35,61,88,33,6,69,61,259,SG
1985,23,9,92,6,17,0,1,6,16,4,8,1,5,6,12,2,0,12,13,16,PG
1985,23,4,11,2,6,0,1,2,5,1,5,0,2,2,1,1,0,1,4,5,SG
1985,21,52,391,35,92,0,0,35,92,32,47,29,94,123,15,9,14,51,82,102,C
1985,30,77,2431,381,798,6,20,375,778,232,267,37,152,189,597,132,3,177,131,1000,PG
1985,24,48,740,108,250,0,4,108,246,79,98,72,174,246,29,11,14,68,102,295,PF
1985,27,61,1523,152,332,0,1,152,331,67,94,108,280,388,78,34,18,63,190,371,PF
1985,31,78,1182,190,424,8,33,182,391,88,107,27,76,103,94,30,2,55,85,476,SF
1985,26,78,2776,728,1593,92,257,636,1336,216,298,124,220,344,243,133,30,247,178,1764,SG
1985,29,69,1061,188,384,2,8,186,376,77,104,41,110,151,105,50,7,40,129,455,SF
1985,24,54,646,110,225,1,7,109,218,40,72,20,50,70,75,25,1,49,88,261,SG
1985,27,80,1673,220,522,1,15,219,507,180,238,88,119,207,210,84,26,115,291,621,SF
1985,23,82,2218,329,633,21,61,308,572,111,154,47,152,199,360,144,37,123,194,790,PG
1985,24,64,825,89,188,0,0,89,188,63,81,59,100,159,46,24,23,50,135,241,PF
1985,29,11,101,10,18,0,0,10,18,2,4,11,23,34,1,1,4,2,19,22,C
1985,29,79,2648,427,891,9,38,418,853,199,255,71,119,190,559,140,9,231,196,1062,PG
1985,25,68,942,119,270,10,37,109,233,60,90,55,92,147,73,21,13,49,91,308,SF
1985,23,76,2344,465,925,0,3,465,922,271,376,186,410,596,68,51,173,171,311,1201,PF
1985,24,82,2496,359,732,47,135,312,597,106,130,74,112,186,349,96,1,135,262,871,SG
1985,31,80,1950,249,540,3,13,246,527,108,136,33,140,173,417,78,10,170,187,609,PG
1985,23,74,1761,257,576,14,45,243,531,96,118,30,102,132,198,59,6,123,141,624,SG
1985,28,76,2249,415,822,0,4,415,818,371,494,214,265,479,114,81,9,178,258,1201,SF
1985,22,80,2062,279,626,4,20,275,606,141,170,32,132,164,350,107,8,167,209,703,SG
1985,27,8,93,12,25,0,0,12,25,2,3,0,1,1,23,0,0,8,8,26,PG
1985,28,69,1334,162,354,0,4,162,350,87,128,95,209,304,119,35,35,119,217,411,PF
1985,28,12,156,12,31,0,0,12,31,6,6,11,18,29,6,4,3,16,24,30,PF
1985,28,57,1178,150,323,0,4,150,319,81,122,84,191,275,113,31,32,103,193,381,PF
1985,36,77,1684,363,791,1,7,362,784,257,319,80,251,331,137,65,31,93,171,984,C
1985,22,1,12,1,3,0,0,1,3,0,0,1,0,1,4,2,0,1,1,2,PG
1985,28,58,875,117,235,0,1,117,234,36,49,92,129,221,33,15,44,43,112,270,C
1985,30,80,2976,493,1066,7,26,486,1040,261,306,91,226,317,543,96,39,212,224,1254,PG
1985,29,73,2367,453,946,22,72,431,874,265,332,38,154,192,566,43,7,244,184,1193,SG
1985,25,82,3029,769,1565,13,54,756,1511,325,373,151,256,407,273,83,22,225,237,1876,SF
1985,26,46,925,175,358,6,17,169,341,72,96,23,40,63,143,43,3,59,72,428,PG
1985,36,65,800,42,79,1,1,41,78,22,27,74,111,185,22,19,78,39,151,107,C
1985,28,55,756,107,263,1,10,106,253,49,56,48,116,164,38,31,16,49,99,264,SF
1985,25,77,2781,504,899,7,37,497,862,391,464,90,386,476,968,113,25,305,155,1406,PG
1985,28,72,2448,494,1094,3,13,491,1081,190,260,188,240,428,248,72,30,176,193,1181,SF
1985,32,66,1565,304,714,7,30,297,684,260,316,149,247,396,149,70,35,142,221,875,PF
1985,27,74,1659,281,516,0,3,281,513,181,252,146,291,437,64,37,62,151,265,743,C
1985,28,82,2093,428,942,5,27,423,915,190,247,134,118,252,325,71,20,135,205,1051,SG
1985,33,80,1633,207,385,0,4,207,381,186,216,105,192,297,155,84,50,118,183,600,PF
1985,34,42,885,53,115,0,2,53,113,36,47,49,162,211,34,12,31,40,125,142,C
1985,23,78,1565,236,454,0,4,236,450,182,281,139,255,394,128,45,61,143,149,654,C
1985,27,3,29,2,4,0,0,2,4,4,6,2,4,6,1,0,5,4,6,8,PF
1985,27,28,638,65,123,0,0,65,123,36,52,69,109,178,25,22,74,21,101,166,C
1985,24,2,7,0,1,0,0,0,1,0,0,0,0,0,0,0,0,1,0,0,C
1985,28,44,769,130,275,0,4,130,271,82,111,50,121,171,29,20,29,61,123,342,PF
1985,28,18,322,44,91,0,1,44,90,41,51,16,46,62,18,9,18,28,52,129,PF
1985,28,26,447,86,184,0,3,86,181,41,60,34,75,109,11,11,11,33,71,213,PF
1985,31,47,418,48,87,0,0,48,87,33,51,48,80,128,15,9,14,35,58,129,PF
1985,24,67,888,106,180,0,1,106,179,33,83,65,173,238,56,30,57,61,139,245,C
1985,21,82,3144,837,1625,9,52,828,1573,630,746,167,367,534,481,196,69,291,285,2313,SG
1985,31,77,1276,103,216,0,2,103,214,84,112,118,232,350,120,42,30,124,227,290,C
1985,23,77,2449,562,1112,7,14,555,1098,301,396,224,500,724,244,86,26,231,247,1432,PF
1985,27,10,114,21,53,0,1,21,52,20,28,6,13,19,13,7,0,12,16,62,SF
1985,22,77,958,178,372,0,3,178,369,117,181,95,111,206,63,49,29,66,147,473,SF
1985,25,42,860,226,460,0,8,226,452,85,104,70,89,159,58,41,9,65,110,537,SF
1985,28,55,2063,691,1303,1,10,690,1293,426,552,114,203,317,204,71,15,204,191,1809,SF
1985,27,60,860,63,149,0,0,63,149,41,59,44,78,122,53,28,11,42,74,167,SF
1985,23,55,424,33,88,0,0,33,88,22,32,38,51,89,17,3,10,29,84,88,C
1985,32,16,189,31,69,1,1,30,68,13,16,10,12,22,21,2,1,13,14,76,SG
1985,32,52,611,125,285,10,24,115,261,51,57,40,56,96,59,14,1,57,48,311,SF
1985,24,42,308,50,95,2,3,48,92,43,54,29,57,86,29,13,1,28,58,145,PF
1985,30,58,716,123,244,0,0,123,244,60,91,68,116,184,21,19,20,48,104,306,PF
1985,29,1,8,0,1,0,0,0,1,1,2,1,1,2,0,0,0,1,2,1,C
1985,27,82,2892,595,1177,4,18,591,1159,244,306,295,718,1013,154,69,71,129,308,1438,C
1985,27,42,536,88,209,8,37,80,172,44,57,8,29,37,102,23,4,51,61,228,PG
1985,26,32,278,34,82,0,1,34,81,21,31,4,22,26,80,15,3,32,25,89,PG
1985,24,82,2559,424,985,6,24,418,961,197,256,147,264,411,613,202,30,203,226,1051,PG
1985,24,74,2017,291,552,0,2,291,550,145,222,230,336,566,104,70,69,133,231,727,PF
1985,26,81,2091,322,598,0,1,322,597,154,262,219,428,647,127,49,167,183,287,798,C
1985,25,82,2128,457,869,2,8,455,861,161,220,98,133,231,280,73,28,177,196,1077,SG
1985,28,66,1820,431,885,5,15,426,870,106,123,81,109,190,130,71,14,98,139,973,SG
1985,25,21,190,10,27,0,1,10,26,8,8,4,12,16,50,11,0,13,28,28,PG
1985,25,6,31,2,7,0,0,2,7,0,0,0,1,1,8,0,0,2,5,4,PG
1985,25,15,159,8,20,0,1,8,19,8,8,4,11,15,42,11,0,11,23,24,PG
1985,31,47,1158,206,446,21,66,185,380,103,129,21,64,85,318,62,2,102,78,536,PG
1985,32,63,1670,346,727,0,4,346,723,150,200,138,419,557,145,39,17,151,183,842,PF
1985,27,65,2018,282,582,23,85,259,497,127,140,33,146,179,380,85,3,111,128,714,PG
1985,26,77,2072,206,413,0,0,206,413,71,104,150,458,608,121,59,104,133,308,483,PF
1985,23,76,2613,605,1213,15,72,590,1141,211,250,60,146,206,184,52,9,107,176,1436,SG
1985,29,79,2957,602,1284,0,2,602,1282,737,904,385,646,1031,130,67,123,286,216,1941,C
1985,24,34,190,27,63,0,1,27,62,16,23,12,11,23,27,16,3,18,17,70,SF
1985,25,78,1523,191,386,2,16,189,370,59,85,16,51,67,354,73,12,124,133,443,PG
1985,29,57,1495,201,377,0,2,201,375,231,278,98,144,242,102,36,15,98,140,633,SF
1985,33,66,1254,284,546,0,1,284,545,122,162,79,216,295,67,18,53,95,170,690,C
1985,22,78,1584,269,483,0,1,269,482,188,263,146,252,398,78,18,33,114,207,726,C
1985,23,82,3001,476,890,0,6,476,884,231,313,201,338,539,355,90,75,178,215,1183,SF
1985,24,6,93,6,10,0,0,6,10,3,4,6,11,17,7,1,3,10,13,15,PF
1985,25,34,132,20,42,0,1,20,41,7,10,7,15,22,9,3,5,8,22,47,PF
1985,25,76,1170,329,612,22,61,307,551,94,160,97,68,165,71,39,7,81,147,774,SF
1985,27,79,2653,605,1062,0,6,605,1056,355,467,229,483,712,141,28,120,157,234,1565,PF
1985,26,29,535,61,134,5,13,56,121,38,43,20,29,49,58,30,7,32,63,165,SG
1985,32,69,1547,252,534,0,5,252,529,112,135,64,146,210,52,8,17,44,163,616,C
1985,25,45,273,40,76,0,0,40,76,32,62,31,43,74,6,7,8,19,27,112,C
1985,25,12,63,12,18,0,0,12,18,9,18,7,10,17,0,2,1,6,5,33,C
1985,25,33,210,28,58,0,0,28,58,23,44,24,33,57,6,5,7,13,22,79,C
1985,31,76,1061,121,243,1,2,120,241,96,124,94,169,263,27,17,28,50,181,339,C
1985,24,57,565,91,157,0,3,91,154,29,43,62,81,143,30,20,21,36,75,211,PF
1985,24,18,171,17,35,0,0,17,35,12,17,18,26,44,13,8,7,8,26,46,PF
1985,24,39,394,74,122,0,3,74,119,17,26,44,55,99,17,12,14,28,49,165,PF
1985,29,82,2853,775,1558,5,23,770,1535,269,346,145,272,417,151,61,27,144,219,1824,SF
1985,28,79,1586,205,429,0,2,205,427,81,116,107,303,410,99,28,35,85,266,491,C
1985,27,73,2734,561,1162,9,33,552,1129,454,548,149,242,391,382,117,39,184,197,1585,PG
1985,26,82,2689,416,910,25,89,391,821,189,248,94,284,378,816,229,18,236,247,1046,PG
1985,22,23,149,8,50,0,1,8,49,12,21,6,35,41,4,1,2,8,21,28,PF
1985,25,61,2202,515,877,1,2,514,875,180,254,195,341,536,159,88,104,136,185,1211,PF
1985,28,78,2657,685,1255,0,3,685,1252,447,564,209,401,610,238,75,33,190,182,1817,PF
1985,26,8,29,2,6,0,0,2,6,2,4,2,1,3,3,2,0,3,3,6,SG
1985,26,4,13,2,5,0,0,2,5,2,4,1,1,2,0,1,0,3,2,6,SG
1985,26,4,16,0,1,0,0,0,1,0,0,1,0,1,3,1,0,0,1,0,SG
1985,24,22,225,26,44,0,0,26,44,10,19,15,29,44,18,3,1,12,26,62,PF
1985,25,11,59,5,17,0,0,5,17,2,8,5,15,20,3,0,15,10,20,12,C
1985,26,82,2010,196,434,0,6,196,428,108,140,136,272,408,183,30,126,95,262,500,C
1985,29,81,2894,596,1281,33,99,563,1182,170,218,55,163,218,711,95,4,273,175,1395,PG
1985,24,78,1117,133,245,0,3,133,242,135,203,90,160,250,47,42,33,100,221,401,C
1985,26,43,1119,194,393,8,21,186,372,42,67,46,120,166,102,32,16,51,115,438,SF
1985,22,82,2914,677,1258,0,0,677,1258,338,551,440,534,974,111,99,220,234,344,1692,C
1985,28,81,2277,265,528,0,3,265,525,293,352,139,374,513,243,56,11,185,298,823,PF
1985,27,63,993,89,192,0,1,89,191,34,50,79,157,236,31,11,127,58,166,212,C
1985,26,79,2452,372,766,1,10,371,756,262,334,171,220,391,134,100,27,138,195,1007,PF
1985,31,79,2850,551,1016,0,0,551,1016,292,393,263,577,840,125,56,101,186,223,1394,C
1985,36,62,370,32,87,0,0,32,87,18,28,24,72,96,16,6,11,30,51,82,C
1985,27,68,2253,508,988,6,39,502,949,196,248,69,153,222,264,101,5,108,115,1218,SG
1985,24,78,1259,196,385,10,34,186,351,84,100,19,49,68,215,45,3,81,117,486,PG
1985,23,82,2317,347,736,9,36,338,700,200,244,189,416,605,135,63,63,102,236,903,PF
1985,22,60,714,70,144,0,0,70,144,50,66,44,103,147,29,14,32,71,125,190,PF
1985,25,44,882,165,307,1,4,164,303,102,124,49,68,117,94,34,5,63,117,433,SG
1985,26,68,1001,107,227,0,2,107,225,109,146,90,137,227,69,20,21,100,144,323,SF
1985,22,66,702,92,232,1,4,91,228,65,92,54,80,134,26,15,14,50,127,250,PF
1985,22,22,129,17,53,0,1,17,52,7,13,9,9,18,5,3,3,7,30,41,SF
1985,29,79,1656,210,457,3,17,207,440,109,137,148,325,473,79,47,58,70,220,532,PF
1985,26,80,2876,480,928,7,20,473,908,317,418,149,280,429,543,129,56,247,258,1284,SF
1985,26,82,1617,181,327,0,0,181,327,68,103,164,364,528,69,82,47,97,211,430,PF
1985,26,81,1689,300,654,2,11,298,643,122,142,40,90,130,355,87,7,113,134,724,PG
1985,24,4,12,0,2,0,0,0,2,0,0,1,1,2,3,0,0,1,3,0,SF
1985,29,82,1763,312,648,1,16,311,632,88,126,81,192,273,171,48,22,101,196,713,SF
1985,28,74,1531,183,404,1,3,182,401,76,89,60,95,155,157,37,15,78,143,443,SG
1985,29,82,3127,690,1470,29,115,661,1355,240,313,156,301,457,669,243,22,249,277,1649,PG
1985,23,69,2126,334,701,15,36,319,665,291,378,66,148,214,410,163,53,176,250,974,PG
1985,24,74,1178,208,418,1,1,207,417,150,182,78,108,186,87,28,22,89,141,567,PF
1985,24,22,305,44,98,0,0,44,98,29,38,10,25,35,22,10,12,21,45,117,PF
1985,24,52,873,164,320,1,1,163,319,121,144,68,83,151,65,18,10,68,96,450,PF
1985,22,79,1685,299,600,4,11,295,589,124,169,116,149,265,275,127,24,167,217,726,SG
1985,29,4,48,2,9,0,0,2,9,1,2,3,5,8,5,2,0,8,7,5,C
1985,24,60,1870,422,896,1,3,421,893,158,213,141,405,546,149,51,47,161,187,1003,PF
1985,33,2,35,2,5,0,0,2,5,0,2,6,3,9,3,2,3,5,3,4,PF
1985,29,70,1750,186,339,0,0,186,339,67,93,113,329,442,52,35,167,80,213,439,C
1985,26,9,51,3,16,0,3,3,13,5,5,0,0,0,12,4,0,5,7,11,PG
1985,26,4,16,1,8,0,1,1,7,0,0,0,0,0,2,0,0,0,2,2,PG
1985,26,5,35,2,8,0,2,2,6,5,5,0,0,0,10,4,0,5,5,9,PG
1985,31,56,1492,236,505,0,2,236,503,139,178,175,278,453,102,26,54,123,147,611,PF
1985,26,37,1436,250,439,0,2,250,437,200,292,127,283,410,162,31,27,179,128,700,C
1985,33,3,24,2,7,0,1,2,6,2,3,0,5,5,3,0,0,5,3,6,SF
1985,24,21,377,34,63,1,1,33,62,14,17,8,32,40,66,17,4,40,37,83,PG
1985,24,82,3086,753,1499,0,6,753,1493,303,448,227,626,853,224,81,168,326,306,1809,PF
1985,24,21,418,85,175,0,0,85,175,45,59,38,51,89,29,23,4,34,59,215,SF
1985,24,33,298,41,87,0,0,41,87,14,34,28,47,75,7,7,4,21,50,96,PF
1985,25,56,542,60,129,0,0,60,129,79,97,48,96,144,38,20,25,44,98,199,C
1985,30,39,268,21,51,0,0,21,51,10,20,18,58,76,11,8,11,15,48,52,C
1985,24,19,110,25,74,0,4,25,70,7,10,6,15,21,18,0,1,14,12,57,SG
1985,29,77,1238,111,259,1,5,110,254,53,74,46,115,161,127,39,25,60,125,276,SF
1985,23,81,2305,541,1003,26,60,515,943,187,228,57,153,210,244,100,17,138,197,1295,SG
1985,22,21,87,9,36,0,2,9,34,2,4,2,2,4,6,3,1,7,13,20,SG
1985,29,57,1244,158,363,0,5,158,358,51,77,82,185,267,96,44,18,74,187,367,PF
1985,27,78,3081,819,1780,47,150,772,1630,501,613,157,241,398,234,116,27,241,255,2186,SF
1985,28,70,1808,325,624,9,37,316,587,112,128,24,90,114,264,47,4,102,116,771,PG
1985,29,68,2402,461,943,2,10,459,933,335,393,164,559,723,285,83,91,160,239,1259,C
1985,22,43,304,39,94,0,2,39,92,13,25,24,36,60,26,7,6,19,50,91,SF
1985,22,31,151,30,58,0,2,30,56,13,21,5,7,12,16,3,0,11,18,73,SG
1985,23,80,2762,682,1271,3,19,679,1252,400,504,174,253,427,216,77,52,230,317,1767,SG
1985,27,80,2497,366,690,0,0,366,690,155,256,405,464,869,96,78,54,160,285,887,PF
1985,29,7,48,4,17,0,4,4,13,8,10,0,4,4,7,2,0,3,6,16,PG
1985,32,71,1490,280,628,8,28,272,600,132,162,27,76,103,252,49,9,158,156,700,SG
1985,26,79,2292,326,662,7,31,319,631,122,141,38,131,169,557,81,9,150,200,781,PG
1985,25,75,1292,194,354,0,3,194,351,112,146,77,150,227,132,47,13,115,195,500,PF
1985,23,74,1278,210,458,4,25,206,433,102,126,39,75,114,127,47,12,80,205,526,SG
1985,25,54,486,83,178,0,1,83,177,87,104,25,32,57,36,16,4,43,61,253,SG
1985,24,82,2315,414,871,1,11,413,860,297,372,141,473,614,199,71,78,184,265,1126,C
1985,22,82,1490,157,333,2,11,155,322,142,193,26,79,105,415,109,11,150,203,458,PG
1985,23,73,1150,170,400,12,38,158,362,48,59,17,53,70,206,36,1,85,87,400,PG
1985,23,6,24,6,13,0,1,6,12,2,2,0,3,3,2,1,0,1,3,14,SG
1985,24,21,349,74,137,2,4,72,133,25,35,22,21,43,14,13,5,15,36,175,SG
1985,24,2,5,1,2,0,0,1,2,0,0,0,0,0,0,0,0,1,2,2,SG
1985,24,19,344,73,135,2,4,71,131,25,35,22,21,43,14,13,5,14,34,173,SG
1985,27,82,2543,501,1029,5,38,496,991,334,387,106,164,270,656,95,18,307,250,1341,SG
1985,23,51,461,94,195,0,2,94,193,43,67,29,40,69,17,11,17,34,85,231,SF
1985,24,18,183,20,38,0,1,20,37,11,19,10,7,17,4,5,3,14,22,51,SF
1985,24,10,115,12,23,0,1,12,22,5,11,4,4,8,1,3,2,12,16,29,SF
1985,24,6,16,3,4,0,0,3,4,1,2,1,1,2,0,0,0,0,1,7,SF
1985,24,2,52,5,11,0,0,5,11,5,6,5,2,7,3,2,1,2,5,15,SF
1985,23,81,3089,646,1410,29,113,617,1297,399,493,114,247,361,1123,187,25,302,288,1720,PG
1985,24,80,2059,347,726,8,42,339,684,183,234,74,187,261,234,76,5,131,195,885,SG
1985,22,59,535,79,212,0,8,79,204,39,51,37,39,76,52,31,10,35,79,197,SF
1985,23,82,2458,369,695,0,0,369,695,227,315,274,580,854,130,98,128,202,328,965,C
1985,30,79,2616,572,1111,0,0,572,1111,307,449,211,407,618,205,78,104,231,216,1451,PF
1985,23,49,942,189,459,6,30,183,429,69,87,57,101,158,78,56,25,57,119,453,SF
1985,23,33,715,148,354,6,23,142,331,45,53,36,80,116,58,41,20,42,77,347,SF
1985,23,16,227,41,105,0,7,41,98,24,34,21,21,42,20,15,5,15,42,106,SF
1985,22,82,1918,411,685,0,2,411,683,230,371,187,369,556,111,34,37,187,256,1052,PF
1985,23,82,1304,188,416,4,22,184,394,66,90,21,78,99,175,80,16,99,171,446,PG
1985,27,70,2237,450,914,39,105,411,809,306,355,35,142,177,363,65,24,224,211,1245,SG
1985,25,1,8,0,6,0,0,0,6,2,2,1,0,1,0,0,0,0,1,2,SF
1985,25,55,1675,396,831,2,5,394,826,255,288,66,152,218,135,49,14,118,118,1049,SF
1985,25,77,1819,293,606,29,72,264,534,38,48,74,114,188,199,75,15,64,195,653,SG
1985,25,81,1491,181,388,1,6,180,382,51,65,88,128,216,158,96,7,70,152,414,SF
1985,22,72,1429,171,377,0,3,171,374,79,92,88,130,218,108,29,7,90,243,421,PF
1985,24,79,1949,363,711,0,0,363,711,109,139,155,297,452,36,38,87,118,211,835,C
1985,28,82,2004,422,855,0,8,422,847,106,148,148,275,423,63,49,90,76,192,950,SF
1985,25,75,2278,321,679,0,2,321,677,230,290,54,165,219,522,143,5,194,189,872,PG
1985,26,72,2502,618,1158,11,33,607,1125,369,412,74,154,228,106,37,22,116,116,1616,SF
1985,25,54,366,51,108,0,0,51,108,21,25,28,35,63,17,15,7,20,85,123,PF
1985,25,79,2543,545,1138,0,4,545,1134,351,420,185,519,704,169,48,22,170,226,1441,PF
1985,26,76,2163,186,402,1,4,185,398,67,127,154,282,436,152,76,57,119,256,440,SF
1985,24,62,703,85,190,0,1,85,189,29,50,57,113,170,30,16,44,55,107,199,C
1985,23,82,2489,430,989,0,17,430,972,243,347,128,150,278,408,167,21,204,244,1103,PG
1985,32,67,1647,269,516,0,2,269,514,138,203,168,432,600,156,50,140,174,184,676,C
1985,25,58,713,85,173,1,4,84,169,44,57,10,48,58,153,23,6,70,85,215,PG
1985,32,78,1127,220,460,17,34,203,426,42,55,57,102,159,94,23,10,47,111,499,SF
1985,24,66,888,106,194,0,1,106,193,43,87,90,161,251,15,13,49,59,197,255,C
1985,24,1,6,0,1,0,0,0,1,2,2,1,0,1,0,0,1,2,4,2,C
1985,24,65,882,106,193,0,1,106,192,41,85,89,161,250,15,13,48,57,193,253,C
1985,22,70,1385,140,313,1,9,139,304,68,86,34,67,101,381,66,10,144,141,349,PG
1985,25,80,1106,144,279,0,0,144,279,90,130,94,101,195,34,35,20,87,115,378,PF
1985,22,39,234,52,124,4,11,48,113,21,31,15,21,36,29,5,2,30,24,129,SG
1985,28,79,2536,421,825,0,0,421,825,184,235,219,403,622,53,45,43,141,322,1026,C
1985,25,82,1575,318,657,6,23,312,634,96,131,110,125,235,119,83,13,90,195,738,SG
1985,31,42,761,148,303,0,1,148,302,51,66,35,59,94,41,19,3,49,65,347,SF
1985,25,81,3023,853,1891,25,81,828,1810,486,603,226,331,557,200,135,54,225,170,2217,SF
1985,22,54,917,116,233,0,2,116,231,66,122,86,176,262,16,21,16,64,155,298,C
1985,29,79,1505,285,582,0,1,285,581,61,80,78,288,366,81,35,18,91,173,631,C
1985,24,2,7,0,2,0,0,0,2,0,0,0,1,1,0,0,0,0,2,0,PF
1985,24,10,38,4,14,0,1,4,13,6,7,1,2,3,2,0,0,4,8,14,SF
1985,24,82,3182,577,1089,1,4,576,1085,336,538,323,682,1005,167,63,110,238,293,1491,PF
1985,31,79,2960,638,1483,51,176,587,1307,251,346,72,123,195,608,178,32,213,159,1578,PG
1985,24,21,119,29,63,1,4,28,59,2,5,15,12,27,9,5,2,8,17,61,SF
1985,26,75,2557,575,1211,1,9,574,1202,224,341,154,480,634,252,54,134,265,218,1375,C
1985,23,46,413,58,134,0,5,58,129,47,64,19,44,63,61,22,4,49,86,163,SG
1985,30,23,459,55,143,6,23,49,120,31,46,16,41,57,90,30,5,42,56,147,PG
1985,25,46,488,58,148,0,1,58,147,28,47,38,68,106,11,26,26,44,92,144,PF
1985,27,34,867,167,380,4,15,163,365,79,123,45,123,168,94,28,8,78,83,417,SF
1985,22,82,1785,322,690,2,9,320,681,119,181,177,345,522,36,31,49,104,226,765,PF
1985,25,19,267,36,77,0,0,36,77,27,36,14,17,31,35,14,5,20,21,99,SG
1985,25,11,175,27,54,0,0,27,54,23,30,10,8,18,24,10,3,15,14,77,SG
1985,25,8,92,9,23,0,0,9,23,4,6,4,9,13,11,4,2,5,7,22,SG
1985,23,74,1260,134,291,3,16,131,275,54,76,35,96,131,217,77,12,95,122,325,PG
1985,25,41,1168,187,352,2,7,185,345,30,41,16,57,73,125,28,7,57,58,406,SG
1985,26,80,2545,515,1061,7,33,508,1028,166,214,99,180,279,236,84,52,120,187,1203,SG
1985,22,38,269,50,134,4,30,46,104,18,26,3,15,18,45,8,0,25,17,122,PG
1985,26,78,1998,530,1068,5,21,525,1047,264,330,69,129,198,143,117,28,139,216,1329,SG
1985,25,77,2816,679,1225,0,5,679,1220,409,521,158,277,435,135,58,38,178,185,1767,SF
1985,23,80,2696,610,1066,0,7,610,1059,190,245,169,342,511,201,87,67,198,196,1410,SF
1985,22,3,26,2,10,0,1,2,9,0,0,0,3,3,2,3,0,2,2,4,PG
1985,24,2,11,2,6,0,1,2,5,0,0,1,1,2,0,0,0,0,0,4,SF
1986,38,79,2629,755,1338,0,2,755,1336,336,439,133,345,478,280,67,130,203,248,1846,C
1986,31,78,2005,341,679,0,2,341,677,159,203,148,329,477,324,103,46,206,272,841,C
1986,23,18,139,16,44,0,3,16,41,8,12,2,4,6,22,9,1,11,9,40,PG
1986,26,74,2501,668,1327,16,56,652,1271,318,451,177,268,445,339,62,14,252,229,1670,SF
1986,26,80,2407,353,701,26,73,327,628,123,136,47,188,235,405,94,7,129,204,855,SG
1986,27,77,1676,310,628,2,9,308,619,85,127,130,144,274,144,56,6,82,125,707,SF
1986,27,17,207,37,74,0,1,37,73,12,16,5,21,26,8,1,0,6,20,86,SF
1986,27,60,1469,273,554,2,8,271,546,73,111,125,123,248,136,55,6,76,105,621,SF
1986,25,78,2472,366,865,9,37,357,828,170,215,76,199,275,735,122,10,239,165,911,PG
1986,28,48,1245,202,443,0,4,202,439,129,167,102,232,334,50,33,40,99,207,533,PF
1986,24,82,2358,483,1077,0,7,483,1070,230,277,148,345,493,153,42,114,144,160,1196,PF
1986,31,75,1792,272,570,17,35,255,535,101,126,132,285,417,83,65,8,54,174,662,SF
1986,26,82,2139,356,688,0,19,356,669,183,255,178,182,360,251,81,10,139,212,895,SF
1986,25,70,1405,235,479,0,1,235,478,131,249,89,233,322,42,42,24,129,208,601,PF
1986,22,80,2952,595,1041,17,75,578,966,396,578,354,672,1026,312,173,125,350,333,1603,PF
1986,23,64,639,101,222,0,7,101,215,75,103,12,50,62,74,23,3,47,80,277,SG
1986,21,79,2088,324,661,1,3,323,658,229,307,161,439,600,79,64,206,145,286,878,C
1986,31,72,1344,201,415,1,2,200,413,66,83,118,258,376,80,58,51,58,196,469,C
1986,29,82,3113,796,1606,82,194,714,1412,441,492,190,615,805,557,166,51,266,182,2115,SF
1986,30,77,2395,542,1056,8,22,534,1034,122,210,88,114,202,261,85,17,179,228,1214,SG
1986,23,48,409,44,94,0,0,44,94,36,67,25,66,91,17,3,12,28,65,124,C
1986,26,82,2787,677,1318,4,29,673,1289,404,483,88,203,291,271,79,25,189,138,1762,SG
1986,23,80,2090,128,278,0,1,128,277,42,86,123,354,477,23,28,397,65,255,298,C
1986,24,38,1132,167,345,0,0,167,345,114,161,93,234,327,99,21,96,88,142,448,C
1986,28,70,842,73,209,17,68,56,141,32,56,24,71,95,107,85,3,44,101,195,SG
1986,30,33,269,26,70,4,14,22,56,14,18,2,21,23,39,13,0,17,43,70,PG
1986,25,82,1792,272,570,0,1,272,569,141,198,159,299,458,114,50,116,122,214,685,C
1986,30,44,570,86,224,5,17,81,207,34,38,14,39,53,40,17,6,23,44,211,SG
1986,30,4,18,3,9,0,0,3,9,1,1,0,0,0,0,0,0,2,1,7,SG
1986,30,40,552,83,215,5,17,78,198,33,37,14,39,53,40,17,6,21,43,204,SG
1986,26,40,311,30,58,0,0,30,58,18,27,16,38,54,21,11,7,23,74,78,C
1986,32,58,1161,199,451,6,18,193,433,106,119,29,94,123,108,31,8,68,81,510,SF
1986,22,32,219,22,43,0,0,22,43,10,19,10,39,49,5,3,12,20,54,54,C
1986,25,10,132,18,41,0,2,18,39,9,13,5,11,16,14,5,1,4,16,45,SG
1986,26,17,218,15,48,0,0,15,48,11,19,17,36,53,15,5,5,9,38,41,C
1986,26,9,154,11,30,0,0,11,30,6,11,9,24,33,11,3,2,7,26,28,C
1986,26,8,64,4,18,0,0,4,18,5,8,8,12,20,4,2,3,2,12,13,C
1986,31,32,419,49,104,0,1,49,103,19,27,9,42,51,86,40,3,55,80,117,PG
1986,24,78,1566,204,426,0,3,204,423,113,174,168,249,417,81,62,34,106,176,521,PF
1986,23,82,1292,294,608,2,9,292,599,58,73,83,153,236,45,62,7,86,164,648,SF
1986,26,77,760,92,189,0,10,92,179,15,23,22,55,77,104,19,4,50,92,199,SG
1986,24,17,258,49,93,0,0,49,93,18,27,16,36,52,14,7,15,14,51,116,PF
1986,30,55,1557,232,466,0,4,232,462,149,217,146,346,492,70,38,30,106,203,613,PF
1986,27,79,2801,650,1404,0,2,650,1402,377,501,193,477,670,176,101,143,275,277,1677,C
1986,27,9,67,7,24,0,1,7,23,6,7,2,2,4,4,1,0,7,14,20,SG
1986,27,5,31,2,8,0,1,2,7,1,1,2,1,3,3,1,0,6,6,5,SG
1986,27,4,36,5,16,0,0,5,16,5,6,0,1,1,1,0,0,1,8,15,SG
1986,28,2,36,3,7,0,0,3,7,6,10,2,8,10,5,1,1,6,6,12,C
1986,22,64,1092,202,431,0,4,202,427,90,139,107,165,272,21,31,8,69,127,494,PF
1986,27,29,185,28,83,1,5,27,78,35,44,15,19,34,4,6,0,13,23,92,PF
1986,26,66,2019,432,928,13,48,419,880,346,414,126,305,431,132,55,37,194,248,1223,PF
1986,22,36,273,49,88,0,0,49,88,24,36,13,26,39,8,2,6,18,37,122,SF
1986,29,82,3270,490,913,4,17,486,896,282,335,55,180,235,753,207,27,238,160,1266,PG
1986,24,45,469,75,184,3,15,72,169,12,20,6,40,46,82,20,3,49,65,165,PG
1986,23,81,1868,272,597,27,83,245,514,135,164,41,136,177,257,113,10,115,188,706,PG
1986,26,36,413,51,136,2,7,49,129,40,54,25,37,62,43,24,1,15,23,144,PG
1986,27,79,1965,267,627,11,53,256,574,84,111,51,126,177,390,156,22,132,172,629,PG
1986,29,36,373,31,73,0,1,31,72,27,42,33,53,86,21,13,11,14,65,89,PF
1986,29,34,356,28,67,0,1,28,66,26,41,31,50,81,21,13,11,11,64,82,PF
1986,29,2,17,3,6,0,0,3,6,1,1,2,3,5,0,0,0,3,1,7,PF
1986,22,6,38,2,11,0,0,2,11,5,10,5,5,10,1,4,0,2,5,9,PF
1986,29,82,2269,274,606,63,163,211,443,147,170,44,200,244,466,89,43,151,238,758,SG
1986,29,78,2112,422,906,3,7,419,899,174,219,190,420,610,81,42,227,117,315,1021,C
1986,23,16,174,27,64,0,1,27,63,10,14,11,14,25,11,11,2,12,21,64,SF
1986,29,67,1709,255,519,3,12,252,507,127,171,132,301,433,150,28,53,104,133,640,C
1986,27,3,4,0,3,0,0,0,3,0,2,1,0,1,0,0,0,0,2,0,C
1986,27,1,1,0,1,0,0,0,1,0,0,0,0,0,0,0,0,0,0,0,C
1986,27,2,3,0,2,0,0,0,2,0,2,1,0,1,0,0,0,0,2,0,C
1986,24,21,128,6,24,0,0,6,24,14,25,9,21,30,1,2,3,6,38,26,PF
1986,29,31,1007,195,408,0,2,195,406,97,139,92,188,280,47,27,12,87,136,487,C
1986,24,82,2669,681,1438,0,2,681,1436,265,404,222,472,694,193,121,51,191,283,1627,PF
1986,28,80,2017,285,564,0,2,285,562,117,211,198,306,504,137,58,58,150,239,687,PF
1986,25,35,723,203,470,0,8,203,462,163,198,20,48,68,67,22,5,67,86,569,SG
1986,29,76,2744,818,1453,1,11,817,1442,630,796,178,217,395,264,64,4,231,206,2267,SF
1986,30,82,1971,267,502,32,89,235,413,198,228,26,120,146,467,57,15,110,174,764,PG
1986,27,57,873,188,397,3,24,185,373,61,75,60,110,170,55,26,7,50,113,440,SF
1986,30,66,1014,148,344,3,13,145,331,118,138,8,47,55,217,37,4,78,76,417,SG
1986,30,39,612,102,237,2,11,100,226,67,79,6,30,36,105,24,4,40,44,273,SG
1986,30,27,402,46,107,1,2,45,105,51,59,2,17,19,112,13,0,38,32,144,SG
1986,31,70,2239,624,1287,18,76,606,1211,257,305,54,149,203,361,99,3,219,153,1523,SG
1986,29,51,1207,284,441,0,1,284,440,210,297,85,166,251,77,16,59,124,227,778,C
1986,25,64,1075,198,399,1,3,197,396,159,237,71,112,183,109,46,11,98,121,556,SF
1986,28,83,2682,256,459,0,0,256,459,204,254,171,624,795,96,28,139,123,189,716,C
1986,28,14,441,43,84,0,0,43,84,57,70,28,103,131,12,5,29,38,33,143,C
1986,28,69,2241,213,375,0,0,213,375,147,184,143,521,664,84,23,110,85,156,573,C
1986,27,75,1971,376,776,10,31,366,745,128,161,25,100,125,338,66,2,133,134,890,PG
1986,23,75,2576,542,1142,12,60,530,1082,293,381,171,250,421,600,197,46,282,270,1389,SG
1986,22,82,1957,287,597,5,16,282,581,190,238,60,59,119,390,66,11,158,200,769,SG
1986,30,82,2401,172,379,0,1,172,378,68,88,143,234,377,171,155,16,51,228,412,SG
1986,25,4,51,8,21,0,0,8,21,1,4,2,6,8,5,3,0,4,10,17,SF
1986,29,80,2551,277,589,0,0,277,589,122,202,172,503,675,101,33,369,157,282,676,C
1986,26,73,1491,262,577,1,9,261,568,132,151,24,62,86,259,89,4,137,87,657,PG
1986,30,52,1314,318,587,0,0,318,587,212,302,79,222,301,74,23,29,128,200,848,C
1986,24,36,199,36,84,3,9,33,75,23,29,17,29,46,29,11,4,15,22,98,SG
1986,25,72,1086,193,470,63,173,130,297,59,82,86,82,168,37,40,9,38,78,508,SF
1986,32,81,3024,951,1888,1,5,950,1883,511,593,192,213,405,320,73,29,249,235,2414,SF
1986,35,74,2474,521,1085,9,32,512,1053,289,368,169,201,370,248,113,82,214,196,1340,SF
1986,30,81,1389,304,715,39,176,265,539,126,149,30,71,101,177,61,1,124,159,773,PG
1986,23,50,1771,386,814,0,5,386,809,226,306,124,327,451,102,54,103,172,191,998,C
1986,23,78,1120,204,398,0,4,204,394,91,132,59,144,203,79,51,15,77,170,499,SF
1986,23,80,2870,436,862,1,6,435,856,263,353,102,284,386,505,131,5,208,230,1136,PG
1986,25,82,2764,510,1007,39,119,471,888,351,441,76,221,297,746,157,16,290,199,1410,PG
1986,25,48,704,85,218,9,32,76,186,23,32,9,49,58,121,22,1,61,77,202,PG
1986,32,75,2535,652,1433,71,169,581,1264,379,486,72,146,218,314,91,19,172,186,1754,SG
1986,25,80,1197,112,239,0,2,112,237,116,162,106,169,275,95,39,22,91,174,340,PF
1986,33,82,2065,519,1100,4,19,515,1081,283,322,78,137,215,144,49,23,161,210,1325,SG
1986,25,32,161,20,51,0,0,20,51,8,11,15,25,40,5,8,4,6,35,48,PF
1986,36,71,2395,423,684,0,1,423,683,338,482,166,434,600,102,39,108,186,239,1184,C
1986,30,38,573,94,190,0,0,94,190,47,49,4,53,57,39,9,3,18,42,235,SG
1986,26,49,772,84,209,1,1,83,208,70,122,31,132,163,32,26,25,76,124,239,PF
1986,26,81,2525,491,949,0,1,491,948,351,393,206,462,668,133,56,71,140,163,1333,C
1986,23,60,704,130,345,7,28,123,317,45,56,24,44,68,60,33,10,62,91,312,SG
1986,22,67,423,54,108,0,0,54,108,47,74,45,73,118,15,8,11,32,94,155,C
1986,22,82,1542,209,388,1,6,208,382,102,167,160,221,381,54,49,49,99,229,521,PF
1986,26,7,72,13,27,0,0,13,27,5,9,12,15,27,2,4,0,1,8,31,PF
1986,21,41,453,83,192,0,1,83,191,35,49,27,46,73,9,5,9,35,53,201,SF
1986,21,20,221,44,101,0,1,44,100,21,26,17,21,38,3,4,7,17,26,109,SF
1986,21,21,232,39,91,0,0,39,91,14,23,10,25,35,6,1,2,18,27,92,SF
1986,31,80,2012,357,758,5,29,352,729,213,250,32,103,135,411,106,6,132,130,932,PG
1986,25,80,2307,407,875,0,8,407,867,262,335,208,450,658,139,70,37,220,292,1076,PF
1986,28,68,1910,198,388,0,1,198,387,142,184,151,380,531,90,37,52,113,207,538,PF
1986,27,2,2,1,2,0,0,1,2,0,0,2,0,2,0,1,0,2,1,2,PF
1986,30,76,1402,148,355,26,61,122,294,90,108,42,164,206,119,39,13,50,192,412,SF
1986,27,8,128,20,37,0,0,20,37,18,27,17,21,38,3,3,4,11,25,58,C
1986,25,82,2032,299,628,17,50,282,578,95,132,82,162,244,193,74,9,126,205,710,SG
1986,28,79,1982,331,741,8,41,323,700,318,405,88,176,264,316,107,16,165,277,988,SF
1986,24,79,2150,390,730,12,51,378,679,171,229,75,151,226,416,153,23,144,166,963,PG
1986,22,57,482,103,233,1,5,102,228,50,54,25,32,57,50,21,4,34,55,257,SG
1986,25,62,650,65,159,3,4,62,155,60,70,44,80,124,26,14,8,40,118,193,PF
1986,30,58,397,39,87,0,0,39,87,11,36,32,45,77,7,5,19,16,81,89,C
1986,30,82,2568,434,900,18,52,416,848,185,223,89,98,187,487,138,11,184,230,1071,PG
1986,26,1,3,2,3,0,0,2,3,0,0,0,1,1,0,0,0,0,1,4,C
1986,25,28,149,31,67,4,10,27,57,12,17,8,11,19,4,5,0,9,11,78,SG
1986,26,30,332,39,106,1,9,38,97,19,27,14,37,51,24,9,11,13,49,98,SF
1986,26,12,94,9,27,1,4,8,23,3,5,3,9,12,6,2,1,4,11,22,SF
1986,26,11,128,18,40,0,2,18,38,11,16,5,19,24,12,2,3,5,21,47,SF
1986,26,2,29,3,16,0,2,3,14,0,0,3,5,8,1,1,4,2,6,6,SF
1986,26,5,81,9,23,0,1,9,22,5,6,3,4,7,5,4,3,2,11,23,SF
1986,24,82,2834,621,1167,0,4,621,1163,364,506,167,472,639,102,62,112,188,316,1606,SF
1986,25,66,1739,284,568,73,162,211,406,75,86,39,78,117,229,74,2,89,157,716,SG
1986,24,4,65,4,20,0,2,4,18,4,6,1,2,3,7,2,0,4,7,12,SG
1986,24,24,447,73,155,1,10,72,145,24,38,10,20,30,48,23,0,23,40,171,PG
1986,29,23,640,93,198,0,1,93,197,76,112,48,72,120,29,20,3,66,78,262,SF
1986,23,68,866,152,372,3,17,149,355,49,84,49,64,113,61,26,5,63,79,356,SG
1986,23,82,2733,352,735,4,29,348,706,197,257,56,204,260,526,132,9,190,222,905,PG
1986,28,82,1208,140,273,2,6,138,267,63,92,10,55,65,342,38,4,83,67,345,PG
1986,29,68,1014,110,244,0,2,110,242,76,115,63,146,209,82,32,17,72,163,296,PF
1986,29,42,669,74,163,0,2,74,161,43,67,42,90,132,53,22,14,51,109,191,PF
1986,29,26,345,36,81,0,0,36,81,33,48,21,56,77,29,10,3,21,54,105,PF
1986,29,75,1069,105,223,0,0,105,223,51,81,106,149,255,15,23,62,38,129,261,C
1986,31,78,2732,482,1060,6,42,476,1018,243,297,69,199,268,456,110,35,173,206,1213,PG
1986,26,82,2514,623,1311,4,20,619,1291,280,343,173,246,419,214,54,17,191,237,1530,SF
1986,30,71,1477,284,621,29,85,255,536,112,155,30,91,121,333,18,2,150,128,709,SG
1986,30,39,862,155,328,5,20,150,308,79,110,17,58,75,219,10,1,90,72,394,SG
1986,30,32,615,129,293,24,65,105,228,33,45,13,33,46,114,8,1,60,56,315,SG
1986,27,14,402,69,154,0,3,69,151,38,54,7,21,28,76,11,1,29,30,176,PG
1986,37,41,264,12,23,0,0,12,23,11,16,26,34,60,13,6,37,14,46,35,C
1986,29,2,7,1,3,0,0,1,3,2,2,1,1,2,0,0,0,1,1,4,PF
1986,23,64,815,113,214,0,0,113,214,37,85,90,153,243,19,13,22,59,147,263,PF
1986,26,72,2578,483,918,10,43,473,875,378,434,85,341,426,907,113,16,273,133,1354,PG
1986,29,75,2605,613,1201,1,15,612,1186,298,392,156,260,416,283,107,50,183,214,1525,SG
1986,33,79,1574,214,507,5,24,209,483,183,233,98,234,332,217,67,25,165,248,616,PF
1986,28,71,1828,362,573,0,0,362,573,259,373,143,319,462,95,44,66,191,291,983,C
1986,29,79,1978,465,996,2,13,463,983,165,214,119,107,226,269,80,23,88,180,1097,SG
1986,34,70,1519,189,338,0,1,189,337,114,145,49,120,169,126,48,50,90,159,492,PF
1986,35,80,1437,126,254,0,7,126,247,124,150,105,250,355,74,38,61,102,244,376,C
1986,28,81,1609,129,254,0,1,129,253,54,86,122,199,321,76,57,133,71,235,312,C
1986,24,43,742,75,164,0,1,75,163,50,98,65,128,193,52,32,25,57,87,200,PF
1986,25,12,43,5,12,0,0,5,12,3,4,4,6,10,4,0,1,7,13,13,C
1986,29,53,1011,187,370,7,23,180,347,132,178,71,136,207,45,30,38,64,142,513,PF
1986,25,3,18,0,2,0,0,0,2,0,0,0,2,2,0,2,1,3,5,0,C
1986,22,18,451,150,328,3,18,147,310,105,125,23,41,64,53,37,21,45,46,408,SG
1986,22,20,75,17,39,0,0,17,39,10,14,3,3,6,10,7,0,7,9,44,SG
1986,32,37,324,28,49,0,2,28,47,18,22,29,52,81,43,10,3,22,62,74,C
1986,24,19,568,139,294,4,13,135,281,53,69,51,117,168,57,28,8,61,59,335,PF
1986,23,79,1217,258,470,0,6,258,464,156,229,137,156,293,83,85,32,113,208,672,SF
1986,26,73,1998,438,961,4,23,434,938,167,203,116,250,366,181,58,24,181,205,1047,SF
1986,24,64,464,34,91,0,1,34,90,15,39,35,93,128,17,3,28,32,81,83,C
1986,24,80,1180,160,344,0,0,160,344,94,130,113,260,373,46,24,34,107,224,414,C
1986,22,82,1695,263,519,0,1,263,518,156,257,171,296,467,55,37,69,111,296,682,C
1986,31,55,783,124,257,0,1,124,256,84,112,69,122,191,17,12,7,64,102,332,PF
1986,28,82,2891,545,1107,4,14,541,1093,266,319,305,770,1075,146,59,65,133,291,1360,C
1986,26,74,1321,245,514,7,30,238,484,111,133,53,147,200,117,39,4,68,155,608,SF
1986,26,44,701,109,243,3,13,106,230,55,64,34,87,121,64,20,3,30,88,276,SF
1986,26,30,620,136,271,4,17,132,254,56,69,19,60,79,53,19,1,38,67,332,SF
1986,28,74,1190,212,458,24,67,188,391,135,158,6,61,67,234,58,8,88,126,583,PG
1986,23,58,1197,177,380,2,9,175,371,75,96,116,235,351,67,29,37,78,204,431,PF
1986,27,27,222,26,52,0,3,26,49,15,19,0,10,10,54,9,3,42,27,67,PG
1986,25,78,2616,468,1061,12,38,456,1023,132,182,136,284,420,584,178,15,210,204,1080,PG
1986,25,81,1945,294,551,0,1,294,550,164,242,193,341,534,72,76,39,113,260,752,PF
1986,27,81,1812,318,577,0,2,318,575,160,266,199,393,592,101,49,142,161,300,796,C
1986,26,82,2444,592,1119,3,15,589,1104,199,236,155,169,324,300,102,24,194,216,1386,SG
1986,29,62,1176,264,548,3,16,261,532,89,104,47,51,98,82,41,13,59,92,620,SG
1986,32,65,2120,365,818,45,146,320,672,231,298,33,110,143,571,77,5,149,124,1006,PG
1986,33,77,1750,302,653,1,2,301,651,180,230,164,402,566,84,45,24,121,253,785,PF
1986,28,82,2426,286,592,58,141,228,451,73,90,41,137,178,446,81,11,117,201,703,PG
1986,27,80,1442,157,345,0,1,157,344,81,119,121,291,412,64,40,61,109,261,395,PF
1986,24,80,2992,735,1522,3,17,732,1505,322,371,66,222,288,191,70,12,168,180,1795,SG
1986,22,81,2475,504,1016,0,2,504,1014,195,405,174,544,718,236,105,44,279,295,1203,PF
1986,30,74,2706,571,1246,0,1,571,1245,617,784,339,533,872,90,67,71,261,194,1759,C
1986,25,57,673,97,214,8,42,89,172,53,82,26,56,82,55,32,5,41,68,255,SF
1986,23,66,691,143,298,0,8,143,290,46,54,42,60,102,52,21,7,58,108,332,SF
1986,23,3,7,1,2,0,0,1,2,0,0,1,3,4,0,0,1,2,2,2,PF
1986,23,5,14,2,5,0,0,2,5,0,2,0,0,0,0,0,0,0,5,4,SF
1986,26,75,1853,320,603,4,25,316,578,173,211,30,101,131,476,87,32,232,168,817,PG
1986,30,76,2458,314,661,0,3,314,658,447,562,241,383,624,215,61,29,206,252,1075,SF
1986,34,29,609,116,251,0,0,116,251,62,81,25,78,103,35,10,18,49,64,294,C
1986,22,45,461,69,180,1,9,68,171,18,35,14,16,30,67,38,4,40,61,157,SF
1986,23,77,1705,253,444,1,2,252,442,174,244,140,263,403,83,19,28,110,219,681,C
1986,24,82,2610,338,629,0,3,338,626,171,222,159,361,520,292,50,58,130,197,847,SF
1986,22,82,2706,576,1176,2,10,574,1166,250,364,307,348,655,193,101,37,248,305,1404,SF
1986,23,21,266,28,58,0,1,28,57,5,8,15,23,38,9,7,1,10,30,61,SF
1986,26,22,204,24,42,0,1,24,41,17,25,12,37,49,6,1,3,10,25,65,PF
1986,26,71,1213,252,544,41,114,211,430,42,64,51,89,140,83,53,7,70,131,587,SF
1986,28,68,2397,561,978,0,0,561,978,326,420,171,380,551,181,29,134,149,192,1448,PF
1986,27,30,430,61,166,27,75,34,91,25,30,9,27,36,23,29,2,18,54,174,SG
1986,30,9,83,10,23,0,0,10,23,2,2,1,4,5,13,3,0,2,9,22,PG
1986,33,56,863,131,285,0,3,131,282,64,79,44,69,113,35,9,10,34,85,326,C
1986,24,30,627,70,144,0,0,70,144,31,47,62,141,203,41,38,12,35,88,171,PF
1986,25,76,1131,167,347,10,37,157,310,73,93,43,88,131,269,65,1,108,165,417,PG
1986,30,82,2970,802,1697,0,12,802,1685,317,392,134,275,409,188,56,25,184,175,1921,SF
1986,29,45,521,59,139,0,0,59,139,25,34,36,103,139,30,6,6,25,92,143,C
1986,28,73,2567,470,962,33,103,437,859,498,580,115,219,334,357,103,18,174,178,1471,PG
1986,27,28,856,150,303,4,22,146,281,59,86,25,61,86,252,70,6,81,78,363,PG
1986,27,72,1012,116,292,7,32,109,260,65,89,34,81,115,108,56,15,79,132,304,PG
1986,27,12,160,21,53,2,7,19,46,11,15,9,16,25,19,6,3,18,26,55,PG
1986,27,60,852,95,239,5,25,90,214,54,74,25,65,90,89,50,12,61,106,249,PG
1986,22,55,1391,287,620,5,27,282,593,189,211,42,73,115,105,70,23,75,130,768,SG
1986,23,14,100,16,45,0,2,16,43,9,14,7,8,15,3,4,3,5,12,41,SF
1986,26,73,2484,582,1001,0,8,582,993,310,444,169,449,618,240,70,130,210,247,1474,PF
1986,29,69,2007,469,930,2,6,467,924,278,347,125,311,436,164,58,13,130,143,1218,PF
1986,26,29,126,15,43,0,0,15,43,19,26,13,19,32,7,4,19,12,35,49,C
1986,26,4,25,3,11,0,0,3,11,4,6,3,4,7,2,2,2,5,6,10,C
1986,26,25,101,12,32,0,0,12,32,15,20,10,15,25,5,2,17,7,29,39,C
1986,27,80,2226,351,694,0,3,351,691,194,262,152,301,453,62,33,105,120,267,896,PF
1986,27,13,280,37,72,0,1,37,71,17,29,23,37,60,14,3,12,13,38,91,PF
1986,27,67,1946,314,622,0,2,314,620,177,233,129,264,393,48,30,93,107,229,805,PF
1986,30,67,2138,403,921,42,121,361,800,131,162,45,135,180,576,84,3,190,143,979,PG
1986,27,67,1031,160,336,7,27,153,309,23,39,33,102,135,118,29,9,54,134,350,SF
1986,22,77,1772,281,541,0,3,281,538,178,269,255,409,664,133,68,30,175,250,740,PF
1986,23,68,2467,625,1188,0,0,625,1188,347,538,333,448,781,137,134,231,195,271,1597,C
1986,29,81,2157,225,403,0,2,225,401,162,210,113,310,423,266,43,23,148,276,612,PF
1986,28,52,1276,167,323,0,1,167,322,53,91,112,194,306,37,28,134,86,206,387,C
1986,27,74,2237,330,741,0,4,330,737,218,278,123,189,312,179,61,26,118,177,878,SF
1986,32,81,2567,530,966,0,0,530,966,245,335,246,524,770,145,65,116,187,215,1305,C
1986,28,75,1931,372,792,20,62,352,730,217,244,42,106,148,278,94,5,112,156,981,SG
1986,25,75,1570,153,328,15,50,138,278,74,92,18,76,94,274,55,2,63,172,395,PG
1986,24,80,2626,458,910,11,33,447,877,307,377,195,490,685,153,75,94,145,212,1234,PF
1986,23,82,1664,196,411,0,3,196,408,113,160,149,247,396,85,38,54,84,231,505,PF
1986,24,70,880,117,286,1,12,116,274,44,74,29,60,89,71,45,1,62,86,279,SG
1986,26,81,2147,429,798,3,23,426,775,266,310,94,137,231,177,83,6,107,252,1127,SG
1986,22,80,1602,255,457,0,2,255,455,171,254,95,213,308,90,71,37,148,190,681,SF
1986,27,69,1132,127,218,0,0,127,218,99,141,99,147,246,58,37,23,107,140,353,PF
1986,23,11,74,9,20,1,1,8,19,2,4,6,5,11,4,2,1,2,11,21,SF
1986,30,81,1496,166,348,2,10,164,338,72,100,121,252,373,78,33,32,68,187,406,PF
1986,22,79,1214,212,447,13,42,199,405,125,155,35,82,117,198,81,1,106,136,562,PG
1986,27,80,2704,411,843,8,44,403,799,316,392,127,272,399,623,168,71,240,247,1146,SF
1986,27,74,1573,160,269,0,0,160,269,88,122,156,361,517,69,66,33,97,198,408,PF
1986,27,79,1504,231,505,3,24,228,481,121,148,34,82,116,252,51,4,114,128,586,PG
1986,23,48,330,61,150,0,0,61,150,31,39,37,60,97,16,3,10,40,63,153,C
1986,30,82,2157,409,881,6,33,403,848,162,214,67,234,301,222,91,16,96,231,986,SF
1986,23,55,508,72,162,1,2,71,160,58,104,37,43,80,86,43,19,52,57,203,SF
1986,29,82,2224,335,736,1,9,334,727,123,147,69,182,251,372,58,8,136,153,794,SG
1986,30,47,1604,296,661,4,27,292,634,141,179,77,173,250,340,125,11,150,163,737,PG
1986,24,53,1571,220,464,0,16,220,448,172,283,49,113,162,443,120,13,141,185,612,PG
1986,25,58,469,74,167,1,2,73,165,67,87,31,49,80,27,8,6,53,72,216,PF
1986,23,82,2878,562,1093,8,29,554,1064,260,327,184,332,516,448,301,40,256,296,1392,SG
1986,30,46,629,72,191,0,3,72,188,33,48,40,108,148,58,19,5,66,92,177,C
1986,25,78,2563,595,1255,1,4,594,1251,269,353,180,500,680,186,98,44,206,217,1460,SF
1986,30,74,1781,173,347,0,1,173,346,69,90,131,327,458,41,38,167,91,239,415,C
1986,32,79,2321,322,660,0,6,322,654,273,362,210,432,642,167,36,51,187,194,917,PF
1986,26,2,9,1,3,0,0,1,3,1,2,0,1,1,1,0,0,0,1,3,SG
1986,27,30,1114,212,383,0,4,212,379,145,200,107,213,320,159,23,25,121,100,569,PF
1986,25,1,2,0,1,0,0,0,1,0,0,0,0,0,1,0,0,0,0,0,PG
1986,25,79,2864,624,1280,2,15,622,1265,241,376,258,621,879,283,99,129,285,308,1491,PF
1986,25,82,1644,347,676,3,15,344,661,208,257,104,169,273,150,76,31,143,236,905,SF
1986,26,80,1654,221,440,0,1,221,439,216,278,154,285,439,79,42,63,105,298,658,C
1986,23,64,969,142,315,3,7,139,308,110,152,70,128,198,88,23,10,84,166,397,SF
1986,24,76,2190,507,989,22,61,485,928,138,176,55,134,189,164,85,15,110,167,1174,SG
1986,23,78,1168,142,301,1,11,141,290,78,126,97,145,242,85,78,66,96,171,363,SF
1986,30,44,682,92,188,0,2,92,186,14,16,38,105,143,61,21,4,48,128,198,PF
1986,28,64,2427,633,1313,15,49,618,1264,351,406,126,203,329,237,92,22,184,229,1632,SF
1986,29,82,1596,235,412,6,16,229,396,61,66,27,77,104,188,50,0,73,118,537,PG
1986,30,80,2790,508,1100,0,13,508,1087,355,411,146,602,748,301,92,73,214,293,1371,C
1986,24,11,339,100,181,1,2,99,179,58,84,20,21,41,31,9,13,33,35,259,SG
1986,28,77,2441,314,586,0,1,314,585,112,227,384,472,856,95,62,50,135,286,740,PF
1986,23,38,408,46,122,0,2,46,120,16,29,46,64,110,19,6,23,29,95,108,C
1986,33,78,1279,240,541,13,43,227,498,110,125,29,70,99,180,44,2,85,139,603,SG
1986,27,74,2344,345,723,5,20,340,703,101,127,50,120,170,472,85,14,154,182,796,PG
1986,26,43,471,88,192,0,1,88,191,38,49,28,53,81,49,18,9,54,78,214,SF
1986,24,74,1331,191,441,9,53,182,388,107,132,29,110,139,206,59,8,139,200,498,SG
1986,25,79,2397,416,885,2,10,414,875,242,315,173,450,623,206,75,69,146,261,1076,C
1986,23,3,14,1,4,0,0,1,4,1,4,3,0,3,1,0,0,3,2,3,SF
1986,23,82,1935,228,466,2,15,226,451,172,205,33,146,179,610,157,10,168,227,630,PG
1986,22,31,350,56,119,0,1,56,118,14,21,27,30,57,17,14,11,19,56,126,PF
1986,24,70,1150,220,476,21,60,199,416,39,48,22,58,80,261,34,0,85,110,500,PG
1986,25,82,2158,475,958,4,25,471,933,211,265,96,139,235,115,71,34,136,241,1165,SG
1986,28,82,2919,546,1137,6,35,540,1102,405,490,73,231,304,788,112,20,327,231,1503,SG
1986,24,42,531,100,233,2,5,98,228,29,48,28,47,75,28,23,15,39,82,231,SF
1986,25,49,385,54,110,0,1,54,109,55,88,27,43,70,15,11,3,19,55,163,PF
1986,24,77,2790,609,1248,26,84,583,1164,365,462,83,194,277,830,171,20,289,245,1609,PG
1986,25,6,69,6,15,0,0,6,15,1,2,3,5,8,12,5,1,9,12,13,SG
1986,23,61,1281,195,399,0,2,195,397,127,157,58,83,141,132,51,10,90,151,517,SG
1986,24,80,2377,411,794,0,1,411,793,202,276,252,518,770,168,71,109,184,295,1024,C
1986,31,82,2569,503,1011,0,0,503,1011,198,309,181,427,608,176,76,35,196,267,1204,C
1986,24,23,432,70,194,2,12,68,182,37,43,27,36,63,24,15,17,30,49,179,SF
1986,23,71,1323,125,274,0,0,125,274,86,162,113,177,290,43,30,7,83,209,336,PF
1986,23,75,1675,289,492,0,0,289,492,164,248,137,283,420,84,35,34,123,233,742,PF
1986,24,70,1754,310,684,1,24,309,660,75,90,21,100,121,193,93,5,102,157,696,SG
1986,21,81,2277,516,1002,0,2,516,1000,160,234,191,393,584,79,32,44,188,290,1192,PF
1986,28,6,84,11,36,0,2,11,34,3,8,2,3,5,12,2,0,7,8,25,SG
1986,23,13,230,28,66,3,10,25,56,21,31,3,22,25,26,6,0,22,24,80,PG
1986,23,3,24,2,7,0,0,2,7,1,1,0,2,2,0,1,0,3,6,5,PG
1986,23,10,206,26,59,3,10,23,49,20,30,3,20,23,26,5,0,19,18,75,PG
1986,26,81,2626,615,1236,12,25,603,1211,380,444,116,232,348,265,93,10,183,167,1622,SF
1986,26,77,1788,349,740,41,91,308,649,79,100,70,99,169,192,65,8,70,167,818,SG
1986,26,73,1324,165,379,0,9,165,370,39,53,64,137,201,165,70,6,80,150,369,SG
1986,23,53,650,84,171,0,1,84,170,58,78,45,92,137,14,21,3,49,125,226,PF
1986,25,80,2292,456,838,0,4,456,834,185,228,182,374,556,55,65,106,134,260,1097,C
1986,29,71,1651,295,649,0,3,295,646,84,112,109,204,313,94,64,108,94,159,674,SF
1986,26,62,1217,161,388,4,14,157,374,130,175,32,93,125,246,72,2,115,123,456,PG
1986,26,28,734,92,206,1,3,91,203,71,100,20,52,72,139,49,1,58,78,256,PG
1986,26,34,483,69,182,3,11,66,171,59,75,12,41,53,107,23,1,57,45,200,PG
1986,27,79,2791,719,1332,1,8,718,1324,523,602,92,124,216,187,54,17,177,161,1962,SF
1986,22,11,202,23,72,0,0,23,72,8,23,21,39,60,16,2,5,20,34,54,C
1986,26,61,749,90,167,1,2,89,165,25,43,65,95,160,29,29,17,30,141,206,PF
1986,26,80,1994,442,919,0,3,442,916,222,274,107,261,368,180,66,21,145,193,1106,PF
1986,22,57,432,59,162,1,4,58,158,65,70,11,37,48,69,17,4,49,59,184,SG
1986,27,80,1569,131,284,0,4,131,280,39,75,115,166,281,68,63,31,58,218,301,SF
1986,25,43,156,13,39,0,1,13,38,1,6,15,13,28,8,4,10,11,30,27,C
1986,24,81,2023,324,753,0,10,324,743,190,277,100,120,220,337,146,36,192,216,838,PG
1986,33,80,1546,231,411,0,0,231,411,144,202,136,408,544,165,38,106,151,210,606,C
1986,26,36,685,85,182,3,12,82,170,54,68,10,59,69,115,27,2,53,79,227,PG
1986,26,5,27,4,10,1,2,3,8,1,1,0,3,3,6,2,0,5,3,10,PG
1986,26,31,658,81,172,2,10,79,162,53,67,10,56,66,109,25,2,48,76,217,PG
1986,22,79,1229,199,412,2,11,197,401,216,275,27,96,123,337,82,5,159,164,616,PG
1986,33,79,1402,286,605,17,48,269,557,45,68,66,126,192,83,38,22,54,127,634,SF
1986,22,56,562,72,153,0,4,72,149,45,62,32,100,132,21,11,22,21,83,189,C
1986,25,67,1172,113,209,0,0,113,209,54,103,97,225,322,20,27,62,91,235,280,C
1986,23,14,107,15,35,0,0,15,35,5,10,4,10,14,23,5,1,10,10,35,PG
1986,23,8,66,9,19,0,0,9,19,4,7,2,5,7,13,5,0,6,8,22,PG
1986,23,4,27,5,14,0,0,5,14,1,3,2,5,7,7,0,1,0,1,11,PG
1986,23,2,14,1,2,0,0,1,2,0,0,0,0,0,3,0,0,4,1,2,PG
1986,26,75,1761,355,684,1,9,354,675,164,222,82,99,181,74,74,8,95,161,875,SF
1986,23,43,343,74,168,6,21,68,147,19,23,17,27,44,53,18,2,25,24,173,SG
1986,29,81,1079,126,294,0,0,126,294,60,97,94,234,328,19,18,19,64,176,312,C
1986,26,78,1198,222,489,1,12,221,477,86,118,87,72,159,101,59,5,62,155,531,SG
1986,32,13,195,26,65,1,3,25,62,22,27,13,16,29,15,7,2,16,19,75,SF
1986,26,78,3049,888,1897,13,70,875,1827,577,705,261,357,618,206,138,49,251,170,2366,SF
1986,22,81,2025,437,934,7,25,430,909,132,237,92,116,208,161,68,9,157,155,1013,SG
1986,30,75,1126,147,374,0,0,147,374,58,93,74,198,272,46,11,21,52,157,352,C
1986,30,48,604,96,240,0,0,96,240,30,47,40,105,145,28,3,11,32,86,222,C
1986,30,27,522,51,134,0,0,51,134,28,46,34,93,127,18,8,10,20,71,130,C
1986,25,82,3070,500,956,0,2,500,954,301,445,329,657,986,131,73,96,244,294,1301,PF
1986,29,9,110,25,67,7,14,18,53,12,17,4,8,12,7,7,1,13,10,69,SG
1986,32,77,2284,434,1013,30,116,404,897,138,188,52,114,166,453,96,15,160,113,1036,PG
1986,25,5,25,2,5,0,0,2,5,3,6,0,6,6,0,1,2,0,7,7,PF
1986,27,78,2770,627,1275,1,12,626,1263,294,403,172,538,710,174,50,184,210,244,1549,C
1986,20,53,573,67,111,0,0,67,111,17,40,47,99,146,14,19,23,19,68,151,PF
1986,31,47,827,117,306,6,19,111,287,115,126,35,51,86,187,61,4,101,124,355,PG
1986,31,19,367,57,143,4,11,53,132,41,48,19,26,45,67,28,1,41,48,159,PG
1986,31,23,397,50,131,2,6,48,125,62,64,13,24,37,111,28,3,51,64,164,PG
1986,31,5,63,10,32,0,2,10,30,12,14,3,1,4,9,5,0,9,12,32,PG
1986,28,6,54,5,21,0,4,5,17,7,12,7,8,15,2,1,1,7,15,17,SF
1986,23,82,2300,419,811,0,6,419,805,172,263,243,461,704,45,66,44,177,294,1010,PF
1986,23,4,17,3,13,0,1,3,12,0,0,1,2,3,0,1,0,2,1,6,SF
1986,26,81,2760,467,881,5,16,462,865,104,135,51,119,170,306,81,14,114,118,1043,SG
1986,27,78,1749,355,817,5,37,350,780,187,239,80,164,244,114,57,19,107,171,902,SG
1986,23,68,1198,184,466,41,114,143,352,123,155,25,65,90,182,34,0,74,70,532,PG
1986,23,29,455,57,136,13,29,44,107,27,34,9,18,27,75,14,0,7,24,154,PG
1986,23,39,743,127,330,28,85,99,245,96,121,16,47,63,107,20,0,67,46,378,PG
1986,27,81,2417,510,1073,2,13,508,1060,242,289,94,132,226,197,92,37,145,215,1264,SG
1986,26,70,2248,540,1090,4,23,536,1067,364,462,150,200,350,213,49,47,174,186,1448,SF
1986,24,75,2454,629,1086,0,13,629,1073,242,314,136,251,387,201,82,77,149,195,1500,SF
1986,23,82,1901,227,449,24,74,203,375,90,106,29,91,120,303,110,9,92,113,568,PG
1986,25,2,2,0,2,0,0,0,2,0,0,0,0,0,0,0,0,0,0,0,SF
1987,39,78,2441,560,993,1,3,559,990,245,343,152,371,523,203,49,97,186,245,1366,C
1987,32,68,1690,311,618,0,1,311,617,134,170,91,247,338,223,62,37,139,207,756,C
1987,24,63,1303,160,393,28,102,132,291,105,124,38,85,123,244,85,6,81,88,453,PG
1987,22,62,711,146,331,16,50,130,281,51,64,41,65,106,45,27,7,54,75,359,SF
1987,27,80,2663,787,1590,53,150,734,1440,429,557,181,246,427,254,84,30,217,243,2056,SF
1987,27,71,2499,410,844,85,192,325,652,148,165,49,193,242,400,101,14,141,189,1053,SG
1987,23,64,1110,217,443,2,9,215,434,67,101,73,141,214,74,22,28,56,138,503,PF
1987,26,51,312,59,139,4,16,55,123,22,29,24,55,79,33,7,3,19,37,144,PF
1987,28,63,721,139,294,0,5,139,289,85,108,73,78,151,54,31,3,55,65,363,SF
1987,26,72,2182,312,732,31,103,281,629,113,136,55,197,252,379,91,7,163,114,768,PG
1987,29,34,542,112,239,0,0,112,239,58,80,48,89,137,20,12,23,54,119,282,PF
1987,25,81,2155,463,1036,0,2,463,1034,190,236,145,287,432,102,38,88,123,150,1116,PF
1987,32,82,1579,248,564,15,40,233,524,68,91,99,241,340,108,50,15,70,167,579,SF
1987,27,63,1822,249,462,0,5,249,457,112,146,115,193,308,170,52,17,113,173,610,SF
1987,23,68,2740,557,937,21,104,536,833,429,564,390,604,994,331,119,104,322,252,1564,PF
1987,24,64,804,144,315,0,10,144,305,93,126,16,44,60,124,29,5,60,76,381,SG
1987,23,50,979,142,358,0,1,142,357,50,86,79,167,246,57,18,37,85,125,334,C
1987,22,72,2230,320,713,0,2,320,711,188,263,134,452,586,135,60,187,184,251,828,C
1987,32,73,895,140,316,2,7,138,309,47,58,80,151,231,39,39,28,45,138,329,C
1987,22,7,19,6,8,0,0,6,8,1,1,4,3,7,1,2,0,0,8,13,PF
1987,22,56,1567,401,758,0,3,401,755,186,287,132,170,302,104,36,40,153,188,988,SF
1987,25,11,51,4,10,0,0,4,10,6,10,8,10,18,1,2,2,3,5,14,PF
1987,30,74,3005,786,1497,90,225,696,1272,414,455,124,558,682,566,135,70,240,185,2076,SF
1987,31,7,127,19,42,0,1,19,41,6,9,3,4,7,17,3,0,9,16,44,SG
1987,24,30,160,20,51,0,0,20,51,13,28,11,25,36,13,4,9,15,33,53,C
1987,27,80,2758,626,1264,5,15,621,1249,419,474,96,182,278,266,64,21,174,142,1676,SG
1987,24,82,1552,103,231,0,1,103,230,45,67,84,278,362,11,20,302,61,189,251,C
1987,25,5,163,30,66,0,0,30,66,20,30,14,19,33,9,1,10,15,19,80,C
1987,29,68,900,76,213,13,50,63,163,47,58,31,71,102,66,105,8,34,118,212,SG
1987,23,32,219,48,96,0,2,48,94,42,54,23,30,53,16,16,3,24,39,138,SF
1987,26,76,1467,241,497,0,0,241,497,118,202,129,221,350,47,56,61,100,229,600,C
1987,27,37,404,53,94,0,0,53,94,40,59,40,57,97,12,14,4,25,105,146,PF
1987,27,7,83,10,30,0,4,10,26,10,11,8,11,19,5,6,2,7,13,30,C
1987,33,34,418,79,171,1,6,78,165,16,20,14,38,52,35,10,2,15,50,175,SF
1987,23,6,29,4,9,0,0,4,9,1,2,2,2,4,2,1,0,2,3,9,C
1987,28,10,148,13,37,0,0,13,37,7,10,9,19,28,11,9,0,11,19,33,SF
1987,23,62,818,106,201,0,0,106,201,46,72,71,143,214,24,20,7,59,129,258,C
1987,26,77,2339,358,810,5,20,353,790,152,206,84,135,219,259,89,14,153,273,873,SG
1987,25,80,2922,457,878,0,3,457,875,341,467,354,568,922,131,99,67,171,221,1255,PF
1987,24,40,332,57,145,0,3,57,142,24,39,21,37,58,19,12,1,34,40,138,SF
1987,27,42,297,30,92,5,16,25,76,15,20,8,22,30,35,8,0,25,28,80,SG
1987,25,65,695,134,265,1,3,133,262,73,103,60,96,156,34,14,48,40,146,342,PF
1987,31,49,1443,201,399,0,2,201,397,126,169,131,368,499,83,29,13,103,159,528,PF
1987,28,81,2724,690,1461,0,0,690,1461,340,432,173,416,589,214,92,123,226,255,1720,C
1987,29,58,1989,335,631,0,0,335,631,346,438,132,313,445,96,40,26,128,188,1016,C
1987,23,78,2149,413,835,0,4,413,831,199,335,248,312,560,56,43,14,145,195,1025,PF
1987,27,82,3018,660,1446,54,145,606,1301,535,630,163,382,545,245,81,50,268,307,1909,PF
1987,30,68,2624,415,788,4,17,411,771,227,292,47,168,215,538,180,15,173,109,1061,PG
1987,25,5,27,2,11,0,1,2,10,0,0,1,4,5,4,2,0,1,1,4,PG
1987,25,68,1029,182,313,0,1,182,312,88,121,99,189,288,37,32,31,94,200,452,C
1987,28,6,57,10,28,0,0,10,28,5,7,11,4,15,2,2,1,5,11,25,SF
1987,24,70,1322,169,397,4,17,165,380,82,107,23,85,108,210,56,12,70,99,424,PG
1987,24,27,473,49,142,0,9,49,133,33,39,9,33,42,94,19,6,32,38,131,PG
1987,24,43,849,120,255,4,8,116,247,49,68,14,52,66,116,37,6,38,61,293,PG
1987,28,82,1420,265,622,2,23,263,599,82,103,46,99,145,151,98,17,96,136,614,SG
1987,30,82,2253,322,736,89,231,233,505,126,148,58,196,254,373,78,43,102,199,859,SG
1987,30,69,1561,235,524,0,3,235,521,79,109,162,311,473,68,13,101,78,257,549,C
1987,24,63,1170,156,381,1,4,155,377,91,124,88,127,215,97,55,5,66,129,404,SF
1987,24,31,732,113,264,0,0,113,264,49,67,52,67,119,80,38,3,46,81,275,SF
1987,24,32,438,43,117,1,4,42,113,42,57,36,60,96,17,17,2,20,48,129,SF
1987,30,82,2287,294,619,0,5,294,614,95,129,199,341,540,209,38,87,114,202,683,C
1987,30,49,1056,172,382,0,0,172,382,79,110,123,189,312,38,26,7,85,145,423,PF
1987,25,82,2770,729,1426,0,3,729,1423,249,376,214,486,700,229,129,81,172,296,1707,PF
1987,29,78,1973,243,510,0,2,243,508,82,152,212,240,452,122,33,56,80,188,568,C
1987,29,43,1105,129,276,0,1,129,275,39,73,113,114,227,70,15,26,45,102,297,C
1987,29,35,868,114,234,0,1,114,233,43,79,99,126,225,52,18,30,35,86,271,C
1987,22,67,636,139,326,17,60,122,266,30,38,30,48,78,58,27,4,44,86,325,SG
1987,26,49,924,200,491,1,10,199,481,119,155,34,49,83,79,43,8,71,113,520,SG
1987,30,81,2736,601,1126,1,6,600,1120,539,664,104,228,332,162,63,7,181,193,1742,SF
1987,21,80,2695,487,905,0,0,487,905,279,401,152,495,647,304,49,63,248,248,1253,C
1987,31,82,1582,199,436,32,106,167,330,147,171,27,87,114,373,63,10,114,159,577,PG
1987,32,79,2646,779,1515,21,81,758,1434,288,334,90,154,244,364,96,5,226,184,1867,SG
1987,30,6,106,20,32,0,0,20,32,17,24,9,10,19,2,2,3,15,25,57,C
1987,23,81,1682,334,764,14,47,320,717,153,191,56,113,169,290,67,3,120,118,835,PG
1987,26,62,731,101,202,0,0,101,202,34,65,37,88,125,76,25,7,57,100,236,SF
1987,26,61,724,101,202,0,0,101,202,34,65,37,87,124,75,25,7,56,98,236,SF
1987,29,82,3028,311,531,0,0,311,531,267,329,295,678,973,63,51,136,104,191,889,C
1987,22,8,98,7,24,0,1,7,23,0,4,5,9,14,17,9,0,9,9,14,SG
1987,24,24,128,16,37,0,0,16,37,10,12,12,31,43,7,2,2,7,42,42,C
1987,28,60,1566,295,683,12,72,283,611,139,166,26,77,103,326,60,2,151,107,741,PG
1987,24,82,3114,707,1408,11,47,696,1361,357,470,227,291,518,566,204,71,253,281,1782,SG
1987,22,65,875,130,273,0,1,130,272,92,134,76,147,223,29,21,21,78,192,352,C
1987,22,14,122,18,45,0,0,18,45,9,14,13,18,31,6,5,3,4,27,45,C
1987,22,51,753,112,228,0,1,112,227,83,120,63,129,192,23,16,18,74,165,307,C
1987,23,79,2439,369,749,9,22,360,727,184,246,50,117,167,352,83,5,171,194,931,SG
1987,31,81,1932,118,276,0,2,118,274,36,55,91,174,265,147,100,21,33,160,272,SG
1987,30,79,2505,234,585,0,0,234,585,140,213,211,486,697,105,43,321,142,273,608,C
1987,27,3,26,1,8,0,0,1,8,2,2,1,0,1,0,1,0,2,6,4,PG
1987,27,8,122,9,32,0,4,9,28,10,14,2,8,10,29,5,0,17,7,28,PG
1987,31,14,304,57,110,0,0,57,110,54,70,20,40,60,19,6,7,15,42,168,C
1987,25,44,890,99,239,5,29,94,210,70,99,55,106,161,92,40,30,61,80,273,SG
1987,26,82,3073,785,1520,86,240,699,1280,385,489,187,260,447,238,104,32,238,267,2041,SG
1987,27,30,195,23,51,0,0,23,51,12,16,23,34,57,8,5,11,12,33,58,C
1987,27,7,17,4,8,0,0,4,8,3,3,6,2,8,1,1,1,2,0,11,C
1987,27,5,48,3,12,0,0,3,12,1,1,3,13,16,3,1,1,0,10,7,C
1987,27,18,130,16,31,0,0,16,31,8,12,14,19,33,4,3,9,10,23,40,C
1987,33,82,3085,965,1920,4,15,961,1905,411,487,146,198,344,422,73,21,214,216,2345,SF
1987,36,60,1918,400,850,14,53,386,797,191,235,115,149,264,191,76,94,158,137,1005,SF
1987,31,81,1567,334,729,53,169,281,560,96,123,36,92,128,185,79,12,107,149,817,SG
1987,24,63,2206,530,1053,0,7,530,1046,296,415,157,398,555,104,89,147,229,248,1356,PF
1987,24,62,498,88,202,0,1,88,201,53,71,39,78,117,22,9,4,38,83,229,C
1987,24,48,883,159,352,3,12,156,340,73,94,63,85,148,61,32,11,53,123,394,SF
1987,24,4,22,6,8,0,0,6,8,1,5,0,2,2,1,1,0,1,3,13,SF
1987,24,44,861,153,344,3,12,150,332,72,89,63,83,146,60,31,11,52,120,381,SF
1987,24,82,2549,370,727,2,10,368,717,238,302,109,225,334,473,109,18,167,222,980,PG
1987,26,82,3064,503,1030,73,190,430,840,462,537,56,212,268,848,146,18,280,199,1541,PG
1987,33,20,285,39,123,2,9,37,114,36,47,5,14,19,30,5,4,18,26,116,SG
1987,22,77,1104,148,311,0,3,148,308,108,171,87,183,270,36,24,33,88,178,404,PF
1987,37,82,2405,346,580,0,0,346,580,242,356,185,394,579,150,39,95,178,235,934,C
1987,31,4,34,5,13,0,0,5,13,5,7,0,2,2,1,1,0,0,3,15,SG
1987,27,72,2272,433,947,0,0,433,947,313,370,192,438,630,99,52,69,129,159,1179,C
1987,24,64,836,135,300,4,17,131,283,75,107,47,63,110,81,25,4,56,91,349,SG
1987,24,70,1130,221,545,14,48,207,497,70,95,64,62,126,139,61,13,102,106,526,SG
1987,25,15,166,20,54,0,3,20,51,9,11,6,11,17,27,7,1,22,17,49,PG
1987,23,55,456,41,101,0,0,41,101,28,39,39,90,129,26,10,28,36,93,110,C
1987,23,79,2240,316,587,0,5,316,582,220,282,210,405,615,84,70,80,102,171,852,PF
1987,22,19,172,25,70,0,0,25,70,14,19,6,22,28,7,4,2,15,8,64,SF
1987,32,81,2090,301,644,7,19,294,625,172,208,38,125,163,541,110,2,133,108,781,PG
1987,26,80,1792,256,542,0,2,256,540,119,177,196,457,653,62,41,50,127,197,631,PF
1987,29,79,2587,336,655,3,6,333,649,241,307,256,527,783,237,71,50,161,248,916,PF
1987,28,76,1843,463,1038,67,200,396,838,149,212,81,146,227,129,97,29,135,167,1142,SG
1987,26,72,1453,272,601,16,45,256,556,136,179,84,119,203,102,44,6,77,146,696,SG
1987,29,73,1990,307,746,22,80,285,666,316,402,79,177,256,280,87,28,132,245,952,PF
1987,25,77,2556,497,993,76,212,421,781,160,234,51,148,199,609,167,25,138,195,1230,PG
1987,23,82,3064,734,1614,20,94,714,1520,386,564,169,223,392,394,209,84,345,247,1874,SG
1987,23,74,1174,251,599,0,8,251,591,111,130,71,99,170,100,37,16,74,111,613,SG
1987,26,40,256,23,68,2,12,21,56,23,29,16,54,70,13,10,7,13,35,71,PF
1987,21,8,16,4,8,0,0,4,8,3,3,3,5,8,0,0,0,4,2,11,PF
1987,21,6,10,2,5,0,0,2,5,1,1,2,1,3,0,0,0,1,1,5,PF
1987,21,2,6,2,3,0,0,2,3,2,2,1,4,5,0,0,0,3,1,6,PF
1987,31,74,2045,298,674,19,77,279,597,190,230,50,125,175,471,101,11,172,208,805,PG
1987,31,6,155,25,50,0,3,25,47,17,18,6,3,9,32,6,0,15,17,67,PG
1987,31,68,1890,273,624,19,74,254,550,173,212,44,122,166,439,95,11,157,191,738,PG
1987,27,6,36,4,13,0,0,4,13,4,4,2,5,7,0,1,1,6,12,12,PF
1987,22,5,45,3,8,0,0,3,8,2,2,1,2,3,11,1,0,4,9,8,PG
1987,23,54,323,46,136,13,42,33,94,17,27,7,27,34,35,9,1,26,34,122,SG
1987,23,18,92,8,33,1,11,7,22,7,10,0,7,7,8,3,0,9,7,24,SG
1987,23,36,231,38,103,12,31,26,72,10,17,7,20,27,27,6,1,17,27,98,SG
1987,27,73,1497,214,412,3,17,211,395,200,240,72,165,237,96,40,21,76,145,631,SF
1987,25,76,2489,393,823,0,1,393,822,273,360,150,338,488,60,45,161,149,281,1059,SF
1987,26,78,2147,315,682,85,228,230,454,131,147,48,92,140,240,76,7,124,189,846,PG
1987,25,58,479,70,171,7,23,63,148,44,55,9,29,38,73,16,2,41,51,191,PG
1987,23,80,1561,159,350,12,43,147,307,94,121,41,143,184,361,70,5,153,130,424,SG
1987,30,68,2083,321,605,0,4,321,601,162,272,178,210,388,136,66,7,156,224,804,SF
1987,24,82,2579,359,753,5,27,354,726,200,260,62,198,260,632,112,9,195,239,923,PG
1987,29,19,428,55,121,1,2,54,119,18,34,6,11,17,101,14,0,45,28,129,PG
1987,30,78,845,100,215,0,4,100,211,78,116,64,109,173,36,16,11,56,154,278,PF
1987,22,8,22,2,9,0,0,2,9,7,8,1,2,3,6,1,0,5,1,11,PG
1987,23,60,520,94,201,0,1,94,200,40,58,38,50,88,40,17,15,37,81,228,SF
1987,30,78,1051,88,178,0,2,88,176,70,110,106,171,277,21,21,42,36,137,246,C
1987,32,79,2933,423,953,7,62,416,891,209,251,45,216,261,594,87,38,177,201,1062,PG
1987,31,24,508,85,186,5,15,80,171,42,55,11,35,46,115,12,1,41,36,217,SG
1987,27,81,2457,606,1309,37,118,569,1191,267,322,146,207,353,251,42,19,163,218,1516,SF
1987,28,18,399,59,128,0,1,59,127,35,49,10,20,30,58,21,0,31,31,153,PG
1987,27,80,2904,683,1308,8,39,675,1269,535,631,122,382,504,977,138,36,300,168,1909,PG
1987,30,10,302,68,155,0,6,68,149,30,42,9,24,33,28,12,5,17,24,166,SF
1987,24,29,234,27,64,0,3,27,61,20,38,15,28,43,5,9,2,18,55,74,PF
1987,29,79,2345,494,889,0,0,494,889,342,490,194,372,566,155,49,76,276,340,1330,C
1987,30,78,2166,533,1154,4,14,529,1140,158,201,123,134,257,300,92,16,133,159,1228,SG
1987,24,16,114,14,33,0,1,14,32,9,13,1,8,9,7,10,1,11,11,37,SG
1987,24,49,744,119,289,7,19,112,270,41,52,39,56,95,66,32,18,38,68,286,SF
1987,36,78,1578,111,224,0,2,111,222,97,124,114,341,455,64,23,77,87,227,319,PF
1987,29,79,1609,118,249,0,1,118,248,48,76,144,212,356,80,67,165,77,252,284,PF
1987,23,82,3281,1098,2279,12,66,1086,2213,833,972,166,264,430,377,236,125,272,237,3041,SG
1987,25,4,60,8,22,1,2,7,20,3,4,7,4,11,6,5,0,4,12,20,PF
1987,23,66,936,97,206,0,1,97,205,95,137,70,124,194,53,38,12,49,162,289,PF
1987,24,82,2088,373,733,1,23,372,710,262,364,201,295,496,194,122,77,149,328,1009,SF
1987,27,61,1291,244,573,13,32,231,541,81,100,82,132,214,103,34,28,103,177,582,SF
1987,30,6,214,52,105,0,0,52,105,32,43,13,19,32,19,2,0,15,14,136,SF
1987,23,6,31,3,6,0,1,3,5,3,4,4,5,9,1,2,3,0,4,9,PF
1987,25,74,745,47,110,0,1,47,109,29,76,61,108,169,27,17,46,34,148,123,C
1987,25,79,1658,256,543,0,1,256,542,110,140,173,310,483,71,35,30,90,213,622,C
1987,23,82,1684,169,352,0,1,169,351,125,191,153,340,493,31,52,76,92,262,463,C
1987,22,68,1004,170,373,1,12,169,361,110,148,77,162,239,85,22,12,67,141,451,PF
1987,29,82,2854,506,1010,6,21,500,989,245,274,243,712,955,151,72,69,120,283,1263,C
1987,26,1,16,1,3,0,0,1,3,1,2,1,4,5,0,1,0,1,0,3,C
1987,29,53,1175,147,358,18,57,129,301,100,119,14,47,61,224,53,10,64,126,412,PG
1987,24,67,870,170,374,0,1,170,373,72,101,93,158,251,69,25,40,85,147,412,PF
1987,26,82,3054,643,1370,22,92,621,1278,244,312,216,513,729,654,201,34,167,219,1552,PG
1987,26,82,1848,251,496,0,3,251,493,155,212,219,314,533,40,48,68,72,261,657,PF
1987,28,75,2288,346,687,0,1,346,686,179,265,223,482,705,110,32,180,169,289,871,C
1987,27,32,688,165,310,1,7,164,303,65,86,13,35,48,90,19,5,52,69,396,SG
1987,30,80,2265,490,1170,19,67,471,1103,219,246,75,142,217,258,96,8,153,167,1218,SG
1987,33,43,1358,285,624,46,126,239,498,137,174,29,96,125,290,71,6,89,82,753,PG
1987,34,63,1120,175,388,0,5,175,383,150,187,88,219,307,65,34,21,75,171,500,PF
1987,29,76,1250,164,341,14,46,150,295,34,41,25,88,113,197,59,7,58,136,376,PG
1987,28,63,1278,144,322,0,0,144,322,96,117,93,282,375,38,32,50,73,221,384,PF
1987,25,80,2763,689,1509,4,26,685,1483,376,425,50,168,218,298,75,13,182,154,1758,SG
1987,23,82,2857,728,1422,0,7,728,1415,323,540,278,577,855,158,104,60,237,323,1779,PF
1987,31,73,2488,595,1311,0,11,595,1300,570,692,340,484,824,120,59,92,202,139,1760,C
1987,26,23,284,31,94,3,9,28,85,18,31,10,29,39,45,18,4,23,32,83,SF
1987,24,8,68,9,25,0,0,9,25,7,8,2,5,7,0,4,2,7,5,25,SF
1987,24,24,146,9,31,0,1,9,30,4,11,8,20,28,9,7,1,20,24,22,C
1987,22,43,286,51,135,3,15,48,120,42,66,12,29,41,35,13,6,33,48,147,SF
1987,27,50,532,89,187,1,3,88,184,29,36,13,34,47,100,23,4,51,53,208,PG
1987,31,81,1968,253,477,0,1,253,476,303,391,175,260,435,197,39,14,136,178,809,SF
1987,31,35,1132,150,289,0,0,150,289,177,228,103,148,251,122,26,9,88,102,477,SF
1987,31,46,836,103,188,0,1,103,187,126,163,72,112,184,75,13,5,48,76,332,SF
1987,24,81,2817,391,718,0,4,391,714,251,349,180,431,611,114,36,64,153,270,1033,C
1987,25,81,3136,432,783,0,9,432,774,306,393,190,388,578,434,88,53,208,172,1170,SF
1987,26,24,279,30,65,0,0,30,65,20,41,19,39,58,23,9,4,24,28,80,PF
1987,23,82,3031,806,1583,3,14,803,1569,275,395,338,367,705,207,115,52,234,300,1890,SF
1987,24,63,1284,164,360,1,8,163,352,24,38,63,120,183,84,27,8,43,200,353,PF
1987,27,7,70,8,17,0,0,8,17,6,7,9,10,19,2,2,0,3,14,22,PF
1987,27,76,1420,311,677,86,229,225,448,80,137,71,88,159,149,61,2,104,156,788,SF
1987,29,77,3060,790,1307,0,4,790,1303,428,512,247,516,763,198,38,172,197,240,2008,PF
1987,28,56,942,153,337,52,124,101,213,43,57,21,56,77,93,54,7,53,141,401,SG
1987,23,6,42,7,28,1,2,6,26,2,2,2,5,7,1,1,0,3,9,17,SF
1987,22,71,1972,143,301,0,7,143,294,87,141,101,230,331,583,125,45,155,238,373,PG
1987,27,11,113,14,30,0,0,14,30,7,19,17,19,36,2,1,0,8,17,35,C
1987,25,59,972,88,179,0,0,88,179,52,80,74,153,227,46,36,16,64,136,228,PF
1987,25,3,7,3,3,0,0,3,3,0,0,3,5,8,0,0,1,0,1,6,PF
1987,26,74,1600,218,482,11,39,207,443,62,90,29,111,140,348,72,7,157,174,509,PG
1987,26,11,122,13,42,0,5,13,37,1,4,1,9,10,13,6,1,12,8,27,PG
1987,26,63,1478,205,440,11,34,194,406,61,86,28,102,130,335,66,6,145,166,482,PG
1987,31,40,922,208,478,1,2,207,476,92,112,38,65,103,38,19,9,51,68,509,SF
1987,30,62,626,52,129,0,1,52,128,46,64,45,93,138,22,18,13,22,126,150,C
1987,29,39,992,158,324,8,31,150,293,136,162,57,70,127,121,27,10,63,73,460,SG
1987,28,55,1234,198,448,22,79,176,369,56,70,32,68,100,250,83,3,102,97,474,PG
1987,28,64,698,91,207,1,14,90,193,49,69,29,66,95,90,42,3,57,96,232,PG
1987,23,82,2377,477,928,19,63,458,865,269,326,39,142,181,261,98,36,154,217,1242,SG
1987,24,21,141,31,72,0,0,31,72,9,16,17,22,39,5,3,2,6,21,71,PF
1987,23,29,155,19,52,0,6,19,46,28,43,8,9,17,21,14,2,10,25,66,SG
1987,27,69,2569,585,1062,1,5,584,1057,381,493,188,411,599,233,86,148,149,223,1552,PF
1987,30,1,20,4,10,0,0,4,10,2,2,2,3,5,2,1,0,1,2,10,PF
1987,26,60,980,84,192,4,31,80,161,51,69,96,188,284,83,40,11,36,144,223,PF
1987,27,41,267,31,63,0,0,31,63,14,24,36,47,83,4,7,30,21,73,76,C
1987,23,59,630,113,275,1,22,112,253,66,76,36,34,70,27,20,7,46,67,293,SF
1987,28,66,1088,155,330,0,4,155,326,81,120,80,107,187,25,20,54,63,156,391,PF
1987,28,38,811,119,252,0,3,119,249,57,88,58,75,133,18,16,41,47,118,295,PF
1987,28,28,277,36,78,0,1,36,77,24,32,22,32,54,7,4,13,16,38,96,PF
1987,23,25,91,16,40,5,17,11,23,20,22,1,7,8,16,7,0,10,6,57,PG
1987,28,15,123,16,42,0,2,16,40,0,2,6,8,14,13,2,0,6,10,32,SF
1987,23,82,2980,468,1052,11,30,457,1022,245,357,299,775,1074,296,85,36,299,315,1192,PF
1987,24,75,2760,677,1332,1,5,676,1327,400,570,315,543,858,220,140,254,228,294,1755,C
1987,30,76,1002,69,165,0,1,69,164,116,131,50,135,185,91,18,9,56,144,254,PF
1987,29,44,776,71,174,0,1,71,173,31,57,51,128,179,19,22,71,48,95,173,C
1987,28,65,1440,166,389,1,5,165,384,125,172,102,130,232,110,47,18,70,123,458,SF
1987,33,80,2995,588,1057,0,1,588,1056,227,309,254,597,851,173,64,144,191,266,1403,C
1987,29,72,1798,337,733,26,98,311,635,174,216,41,98,139,237,76,12,108,134,874,SG
1987,26,82,2689,386,793,52,140,334,653,106,131,22,117,139,467,66,8,105,207,930,PG
1987,25,80,2687,461,957,19,54,442,903,245,296,197,419,616,146,109,77,132,269,1186,PF
1987,22,82,2956,635,1358,49,138,586,1220,222,297,168,509,677,295,90,16,211,310,1541,SF
1987,24,82,2403,386,755,0,4,386,751,152,209,177,380,557,127,43,102,152,268,924,PF
1987,25,60,469,75,176,1,10,74,166,31,44,16,34,50,64,21,2,32,60,182,SG
1987,27,79,2505,575,1077,3,28,572,1049,387,440,117,149,266,144,64,24,120,222,1540,SG
1987,23,80,2250,290,497,0,2,290,495,257,348,179,401,580,116,86,54,135,196,837,SF
1987,23,1,6,1,4,0,3,1,1,0,0,0,0,0,0,1,0,1,3,2,SG
1987,31,58,604,62,122,0,4,62,118,40,50,30,71,101,35,9,34,21,77,164,PF
1987,31,37,437,41,82,0,3,41,79,31,39,20,57,77,28,6,22,17,51,113,PF
1987,31,21,167,21,40,0,1,21,39,9,11,10,14,24,7,3,12,4,26,51,PF
1987,23,80,2714,376,770,13,60,363,710,280,334,70,267,337,715,159,9,255,192,1045,PG
1987,28,61,2057,294,616,16,55,278,561,242,328,98,198,296,441,110,47,186,213,846,SF
1987,23,67,913,134,317,7,28,127,289,35,48,68,108,176,120,40,21,63,96,310,SF
1987,22,67,1217,173,424,23,70,150,354,95,114,33,84,117,202,43,4,105,75,464,PG
1987,28,78,1514,163,313,0,0,163,313,120,157,159,294,453,63,74,41,104,201,446,PF
1987,24,74,1421,268,570,0,0,268,570,169,231,183,282,465,60,24,58,79,224,705,C
1987,31,75,2594,420,1006,53,162,367,844,136,177,47,242,289,323,75,21,104,232,1029,SG
1987,24,58,963,140,356,6,18,134,338,118,184,72,101,173,106,50,30,82,91,404,SF
1987,30,78,1396,218,467,6,17,212,450,59,74,51,92,143,241,49,7,85,106,501,SG
1987,25,82,2590,342,758,4,21,338,737,365,441,83,216,299,823,171,30,217,287,1053,PG
1987,26,73,1079,139,270,0,3,139,267,124,153,54,136,190,62,22,20,89,129,402,PF
1987,24,81,2697,589,1264,13,48,576,1216,244,324,186,238,424,421,260,35,243,264,1435,SG
1987,26,55,1586,338,729,0,4,338,725,139,184,86,221,307,89,86,30,123,150,815,PF
1987,25,77,1155,213,391,0,1,213,390,74,126,163,169,332,56,38,48,93,166,500,SF
1987,23,45,468,90,185,0,5,90,180,9,15,30,47,77,26,9,8,20,66,189,PF
1987,31,75,1764,171,313,0,0,171,313,63,87,155,333,488,22,43,140,61,240,405,C
1987,33,36,669,90,220,1,5,89,215,57,72,64,106,170,39,11,16,49,77,238,PF
1987,24,7,16,4,9,1,1,3,8,3,4,1,0,1,1,4,0,3,1,12,SG
1987,28,5,116,19,28,0,0,19,28,9,12,12,16,28,10,0,4,10,13,47,PF
1987,26,48,511,64,165,2,16,62,149,27,37,18,37,55,129,20,5,60,62,157,PG
1987,22,82,1463,163,290,0,1,163,289,105,171,108,188,296,54,44,125,74,256,431,C
1987,26,43,1326,277,566,0,3,277,563,118,189,88,284,372,120,40,58,126,169,672,PF
1987,26,82,1655,357,722,2,17,355,705,143,183,101,170,271,126,61,23,105,210,859,SF
1987,27,76,1556,210,405,0,0,210,405,229,294,120,260,380,85,20,74,95,266,649,C
1987,26,63,579,71,190,2,13,69,177,29,46,52,65,117,27,20,11,42,94,173,PF
1987,24,81,1711,265,561,33,69,232,492,193,260,87,216,303,161,50,16,110,224,756,SF
1987,26,3,7,0,1,0,0,0,1,0,0,0,1,1,0,0,0,2,2,0,SG
1987,25,82,2729,554,1134,65,149,489,985,224,251,63,223,286,281,125,18,144,163,1397,SG
1987,24,69,753,123,247,4,13,119,234,94,134,97,101,198,57,55,54,56,124,344,SF
1987,24,80,1751,276,606,2,10,274,596,126,173,155,218,373,102,44,68,84,194,680,PF
1987,29,34,950,240,501,4,17,236,484,137,160,55,82,137,86,45,7,68,103,621,SF
1987,30,78,1566,202,398,7,26,195,372,37,42,22,69,91,187,40,1,61,124,448,PG
1987,31,82,2536,390,842,0,2,390,840,265,313,208,614,822,203,88,90,160,328,1045,C
1987,25,2,10,2,3,0,1,2,2,0,0,0,0,0,1,0,0,0,1,4,PG
1987,22,13,205,18,62,3,14,15,48,10,12,6,20,26,45,5,1,21,18,49,PG
1987,23,41,341,50,117,0,2,50,115,27,36,26,30,56,45,13,1,26,36,127,SG
1987,25,52,1658,338,757,9,33,329,724,178,228,60,122,182,204,46,23,126,184,863,SG
1987,22,42,461,57,150,3,9,54,141,21,28,13,19,32,43,25,3,30,74,138,SG
1987,29,80,2374,297,544,0,1,297,543,113,197,366,551,917,95,71,56,135,295,707,PF
1987,23,28,168,33,79,0,2,33,77,12,21,17,17,34,22,1,1,19,30,78,SG
1987,24,35,233,30,60,0,0,30,60,16,25,13,24,37,5,4,13,19,70,76,C
1987,28,80,1951,263,590,11,42,252,548,71,89,29,86,115,432,67,6,140,160,608,PG
1987,25,44,375,67,156,11,29,56,127,31,50,8,16,24,57,13,0,29,78,176,SG
1987,27,34,665,95,199,3,9,92,190,73,88,21,40,61,81,18,3,54,56,266,SG
1987,26,81,2761,382,760,1,4,381,756,307,367,184,486,670,180,106,97,130,304,1072,C
1987,24,82,1858,231,463,7,39,224,424,179,229,32,119,151,670,177,14,164,224,648,PG
1987,25,76,1765,365,751,50,149,315,602,70,84,20,78,98,315,35,0,97,109,850,PG
1987,22,75,1405,233,499,1,3,232,496,94,139,180,353,533,52,56,79,101,232,561,PF
1987,27,12,44,6,10,0,0,6,10,9,10,1,3,4,3,2,1,8,4,21,SG
1987,26,82,1650,370,808,0,10,370,798,182,234,68,107,175,105,68,13,117,190,922,SG
1987,29,79,2872,577,1223,17,78,560,1145,429,495,86,180,266,692,78,16,289,208,1600,PG
1987,26,17,89,10,24,0,1,10,23,5,16,5,14,19,2,2,0,5,12,25,SF
1987,25,81,3013,626,1353,19,98,607,1255,400,521,82,237,319,813,153,20,343,251,1671,PG
1987,24,24,331,42,105,0,3,42,102,27,33,20,11,31,18,11,5,16,53,111,SF
1987,23,59,762,142,261,0,1,142,260,48,74,69,102,171,60,15,30,61,148,332,SF
1987,25,82,2166,362,752,0,5,362,747,188,255,237,450,687,122,69,126,143,290,912,C
1987,32,82,1890,359,797,1,2,358,795,219,297,138,274,412,115,45,71,134,202,938,PF
1987,32,49,1210,230,528,1,1,229,527,144,196,91,185,276,87,31,41,77,117,605,PF
1987,32,33,680,129,269,0,1,129,268,75,101,47,89,136,28,14,30,57,85,333,PF
1987,24,33,282,29,67,0,1,29,66,13,20,18,38,56,8,4,3,24,48,71,PF
1987,24,82,2956,567,1050,0,3,567,1047,413,543,259,560,819,201,46,60,189,292,1547,PF
1987,25,68,1446,239,534,7,32,232,502,95,119,26,82,108,259,74,13,89,164,580,PG
1987,25,28,668,108,261,7,16,101,245,42,53,18,39,57,82,32,4,47,76,265,PG
1987,25,40,778,131,273,0,16,131,257,53,66,8,43,51,177,42,9,42,88,315,PG
1987,22,81,2159,458,892,0,2,458,890,258,364,217,258,475,117,50,26,139,293,1174,PF
1987,29,52,1058,197,437,22,67,175,370,133,167,16,69,85,188,18,8,112,78,549,SG
1987,27,79,1865,291,621,19,52,272,569,197,226,54,188,242,243,85,11,167,147,798,SF
1987,27,70,1691,325,691,68,161,257,530,77,101,49,86,135,166,116,13,78,169,795,SG
1987,22,3,18,2,5,0,1,2,4,0,0,1,1,2,1,0,0,5,1,4,PG
1987,27,70,936,112,252,1,8,111,244,23,31,34,81,115,102,30,4,31,97,248,SF
1987,24,76,1003,151,325,0,1,151,324,76,104,80,117,197,60,33,13,81,200,378,PF
1987,26,64,801,169,366,0,0,169,366,55,77,62,128,190,33,11,40,63,90,393,C
1987,30,82,1930,329,664,1,3,328,661,101,140,116,212,328,73,55,78,78,151,760,SF
1987,27,65,1759,275,671,13,56,262,615,163,200,38,112,150,447,116,10,167,148,726,PG
1987,28,79,3029,808,1545,39,81,769,1464,467,527,86,165,251,220,52,17,139,137,2122,SF
1987,23,57,640,65,158,0,2,65,156,38,59,67,113,180,43,19,23,48,94,168,C
1987,27,5,44,5,14,0,0,5,14,0,0,2,5,7,2,2,1,0,11,10,PF
1987,27,51,1386,274,613,0,3,274,610,130,169,69,141,210,85,40,17,77,127,678,SF
1987,23,46,374,60,136,0,0,60,136,51,55,5,22,27,59,13,1,33,33,171,PG
1987,28,58,817,59,138,1,5,58,133,21,45,51,95,146,30,35,25,26,127,140,SF
1987,26,44,534,40,93,0,1,40,92,5,9,38,49,87,22,10,31,16,83,85,C
1987,25,81,2020,358,742,0,4,358,738,272,365,157,170,327,282,120,37,187,229,988,PG
1987,22,68,1719,285,581,0,4,285,577,140,185,118,220,338,75,49,49,75,236,710,SF
1987,34,10,112,10,26,0,0,10,26,8,15,11,20,31,9,1,10,15,23,28,C
1987,21,35,385,57,145,0,1,57,144,18,51,36,65,101,16,6,8,39,51,132,C
1987,23,72,1600,257,538,4,24,253,514,98,125,37,92,129,301,92,7,175,184,616,PG
1987,23,33,532,71,162,1,6,70,156,80,105,6,54,60,167,34,2,70,65,223,PG
1987,34,15,102,10,19,1,1,9,18,6,8,12,14,26,3,3,7,8,17,27,C
1987,34,6,78,9,27,1,2,8,25,1,2,3,6,9,6,2,2,3,6,20,SF
1987,23,58,560,56,132,0,2,56,130,45,60,53,76,129,24,13,10,39,95,157,C
1987,26,78,1333,209,385,0,2,209,383,89,173,126,213,339,41,22,81,106,229,507,C
1987,24,73,1816,246,515,0,2,246,513,126,165,58,136,194,392,92,10,138,172,618,PG
1987,27,68,1545,265,552,0,3,265,549,94,144,90,104,194,79,47,19,73,159,624,SF
1987,30,73,937,147,327,0,1,147,326,79,113,110,152,262,24,16,12,50,175,373,C
1987,27,32,788,153,350,0,5,153,345,49,65,74,59,133,76,44,3,50,82,355,SG
1987,27,79,2969,828,1787,31,106,797,1681,607,742,210,284,494,261,117,51,215,149,2294,SF
1987,24,24,454,56,127,0,1,56,126,27,58,45,62,107,6,9,2,28,67,139,PF
1987,23,80,2758,633,1302,26,74,607,1228,235,335,120,174,294,354,88,18,214,165,1527,SG
1987,26,82,2976,521,936,0,1,521,935,430,588,322,701,1023,129,78,91,280,315,1472,PF
1987,33,33,481,53,146,5,18,48,128,27,40,8,32,40,139,17,5,54,53,138,SG
1987,28,74,2526,451,939,0,9,451,930,199,269,143,400,543,174,59,93,145,255,1101,PF
1987,24,80,2714,435,897,0,1,435,896,298,400,222,407,629,154,58,167,139,197,1168,PF
1987,20,78,1773,283,624,8,36,275,588,144,223,130,236,366,191,129,30,122,173,718,SF
1987,25,65,703,132,296,0,7,132,289,55,66,47,36,83,66,45,8,63,154,319,SG
1987,21,5,10,1,2,0,0,1,2,0,0,0,1,1,1,0,0,1,1,2,PF
1987,32,32,800,131,290,7,28,124,262,49,60,26,49,75,185,38,9,94,111,318,PG
1987,24,81,2626,538,1003,1,4,537,999,227,320,321,528,849,62,65,61,173,313,1304,PF
1987,27,5,43,3,8,0,0,3,8,2,2,1,3,4,6,1,0,4,9,8,SG
1987,27,2,2,0,2,0,0,0,2,0,0,0,0,0,1,0,0,1,1,0,PG
1987,25,53,789,82,185,3,18,79,167,43,54,28,53,81,207,42,4,77,67,210,PG
1987,23,77,1612,259,602,13,52,246,550,149,201,70,86,156,155,93,19,128,169,680,SG
1987,27,71,2049,398,792,4,12,394,780,100,127,30,94,124,211,39,16,88,107,900,SG
1987,28,54,657,121,310,7,25,114,285,109,139,39,55,94,34,19,11,34,83,358,SG
1987,24,76,1733,187,501,60,200,127,301,123,154,23,97,120,370,48,3,108,126,557,PG
1987,28,74,2126,494,1130,34,123,460,1007,240,290,68,94,162,196,100,16,168,201,1262,SG
1987,27,75,2638,556,1067,1,8,555,1059,438,564,118,249,367,261,54,86,213,243,1551,SF
1987,25,82,2819,651,1207,0,13,651,1194,292,389,158,308,466,226,108,83,168,206,1594,SF
1987,24,14,138,20,46,0,1,20,45,12,28,25,28,53,1,3,6,13,20,52,PF
1987,24,73,1482,132,288,29,79,103,209,59,71,23,90,113,353,74,3,85,72,352,PG
1987,23,9,72,6,21,0,0,6,21,1,2,3,5,8,7,5,1,4,14,13,SG
1987,23,5,20,2,4,0,0,2,4,1,2,0,1,1,0,1,0,1,3,5,SG
1987,23,4,52,4,17,0,0,4,17,0,0,3,4,7,7,4,1,3,11,8,SG
1988,40,80,2308,480,903,0,1,480,902,205,269,118,360,478,135,48,92,159,216,1165,C
1988,25,79,1151,108,203,0,0,108,203,71,111,105,165,270,42,29,27,54,198,287,C
1988,33,82,1646,251,506,1,2,250,504,108,128,118,247,365,183,82,41,140,245,611,C
1988,25,82,2778,416,927,139,379,277,548,166,199,40,183,223,503,168,16,144,138,1137,PG
1988,28,77,2610,746,1571,52,172,694,1399,388,504,182,252,434,278,70,57,203,223,1932,SF
1988,28,81,3018,482,982,148,357,334,625,158,180,59,190,249,503,115,17,153,203,1270,SG
1988,24,63,769,144,300,4,18,140,282,35,49,70,90,160,39,10,12,50,107,327,PF
1988,23,28,197,21,55,1,8,20,47,16,17,3,20,23,23,17,3,12,23,59,PG
1988,23,82,1984,379,756,1,5,378,751,198,328,161,352,513,79,54,122,143,228,957,PF
1988,27,74,1350,171,439,48,150,123,289,58,77,91,212,303,112,51,16,61,137,448,PF
1988,27,12,53,11,26,6,15,5,11,4,5,9,8,17,4,1,0,1,4,32,PF
1988,27,62,1297,160,413,42,135,118,278,54,72,82,204,286,108,50,16,60,133,416,PF
1988,29,74,1097,217,436,0,2,217,434,108,141,89,127,216,78,41,6,73,98,542,SF
1988,22,9,85,14,43,0,0,14,43,6,8,6,7,13,8,3,4,4,16,34,SF
1988,21,14,234,22,74,0,0,22,74,8,11,6,16,22,33,10,6,12,12,52,SG
1988,27,82,2774,393,896,47,161,346,735,148,180,61,196,257,479,110,10,201,162,981,PG
1988,30,65,869,109,241,0,4,109,237,70,89,73,137,210,42,17,28,70,180,288,PF
1988,26,82,2804,633,1286,1,3,632,1283,337,408,134,397,531,158,49,125,190,186,1604,SF
1988,24,80,3170,753,1283,44,157,709,1126,714,951,385,566,951,254,100,103,304,278,2264,PF
1988,25,67,1227,278,613,16,41,262,572,141,188,26,87,113,158,31,5,75,84,713,SG
1988,24,38,298,44,101,0,0,44,101,13,23,27,38,65,4,8,17,19,47,101,C
1988,23,66,2171,340,693,0,8,340,685,180,255,112,418,530,172,50,225,223,203,860,C
1988,33,2,12,2,2,0,0,2,2,1,2,0,1,1,0,1,1,2,2,5,C
1988,23,73,1922,540,960,0,0,540,960,192,320,176,219,395,110,55,63,162,207,1272,SF
1988,31,76,2965,881,1672,98,237,783,1435,415,453,108,595,703,467,125,57,213,157,2275,SF
1988,32,67,1882,337,736,9,25,328,711,47,92,73,94,167,222,54,11,129,143,730,SG
1988,25,73,658,58,132,0,0,58,132,46,65,52,82,134,35,8,29,49,108,162,C
1988,28,71,2580,497,1050,0,5,497,1045,331,379,82,164,246,262,64,18,144,112,1325,SG
1988,22,10,112,15,41,2,11,13,30,5,6,2,4,6,18,3,0,8,16,37,PG
1988,23,79,1628,166,426,3,16,163,410,58,74,35,101,136,404,127,3,101,138,393,PG
1988,25,77,1136,75,165,0,1,75,164,26,49,72,203,275,13,11,208,35,160,176,C
1988,30,65,1437,156,365,37,102,119,263,74,97,25,102,127,151,114,43,88,172,423,SG
1988,30,63,1432,156,364,37,101,119,263,74,97,25,101,126,150,114,43,88,170,423,SG
1988,24,20,308,56,134,1,5,55,129,20,23,20,28,48,16,16,11,29,41,133,SF
1988,27,81,2258,390,788,0,0,390,788,188,286,191,360,551,103,46,107,107,198,968,C
1988,28,70,2227,425,805,1,5,424,800,268,349,167,316,483,266,74,36,207,275,1119,C
1988,29,16,133,20,49,0,0,20,49,3,4,19,25,44,13,4,1,12,21,43,SF
1988,24,46,591,78,174,0,1,78,173,41,71,66,93,159,28,11,4,38,85,197,C
1988,25,19,312,62,138,0,4,62,134,47,69,6,21,27,38,10,5,40,56,171,SG
1988,26,72,2660,360,766,0,1,360,765,326,474,371,567,938,110,91,58,160,194,1046,PF
1988,25,13,242,57,101,1,3,56,98,28,39,8,19,27,15,11,2,26,41,143,SF
1988,28,26,204,29,67,6,17,23,50,10,11,6,7,13,32,11,4,22,39,74,SG
1988,26,80,1483,281,517,1,4,280,513,142,182,94,195,289,103,38,83,116,272,705,PF
1988,29,77,2004,402,924,0,2,402,922,172,225,131,358,489,113,50,106,164,195,976,C
1988,29,14,408,79,209,0,1,79,208,59,74,21,72,93,19,13,25,43,46,217,C
1988,29,63,1596,323,715,0,1,323,714,113,151,110,286,396,94,37,81,121,149,759,C
1988,30,82,1676,287,528,0,0,287,528,340,426,127,257,384,85,43,43,135,234,914,C
1988,24,70,1610,296,585,0,2,296,583,154,235,180,217,397,63,33,9,101,172,746,PF
1988,28,82,2680,611,1364,33,109,578,1255,419,519,135,355,490,212,87,53,209,297,1674,PF
1988,31,79,2871,428,865,3,22,425,843,227,275,59,194,253,635,167,22,160,116,1086,PG
1988,26,70,1498,226,453,0,3,226,450,141,185,116,234,350,62,43,41,127,230,593,PF
1988,26,27,657,116,240,0,2,116,238,65,84,58,115,173,39,28,16,72,110,297,PF
1988,26,43,841,110,213,0,1,110,212,76,101,58,119,177,23,15,25,55,120,296,PF
1988,26,29,431,66,191,1,2,65,189,20,36,36,45,81,13,11,6,16,51,153,SF
1988,25,68,1513,203,441,3,10,200,431,75,95,58,115,173,261,62,14,88,132,484,PG
1988,25,12,152,15,40,0,0,15,40,7,9,7,11,18,26,6,0,11,20,37,PG
1988,25,56,1361,188,401,3,10,185,391,68,86,51,104,155,235,56,14,77,112,447,PG
1988,23,75,1122,156,363,0,1,156,362,106,150,54,164,218,65,36,70,116,175,418,PF
1988,28,52,399,50,108,0,7,50,101,32,41,20,18,38,59,38,1,33,31,132,PG
1988,31,33,359,14,59,0,1,14,58,23,28,37,69,106,14,9,8,14,64,51,PF
1988,31,61,1793,189,482,57,178,132,304,97,113,50,178,228,289,66,26,101,136,532,SG
1988,31,45,865,118,270,0,1,118,269,50,67,98,172,270,30,12,94,59,145,286,C
1988,25,84,1739,257,525,1,6,256,519,110,138,127,223,350,115,72,18,104,181,625,SF
1988,25,54,1148,158,322,0,3,158,319,77,98,79,141,220,56,42,15,66,128,393,SF
1988,25,30,591,99,203,1,3,98,200,33,40,48,82,130,59,30,3,38,53,232,SF
1988,31,80,2328,344,715,1,9,343,706,115,153,170,357,527,154,36,95,109,149,804,C
1988,22,29,258,34,68,0,0,34,68,19,25,27,37,64,15,5,8,25,42,87,SF
1988,31,62,946,140,307,0,1,140,306,59,80,82,153,235,37,20,10,65,143,339,PF
1988,26,76,2629,675,1392,1,3,674,1389,270,406,184,369,553,181,78,46,170,274,1621,PF
1988,30,69,1128,133,310,0,3,133,307,33,63,97,174,271,63,32,36,58,135,299,PF
1988,23,79,1499,340,742,28,81,312,661,79,101,43,123,166,149,94,22,108,128,787,SG
1988,27,67,1282,328,755,2,12,326,743,243,313,62,92,154,109,69,4,123,128,901,SG
1988,31,69,2144,444,863,0,2,444,861,492,572,84,143,227,171,39,10,135,144,1380,SF
1988,22,79,2957,551,1081,0,2,551,1079,378,528,151,514,665,333,48,56,267,235,1480,C
1988,32,75,1480,208,415,30,74,178,341,91,108,18,84,102,303,51,18,91,149,537,PG
1988,29,21,226,48,115,1,17,47,98,7,10,16,25,41,20,2,4,18,29,104,SF
1988,29,5,39,6,18,0,2,6,16,0,0,1,2,3,3,2,1,5,4,12,SF
1988,29,16,187,42,97,1,15,41,82,7,10,15,23,38,17,0,3,13,25,92,SF
1988,33,68,1951,488,1031,36,96,452,935,205,231,32,127,159,278,86,3,126,131,1217,SF
1988,31,6,33,2,9,0,0,2,9,6,15,2,3,5,2,0,2,7,14,10,C
1988,31,4,26,1,7,0,0,1,7,4,12,2,3,5,1,0,1,4,10,6,C
1988,31,2,7,1,2,0,0,1,2,2,3,0,0,0,1,0,1,3,4,4,C
1988,24,65,2179,405,835,19,61,386,774,198,221,66,138,204,480,88,2,154,95,1027,PG
1988,27,47,655,112,217,0,1,112,216,59,87,30,46,76,71,29,4,44,68,283,SF
1988,30,81,2523,212,380,0,0,212,380,147,189,247,508,755,66,40,104,113,175,571,C
1988,22,44,364,44,109,0,7,44,102,17,21,5,20,25,87,16,1,42,33,105,PG
1988,25,20,74,8,17,0,0,8,17,18,26,3,14,17,5,2,4,11,19,34,C
1988,29,74,2024,328,720,26,90,302,630,83,108,21,98,119,383,65,0,152,114,765,PG
1988,25,81,3060,849,1679,11,52,838,1627,476,587,261,272,533,467,203,52,236,250,2185,SG
1988,23,78,2223,450,907,0,0,450,907,331,430,224,352,576,66,31,32,177,280,1231,C
1988,22,55,513,65,137,0,0,65,137,40,71,74,70,144,23,13,19,31,87,170,C
1988,24,82,2732,453,960,4,19,449,941,251,308,63,137,200,387,87,15,172,155,1161,SG
1988,32,82,1534,70,156,0,1,70,155,40,52,110,130,240,87,101,11,26,152,180,SG
1988,31,82,2731,226,541,0,0,226,541,119,191,230,487,717,55,41,304,131,320,571,C
1988,28,16,414,54,115,0,2,54,113,24,32,4,15,19,92,10,1,47,10,132,PG
1988,32,69,1705,302,643,0,1,302,642,210,321,119,293,412,78,16,37,130,216,814,C
1988,32,43,1377,254,542,0,1,254,541,165,260,97,238,335,73,14,32,108,159,673,C
1988,32,26,328,48,101,0,0,48,101,45,61,22,55,77,5,2,5,22,57,141,C
1988,26,79,1709,226,485,22,64,204,421,89,132,86,188,274,206,82,30,107,182,563,SG
1988,27,75,2790,764,1519,107,259,657,1260,303,395,167,173,340,197,74,11,172,221,1938,SG
1988,28,54,399,36,88,0,0,36,88,31,35,32,66,98,15,9,6,29,73,103,C
1988,34,80,2818,843,1704,0,6,843,1698,314,379,166,207,373,377,70,23,181,193,2000,SF
1988,32,56,656,139,307,36,91,103,216,30,37,9,39,48,81,34,6,43,78,344,PG
1988,25,82,2546,656,1183,0,3,656,1180,341,476,245,431,676,125,104,245,287,332,1653,C
1988,23,30,157,26,69,0,6,26,63,9,10,9,9,18,16,3,1,22,18,61,SG
1988,25,70,1128,182,404,0,4,182,400,94,134,83,252,335,53,15,9,87,146,458,C
1988,25,7,154,16,36,0,0,16,36,20,26,13,16,29,10,5,2,19,17,52,SF
1988,25,80,2733,442,845,0,13,442,832,227,283,106,258,364,568,115,11,175,225,1111,PG
1988,27,77,2514,420,969,14,72,406,897,301,354,77,219,296,544,95,12,223,190,1155,PG
1988,27,18,680,132,301,1,20,131,281,116,139,26,65,91,178,27,2,67,46,381,PG
1988,27,59,1834,288,668,13,52,275,616,185,215,51,154,205,366,68,10,156,144,774,PG
1988,22,78,1597,242,565,0,1,242,564,150,207,95,235,330,111,53,23,109,267,634,PF
1988,34,58,682,143,350,8,35,135,315,80,100,14,30,44,60,20,3,49,74,374,SG
1988,22,9,19,0,3,0,1,0,2,0,0,2,1,3,1,2,0,2,2,0,SF
1988,23,67,2122,340,775,13,39,327,736,138,157,68,159,227,429,116,7,167,188,831,PG
1988,23,55,1807,342,720,0,0,342,720,131,193,134,300,434,72,58,29,123,143,815,PF
1988,38,71,893,99,181,0,0,99,181,67,128,69,142,211,21,15,30,67,148,265,C
1988,38,24,372,41,80,0,0,41,80,19,37,15,48,63,9,5,12,28,54,101,C
1988,38,47,521,58,101,0,0,58,101,48,91,54,94,148,12,10,18,39,94,164,C
1988,28,81,2961,505,1126,0,2,505,1124,355,392,245,569,814,139,64,118,177,176,1365,C
1988,28,34,1194,215,474,0,2,215,472,143,166,82,238,320,55,28,33,83,78,573,C
1988,28,47,1767,290,652,0,0,290,652,212,226,163,331,494,84,36,85,94,98,792,C
1988,25,8,65,11,31,0,0,11,31,6,6,2,2,4,7,1,2,4,8,28,SG
1988,22,81,1827,254,507,0,2,254,505,114,182,155,292,447,89,51,53,86,221,622,PF
1988,24,74,807,90,193,0,1,90,192,44,73,70,180,250,44,11,32,50,152,224,C
1988,24,82,2636,322,640,0,2,322,638,293,379,245,465,710,93,87,45,120,204,937,PF
1988,33,81,1116,157,370,4,19,153,351,75,83,14,66,80,300,57,1,94,83,393,PG
1988,27,82,2049,258,585,0,2,258,583,126,190,221,421,642,93,65,32,148,318,642,PF
1988,30,45,1236,151,328,0,2,151,326,83,111,92,208,300,97,33,22,74,134,385,PF
1988,29,23,313,61,134,0,1,61,133,12,36,37,58,95,16,9,13,22,37,134,PF
1988,29,52,1052,251,585,28,102,223,483,59,92,36,91,127,91,52,5,67,102,589,SG
1988,29,69,1017,139,280,0,1,139,279,117,145,93,230,323,86,18,61,103,197,395,C
1988,27,81,1796,316,611,32,97,284,514,113,152,64,123,187,175,65,5,91,193,777,SG
1988,30,77,1334,109,287,3,16,106,271,129,163,39,132,171,166,64,17,95,185,350,SF
1988,26,82,3032,536,1167,60,192,476,975,261,344,71,175,246,634,168,35,190,164,1393,PG
1988,24,57,1830,340,732,3,20,337,712,196,278,64,159,223,281,122,52,158,157,879,SG
1988,24,58,1084,223,487,0,7,223,480,89,113,53,73,126,87,50,8,56,89,535,SG
1988,24,14,199,34,86,0,1,34,85,15,16,12,9,21,17,8,2,6,15,83,SG
1988,24,44,885,189,401,0,6,189,395,74,97,41,64,105,70,42,6,50,74,452,SG
1988,27,55,403,40,82,5,12,35,70,25,27,27,70,97,16,8,10,14,67,110,PF
1988,23,22,351,47,116,0,1,47,115,32,47,11,24,35,34,12,5,40,41,126,SG
1988,32,75,1505,194,453,69,163,125,290,138,170,27,80,107,231,69,5,133,187,595,PG
1988,32,6,69,5,14,2,4,3,10,2,2,1,9,10,13,2,0,8,14,14,PG
1988,32,69,1436,189,439,67,159,122,280,136,168,26,71,97,218,67,5,125,173,581,PG
1988,23,17,190,21,53,0,1,21,52,15,26,9,12,21,23,8,0,17,26,57,SG
1988,23,12,170,19,48,0,1,19,47,10,14,6,11,17,21,8,0,15,24,48,SG
1988,23,5,20,2,5,0,0,2,5,5,12,3,1,4,2,0,0,2,2,9,SG
1988,24,39,433,62,150,20,45,42,105,39,47,13,36,49,67,12,5,39,37,183,SG
1988,24,10,81,11,28,3,8,8,20,9,10,2,8,10,12,1,1,9,11,34,SG
1988,24,14,145,13,41,2,6,11,35,4,7,5,14,19,29,4,1,14,11,32,SG
1988,24,15,207,38,81,15,31,23,50,26,30,6,14,20,26,7,3,16,15,117,SG
1988,28,68,2188,381,725,19,39,362,686,273,322,94,199,293,188,70,31,111,188,1054,SF
1988,26,77,2592,453,930,0,2,453,928,272,351,159,358,517,99,69,140,169,275,1178,SF
1988,26,29,845,123,272,0,1,123,271,89,124,53,116,169,27,24,68,63,90,335,SF
1988,26,48,1747,330,658,0,1,330,657,183,227,106,242,348,72,45,72,106,185,843,SF
1988,27,66,1445,242,523,86,175,156,348,59,71,19,59,78,153,46,2,77,118,629,SG
1988,27,43,983,155,345,55,118,100,227,32,39,12,34,46,109,30,0,49,80,397,SG
1988,27,23,462,87,178,31,57,56,121,27,32,7,25,32,44,16,2,28,38,232,SG
1988,26,82,1279,163,353,3,15,160,338,107,129,50,99,149,211,41,10,86,154,436,PG
1988,23,39,642,84,183,0,1,84,182,54,62,58,116,174,32,13,6,37,87,222,C
1988,23,3,35,4,11,0,0,4,11,3,3,4,3,7,2,0,0,2,3,11,C
1988,23,36,607,80,172,0,1,80,171,51,59,54,113,167,30,13,6,35,84,211,C
1988,22,61,1365,222,549,12,45,210,504,131,177,63,80,143,118,57,25,119,145,587,SG
1988,24,82,2243,306,605,17,58,289,547,152,185,71,191,262,540,107,10,156,151,781,SG
1988,31,78,1631,237,485,0,5,237,480,182,243,117,164,281,81,50,7,118,167,656,SF
1988,27,11,42,5,13,1,6,4,7,6,6,3,1,4,8,0,0,6,5,17,PG
1988,25,68,1809,284,538,3,18,281,520,112,153,49,125,174,395,81,5,127,177,683,PG
1988,25,50,1557,264,484,3,16,261,468,103,139,44,107,151,354,61,4,108,154,634,PG
1988,25,18,252,20,54,0,2,20,52,9,14,5,18,23,41,20,1,19,23,49,PG
1988,31,81,1238,143,308,0,2,143,306,78,99,94,174,268,67,23,25,83,162,364,PF
1988,22,82,3249,438,1013,32,126,406,887,206,266,120,276,396,868,205,6,258,244,1114,PG
1988,23,58,760,64,171,6,25,58,146,23,32,17,42,59,179,20,5,58,81,157,PG
1988,24,70,879,155,298,1,8,154,290,67,91,77,91,168,49,30,26,54,127,378,SF
1988,31,74,723,49,105,0,0,49,105,22,32,66,108,174,17,13,24,29,104,120,C
1988,33,77,2670,352,803,12,46,340,757,255,298,62,178,240,598,93,29,195,204,971,PG
1988,28,73,2177,533,1110,24,94,509,1016,204,240,121,197,318,180,33,9,139,190,1294,SF
1988,29,75,1258,216,498,1,9,215,489,121,149,39,82,121,188,70,4,99,120,554,PG
1988,22,4,12,1,3,0,0,1,3,0,0,0,0,0,0,1,0,2,1,2,SF
1988,21,80,1917,275,596,5,24,270,572,177,211,36,155,191,437,103,24,146,155,732,PG
1988,21,52,1043,143,311,2,9,141,302,92,112,10,62,72,193,60,17,82,96,380,PG
1988,21,28,874,132,285,3,15,129,270,85,99,26,93,119,244,43,7,64,59,352,PG
1988,28,72,2637,490,996,11,56,479,940,417,489,88,361,449,858,114,13,269,147,1408,PG
1988,30,43,1050,258,488,0,1,258,487,146,249,84,158,242,57,17,32,122,151,662,C
1988,31,82,1935,425,959,5,24,420,935,147,217,90,141,231,267,58,18,152,164,1002,SG
1988,37,79,1778,128,263,0,4,128,259,78,106,105,303,408,81,29,99,82,251,334,C
1988,30,69,1313,72,177,0,1,72,176,53,75,106,219,325,59,53,113,57,226,197,PF
1988,26,37,186,16,40,0,1,16,39,19,33,11,20,31,8,3,6,12,28,51,PF
1988,24,82,3311,1069,1998,7,53,1062,1945,723,860,139,310,449,485,259,131,252,270,2868,SG
1988,25,79,2888,611,1225,3,15,608,1210,291,396,211,446,657,243,127,65,161,302,1516,SF
1988,28,72,1593,211,540,17,49,194,491,78,103,71,145,216,109,39,18,93,219,517,SF
1988,31,69,2044,470,938,1,6,469,932,247,324,86,194,280,192,49,10,211,202,1188,SF
1988,26,53,1063,92,205,0,1,92,204,40,79,85,179,264,47,19,58,73,153,224,C
1988,26,13,86,9,23,0,0,9,23,1,6,10,14,24,2,3,8,9,16,19,C
1988,26,40,977,83,182,0,1,83,181,39,73,75,165,240,45,16,50,64,137,205,C
1988,26,82,1999,324,686,0,0,324,686,153,188,179,400,579,93,28,59,107,228,801,C
1988,23,36,225,18,48,2,7,16,41,8,13,4,11,15,23,6,1,18,42,46,SG
1988,24,49,1073,98,203,0,2,98,201,83,136,103,230,333,19,36,56,53,161,279,C
1988,23,50,1050,128,266,0,3,128,263,103,127,88,143,231,50,18,8,57,137,359,PF
1988,30,82,2897,455,923,13,39,442,884,187,214,165,667,832,199,66,78,136,284,1110,C
1988,30,80,2150,291,666,19,88,272,578,218,251,22,126,148,405,124,9,130,162,819,SG
1988,27,82,3061,643,1360,12,57,631,1303,248,316,203,462,665,639,223,21,182,214,1546,SG
1988,27,82,2135,314,564,1,2,313,562,190,246,228,276,504,71,52,84,94,287,819,PF
1988,24,50,310,27,87,0,1,27,86,29,48,17,34,51,14,13,4,19,36,83,SG
1988,22,49,405,90,193,0,4,90,189,40,57,28,35,63,26,16,15,30,54,220,SG
1988,29,82,1812,173,343,1,2,172,341,114,188,200,427,627,58,27,140,90,319,461,C
1988,23,70,718,122,246,3,13,119,233,50,62,46,92,138,49,20,41,59,123,297,PF
1988,31,81,2022,417,879,34,77,383,802,166,183,72,157,229,173,84,11,127,164,1034,SG
1988,34,81,1766,281,631,51,151,230,480,130,162,29,130,159,392,88,3,125,102,743,PG
1988,35,73,1191,168,373,0,3,168,370,109,148,101,214,315,94,33,10,73,188,445,PF
1988,29,67,1963,276,481,1,2,275,479,164,217,159,406,565,60,43,42,119,262,717,PF
1988,26,80,2655,648,1360,10,24,638,1336,335,380,44,162,206,237,51,13,172,198,1641,SG
1988,24,82,3198,858,1650,0,5,858,1645,552,789,277,709,986,199,117,50,325,296,2268,PF
1988,32,79,2692,531,1090,2,7,529,1083,543,689,372,512,884,112,59,72,249,160,1607,C
1988,27,35,477,48,118,2,12,46,106,25,37,17,34,51,55,13,7,24,53,123,SF
1988,25,10,101,16,51,0,1,16,50,8,13,9,18,27,6,5,0,9,16,40,SF
1988,23,26,136,23,61,1,4,22,57,10,21,13,11,24,14,6,3,10,21,57,SF
1988,28,51,706,114,248,7,30,107,218,54,65,16,50,66,138,25,3,69,65,289,PG
1988,32,71,848,80,171,0,2,80,169,110,143,74,105,179,60,22,12,54,75,270,SF
1988,25,70,2114,348,648,0,2,348,646,145,215,146,321,467,118,32,23,111,234,841,C
1988,25,23,601,71,138,0,0,71,138,37,53,49,95,144,26,14,8,35,75,179,C
1988,25,47,1513,277,510,0,2,277,508,108,162,97,226,323,92,18,15,76,159,662,C
1988,26,81,2689,359,746,0,4,359,742,288,367,232,399,631,264,57,51,144,166,1006,SF
1988,24,78,2703,687,1407,14,50,673,1357,281,393,206,312,518,263,96,52,223,230,1669,SF
1988,25,81,2039,258,552,9,35,249,517,87,111,133,202,335,138,39,8,93,246,612,PF
1988,28,11,117,22,52,5,19,17,33,2,6,4,12,16,13,5,0,7,6,51,SG
1988,28,37,886,201,478,48,141,153,337,74,96,51,61,112,58,47,6,58,75,524,SF
1988,30,64,2390,550,911,0,0,550,911,346,434,159,377,536,171,27,92,141,179,1446,PF
1988,29,31,393,43,109,16,50,27,59,24,25,4,27,31,40,15,2,19,55,126,SG
1988,21,82,1706,255,519,11,30,244,489,173,224,115,213,328,107,70,63,108,237,694,SF
1988,23,82,2453,235,496,9,24,226,472,145,205,117,221,338,702,169,47,189,238,624,PG
1988,28,42,581,52,133,0,0,52,133,48,66,66,91,157,18,4,12,26,67,152,C
1988,26,19,265,23,74,0,0,23,74,21,31,24,40,64,23,16,2,17,50,67,PF
1988,22,82,1840,306,627,61,172,245,455,149,186,95,95,190,132,53,19,101,157,822,SG
1988,27,72,1070,108,221,4,16,104,205,41,55,30,66,96,228,59,3,93,133,261,PG
1988,27,11,202,25,48,1,5,24,43,14,23,8,13,21,38,15,0,16,26,65,PG
1988,27,61,868,83,173,3,11,80,162,27,32,22,53,75,190,44,3,77,107,196,PG
1988,32,68,1501,378,784,3,12,375,772,160,194,54,144,198,68,31,13,52,101,919,SF
1988,31,60,848,100,210,0,4,100,206,51,72,70,151,221,22,27,27,49,194,251,C
1988,30,56,1428,217,444,5,31,212,413,164,196,58,122,180,204,41,14,86,109,603,SG
1988,23,7,34,7,24,0,0,7,24,6,6,5,7,12,5,2,1,3,4,20,PF
1988,23,3,16,2,3,0,0,2,3,0,2,1,1,2,1,0,0,1,2,4,SF
1988,29,5,61,4,10,0,1,4,9,0,0,2,4,6,12,3,0,7,1,8,PG
1988,29,4,51,4,9,0,1,4,8,0,0,1,3,4,11,3,0,4,1,8,PG
1988,29,1,10,0,1,0,0,0,1,0,0,1,1,2,1,0,0,3,0,0,PG
1988,26,14,59,9,29,0,0,9,29,6,8,2,6,8,1,5,0,4,21,24,C
1988,26,9,25,4,13,0,0,4,13,2,4,2,0,2,1,2,0,3,8,10,C
1988,26,5,34,5,16,0,0,5,16,4,4,0,6,6,0,3,0,1,13,14,C
1988,24,60,2033,470,926,34,97,436,829,239,270,58,147,205,290,113,32,156,136,1213,SF
1988,25,9,46,8,23,0,0,8,23,4,5,4,12,16,1,0,0,5,5,20,PF
1988,23,18,89,14,49,1,4,13,45,7,11,5,6,11,6,5,1,8,14,36,SF
1988,24,1,19,1,1,0,0,1,1,3,4,1,1,2,2,1,0,0,2,5,PF
1988,24,22,328,43,95,0,4,43,91,26,39,11,26,37,48,17,6,33,30,112,SG
1988,28,67,2383,487,920,2,6,485,914,304,390,193,414,607,207,63,159,155,242,1280,PF
1988,28,40,1477,327,616,2,5,325,611,187,249,119,275,394,123,45,96,106,152,843,PF
1988,28,27,906,160,304,0,1,160,303,117,141,74,139,213,84,18,63,49,90,437,PF
1988,31,27,533,102,208,0,1,102,207,54,73,35,61,96,47,13,3,30,43,258,PF
1988,27,68,837,50,109,1,2,49,107,41,63,82,140,222,49,29,5,27,94,142,PF
1988,22,44,336,20,52,0,0,20,52,8,18,23,59,82,16,8,12,23,89,48,C
1988,22,35,295,18,49,0,0,18,49,7,14,20,53,73,16,7,11,21,78,43,C
1988,22,9,41,2,3,0,0,2,3,1,4,3,6,9,0,1,1,2,11,5,C
1988,28,17,63,7,21,0,0,7,21,3,6,4,14,18,0,1,5,2,12,17,C
1988,24,77,1589,270,620,26,93,244,527,207,246,87,72,159,62,72,11,103,204,773,SF
1988,29,72,919,128,257,0,1,128,256,60,83,62,91,153,53,22,56,49,141,316,C
1988,23,66,1435,241,500,0,10,241,490,87,170,100,163,263,78,44,34,103,123,569,SF
1988,29,4,52,9,16,0,1,9,15,0,4,1,3,4,2,3,2,0,2,18,SF
1988,24,82,2816,375,776,3,12,372,764,261,359,326,740,1066,248,68,28,241,272,1014,PF
1988,25,79,2825,712,1385,0,4,712,1381,381,548,302,657,959,163,162,214,243,324,1805,C
1988,30,54,946,119,250,0,0,119,250,59,87,82,222,304,33,12,110,62,143,297,C
1988,29,29,180,16,50,0,1,16,49,8,16,13,21,34,9,6,0,14,27,40,SF
1988,34,74,2312,442,750,0,1,442,749,177,241,173,455,628,115,55,84,154,198,1061,C
1988,30,45,801,137,298,5,21,132,277,68,79,15,30,45,76,30,5,39,73,347,SG
1988,30,17,263,43,107,3,8,40,99,14,18,8,10,18,27,7,1,11,29,103,SG
1988,30,28,538,94,191,2,13,92,178,54,61,7,20,27,49,23,4,28,44,244,SG
1988,27,81,1888,287,582,33,95,254,487,33,45,16,88,104,303,49,1,64,154,640,PG
1988,26,75,2499,394,876,5,30,389,846,273,332,201,400,601,118,74,54,119,227,1066,PF
1988,23,79,2807,575,1252,59,177,516,1075,132,197,171,365,536,309,73,8,210,266,1341,SF
1988,25,69,1793,249,488,1,6,248,482,114,153,145,291,436,106,36,40,119,203,613,PF
1988,26,2,23,3,7,0,0,3,7,3,4,0,2,2,3,5,0,2,1,9,SG
1988,28,37,965,248,486,3,14,245,472,107,122,30,53,83,73,21,7,57,94,606,SG
1988,24,79,1177,179,343,0,2,179,341,133,178,94,136,230,66,39,32,77,118,491,PF
1988,22,79,1650,261,564,4,23,257,541,99,172,115,183,298,169,91,52,131,214,625,SF
1988,23,82,1080,118,254,0,2,118,252,101,158,122,208,330,33,32,26,81,215,337,C
1988,24,82,2991,462,890,24,69,438,821,274,324,65,313,378,831,150,16,244,204,1222,PG
1988,29,75,2484,345,702,8,39,337,663,285,357,130,245,375,523,112,34,198,233,983,SG
1988,24,80,2029,318,702,36,110,282,592,103,130,139,230,369,185,84,55,135,211,775,SF
1988,23,80,2626,493,974,72,148,421,826,221,252,54,126,180,480,99,12,184,119,1279,PG
1988,29,70,845,102,186,0,0,102,186,73,93,103,165,268,54,39,13,59,103,277,PF
1988,25,79,1779,435,884,0,0,435,884,132,170,130,307,437,78,22,81,73,241,1002,C
1988,32,62,980,165,356,13,34,152,322,50,63,38,87,125,67,27,5,41,118,393,SG
1988,23,4,42,5,8,0,0,5,8,6,8,2,5,7,1,0,3,4,3,16,SF
1988,25,62,1161,188,419,3,7,185,412,119,154,70,90,160,104,74,32,104,97,498,SF
1988,26,80,2502,403,890,9,33,394,857,319,421,83,283,366,747,140,41,210,272,1134,PG
1988,27,74,1032,161,330,0,6,161,324,128,165,60,102,162,81,16,15,68,118,450,PF
1988,25,82,2978,655,1408,27,95,628,1313,273,365,165,333,498,557,243,69,251,300,1610,SG
1988,27,62,2110,483,1041,2,9,481,1032,210,293,116,289,405,131,79,39,161,192,1178,SF
1988,26,82,2147,398,709,5,17,393,692,152,284,318,397,715,110,75,45,156,273,953,SF
1988,24,24,168,26,61,0,2,26,59,10,13,8,19,27,3,4,3,10,23,62,PF
1988,32,76,1765,133,260,0,0,133,260,70,80,142,317,459,20,31,132,51,229,336,C
1988,24,26,201,30,74,2,11,28,63,22,30,7,21,28,16,12,0,11,37,84,SF
1988,22,4,16,0,6,0,0,0,6,6,6,1,4,5,1,1,0,1,3,6,PF
1988,23,82,2003,258,456,0,0,258,456,185,261,166,236,402,113,53,137,120,294,701,C
1988,27,19,705,119,271,2,6,117,265,63,85,58,114,172,37,17,33,62,63,303,PF
1988,27,29,958,180,411,0,5,180,406,86,111,82,208,290,85,24,55,109,101,446,C
1988,27,59,883,153,303,0,1,153,302,59,76,38,71,109,56,31,9,50,131,365,SF
1988,27,35,466,82,171,0,1,82,170,39,53,28,34,62,30,18,4,27,73,203,SF
1988,27,24,417,71,132,0,0,71,132,20,23,10,37,47,26,13,5,23,58,162,SF
1988,28,81,2166,361,668,0,2,361,666,407,487,200,462,662,106,62,92,155,323,1129,PF
1988,27,81,973,208,454,17,58,191,396,51,63,78,120,198,53,39,13,57,151,484,PF
1988,25,82,1587,246,539,5,32,241,507,201,266,102,177,279,159,42,32,108,189,698,SF
1988,26,81,3048,710,1348,62,179,648,1169,272,317,76,257,333,335,155,27,161,204,1754,SG
1988,25,33,455,55,118,3,8,52,110,27,39,30,54,84,50,49,23,43,81,140,SF
1988,25,29,447,54,116,3,8,51,108,27,39,29,52,81,49,47,22,41,78,138,SF
1988,25,4,8,1,2,0,0,1,2,0,0,1,2,3,1,2,1,2,3,2,SF
1988,25,82,2212,326,714,1,7,325,707,124,157,107,143,250,141,34,66,91,174,777,SF
1988,30,81,1949,474,986,5,21,469,965,206,240,71,151,222,162,58,14,118,197,1159,SG
1988,31,52,694,93,172,10,22,83,150,17,23,9,27,36,93,21,0,22,60,213,PG
1988,31,24,370,44,82,2,8,42,74,8,12,5,16,21,60,14,0,14,30,98,PG
1988,31,28,324,49,90,8,14,41,76,9,11,4,11,15,33,7,0,8,30,115,PG
1988,32,82,2923,514,1058,3,14,511,1044,321,348,195,514,709,279,93,80,157,316,1352,C
1988,23,51,760,86,209,6,20,80,189,45,54,11,55,66,180,22,3,76,97,223,PG
1988,26,35,899,174,364,8,23,166,341,87,113,35,68,103,89,21,17,48,108,443,SG
1988,22,61,2170,331,694,12,39,319,655,167,204,40,98,138,434,92,8,184,140,841,PG
1988,30,20,499,58,123,0,1,58,122,11,27,79,103,182,25,12,11,36,63,127,PF
1988,24,72,1549,325,662,13,41,312,621,178,229,126,121,247,155,91,42,107,160,841,SG
1988,24,15,191,37,93,0,0,37,93,21,28,16,14,30,11,5,6,12,23,95,SG
1988,24,57,1358,288,569,13,41,275,528,157,201,110,107,217,144,86,36,95,137,746,SG
1988,25,48,421,44,103,0,0,44,103,44,66,27,58,85,8,7,42,30,105,132,C
1988,29,58,1044,117,293,2,13,115,280,24,33,15,57,72,167,41,3,58,79,260,PG
1988,29,3,52,5,19,0,1,5,18,0,0,1,1,2,5,4,0,6,7,10,PG
1988,29,55,992,112,274,2,12,110,262,24,33,14,56,70,162,37,3,52,72,250,PG
1988,27,80,2692,411,828,3,15,408,813,254,314,157,505,662,183,90,69,156,302,1079,C
1988,25,82,2842,454,791,24,67,430,724,272,324,54,183,237,1128,242,16,262,247,1204,PG
1988,29,41,271,29,79,0,2,29,77,20,30,24,47,71,20,3,12,24,48,78,PF
1988,26,52,1024,176,379,26,64,150,315,43,48,14,34,48,183,27,2,57,54,421,PG
1988,23,81,2307,444,888,0,5,444,883,205,277,360,599,959,86,103,86,172,313,1093,PF
1988,27,47,958,248,546,1,9,247,537,97,121,41,40,81,61,32,4,80,95,594,SG
1988,30,73,2653,619,1318,16,59,603,1259,320,385,72,160,232,463,59,16,234,173,1574,SG
1988,26,81,2927,621,1341,30,97,591,1244,305,394,64,214,278,678,141,17,273,217,1577,PG
1988,25,37,566,74,159,0,2,74,157,43,60,40,36,76,51,21,1,21,75,191,SF
1988,24,9,38,3,13,0,0,3,13,8,10,2,7,9,1,1,0,6,11,14,SF
1988,26,69,1257,215,456,2,5,213,451,118,164,138,289,427,68,54,73,109,217,550,C
1988,33,80,2007,370,722,0,3,370,719,185,292,198,291,489,66,38,79,113,251,925,C
1988,25,48,593,65,130,0,2,65,128,34,55,46,66,112,15,11,3,35,103,164,PF
1988,25,7,85,6,19,0,0,6,19,5,8,5,8,13,4,2,0,8,23,17,PF
1988,25,41,508,59,111,0,2,59,109,29,47,41,58,99,11,9,3,27,80,147,PF
1988,25,82,3072,622,1226,0,6,622,1220,460,609,279,558,837,266,62,56,228,264,1704,PF
1988,26,71,1055,216,425,3,27,213,398,57,71,23,65,88,160,60,8,63,100,492,PG
1988,26,45,701,132,263,2,20,130,243,32,41,12,43,55,107,27,3,44,71,298,PG
1988,26,26,354,84,162,1,7,83,155,25,30,11,22,33,53,33,5,19,29,194,PG
1988,23,79,2378,511,998,0,2,511,996,246,314,168,323,491,103,54,34,145,274,1268,PF
1988,29,25,259,35,69,0,0,35,69,19,30,23,32,55,10,8,5,21,39,89,PF
1988,29,11,177,19,41,0,0,19,41,9,17,14,21,35,5,5,2,10,25,47,PF
1988,29,14,82,16,28,0,0,16,28,10,13,9,11,20,5,3,3,11,14,42,PF
1988,30,29,522,72,171,9,27,63,144,58,72,8,39,47,108,11,6,50,35,211,SG
1988,25,21,139,21,48,5,14,16,34,10,11,3,5,8,24,9,1,12,20,57,PG
1988,28,49,976,139,303,31,74,108,229,59,68,30,87,117,105,34,4,68,68,368,SF
1988,28,71,1248,193,455,69,167,124,288,51,71,32,87,119,117,53,6,47,158,506,SG
1988,23,12,99,12,34,1,7,11,27,10,14,4,4,8,23,7,1,12,13,35,PG
1988,28,17,98,8,30,0,0,8,30,1,2,8,2,10,9,8,0,10,5,17,SF
1988,27,79,1011,199,389,1,3,198,386,71,98,88,148,236,32,26,68,71,157,470,C
1988,31,74,1185,184,407,1,7,183,400,41,64,87,155,242,56,43,47,43,85,410,SF
1988,28,79,1636,223,533,15,33,208,500,101,136,37,119,156,382,122,8,148,135,562,PG
1988,29,37,1038,283,557,22,58,261,499,159,181,36,73,109,71,21,7,48,68,747,SF
1988,28,73,1755,446,958,1,4,445,954,231,287,80,229,309,143,46,26,137,198,1124,SF
1988,24,72,1501,210,461,8,21,202,440,145,167,35,117,152,381,55,16,136,145,573,PG
1988,24,43,548,72,152,5,13,67,139,46,60,17,32,49,137,21,4,52,63,195,PG
1988,24,29,953,138,309,3,8,135,301,99,107,18,85,103,244,34,12,84,82,378,PG
1988,29,57,772,53,121,0,3,53,118,15,35,45,72,117,36,27,33,25,100,121,SF
1988,22,11,123,3,20,0,2,3,18,2,4,3,12,15,34,7,1,13,13,8,PG
1988,24,40,380,62,147,2,10,60,137,26,29,4,24,28,61,6,4,22,42,152,SG
1988,27,22,114,9,29,0,1,9,28,0,2,9,19,28,1,2,15,6,26,18,C
1988,26,52,940,114,291,0,6,114,285,82,105,43,84,127,100,62,10,69,105,310,SG
1988,23,82,2139,344,728,0,1,344,727,138,178,192,197,389,86,63,59,83,290,826,SF
1988,23,9,91,16,40,0,2,16,38,10,18,9,4,13,3,4,1,11,13,42,SG
1988,22,37,260,36,81,0,0,36,81,18,31,28,47,75,6,5,8,17,29,90,C
1988,22,8,86,14,32,0,0,14,32,5,8,9,11,20,3,1,0,7,10,33,C
1988,22,29,174,22,49,0,0,22,49,13,23,19,36,55,3,4,8,10,19,57,C
1988,23,15,156,18,42,2,4,16,38,16,20,5,17,22,34,12,0,9,23,54,SG
1988,36,6,56,7,14,0,0,7,14,2,2,9,10,19,0,4,4,4,13,16,PF
1988,24,68,1379,245,547,11,49,234,498,132,189,54,64,118,206,91,4,141,163,633,PG
1988,24,82,1347,191,402,1,19,190,383,107,131,16,130,146,337,63,12,131,125,490,PG
1988,24,10,132,18,31,0,0,18,31,12,18,11,13,24,5,5,5,9,25,48,C
1988,24,30,125,25,49,1,2,24,47,12,19,14,25,39,4,5,9,9,33,63,C
1988,27,83,2098,316,573,0,1,316,572,170,285,165,358,523,74,47,147,173,265,802,C
1988,27,54,1183,182,316,0,0,182,316,95,153,83,198,281,50,25,79,91,158,459,C
1988,27,29,915,134,257,0,1,134,256,75,132,82,160,242,24,22,68,82,107,343,C
1988,25,5,24,4,9,0,0,4,9,3,4,0,4,4,2,2,0,4,3,11,PG
1988,28,59,513,62,132,0,0,62,132,25,34,19,21,40,103,36,2,52,37,149,PG
1988,22,17,352,66,124,1,1,65,123,45,57,31,31,62,9,7,3,21,32,178,SF
1988,22,49,581,111,249,0,6,111,243,39,54,12,19,31,59,20,2,47,57,261,PG
1988,22,12,117,17,46,0,1,17,45,9,13,1,2,3,10,1,0,13,14,43,PG
1988,22,35,462,94,203,0,5,94,198,30,41,11,17,28,49,19,2,34,43,218,PG
1988,31,72,1221,174,360,0,0,174,360,59,82,109,212,321,39,32,21,49,209,407,C
1988,28,78,2948,909,1957,38,129,871,1828,541,655,211,291,502,224,103,47,218,162,2397,SF
1988,24,81,2703,591,1324,39,129,552,1195,191,243,106,164,270,326,90,22,212,183,1412,SG
1988,27,70,2637,466,832,1,1,465,831,346,518,298,536,834,109,68,44,189,266,1279,PF
1988,29,75,1966,311,732,0,6,311,726,126,171,116,353,469,98,37,146,119,244,748,C
1988,25,77,2106,316,663,0,1,316,662,211,279,159,347,506,103,61,145,104,203,843,PF
1988,21,82,2428,427,910,5,38,422,872,188,256,127,317,444,232,117,34,145,217,1047,SF
1988,26,80,1084,199,450,1,7,198,443,103,122,61,66,127,96,62,7,68,207,502,SG
1988,23,35,857,152,427,13,58,139,369,48,66,55,63,118,58,29,21,63,108,365,SF
1988,25,75,2091,356,687,0,2,356,685,159,245,235,312,547,28,68,41,138,240,871,PF
1988,23,15,54,7,23,0,0,7,23,5,6,2,9,11,3,0,0,5,7,19,SF
1988,23,24,420,43,110,10,26,33,84,29,40,2,25,27,69,23,3,25,40,125,PG
1988,23,6,47,7,11,1,1,6,10,6,11,1,0,1,6,6,0,4,6,21,PG
1988,23,18,373,36,99,9,25,27,74,23,29,1,25,26,63,17,3,21,34,104,PG
1988,24,61,1419,218,545,10,40,208,505,99,132,44,57,101,119,47,22,104,125,545,SG
1988,23,7,45,3,13,0,1,3,12,1,2,3,4,7,2,1,0,4,9,7,SF
1988,28,82,2412,376,787,0,0,376,787,71,89,39,131,170,302,50,18,82,117,823,SG
1988,23,42,1137,136,334,3,15,133,319,45,54,51,136,187,98,38,16,76,139,320,C
1988,25,52,909,136,312,52,127,84,185,76,99,17,40,57,174,26,1,39,50,400,PG
1988,25,38,830,120,282,43,108,77,174,69,91,16,35,51,155,22,1,34,44,352,PG
1988,25,14,79,16,30,9,19,7,11,7,8,1,5,6,19,4,0,5,6,48,PG
1988,29,80,2534,562,1263,18,78,544,1185,296,341,64,126,190,273,109,26,186,210,1438,SG
1988,28,19,622,110,247,0,2,110,245,92,130,31,60,91,71,13,20,48,73,312,SF
1988,26,75,2655,617,1161,2,16,615,1145,242,304,129,245,374,289,72,55,155,175,1478,SF
1988,25,2,7,1,5,0,0,1,5,0,0,0,1,1,0,0,0,2,3,2,PF
1988,25,77,949,89,218,22,77,67,141,43,53,18,57,75,218,52,2,37,69,243,PG
1988,23,8,58,15,27,0,0,15,27,0,2,4,9,13,3,3,1,4,12,30,C
1989,41,74,1695,313,659,0,3,313,656,122,165,103,231,334,74,38,85,95,196,748,C
1989,26,62,632,55,114,1,1,54,113,26,48,59,87,146,19,19,6,23,94,137,C
1989,26,77,2787,468,1082,166,466,302,616,322,393,71,212,283,490,166,11,180,149,1424,PG
1989,29,80,2597,586,1270,51,174,535,1096,288,393,146,240,386,278,45,36,208,229,1511,SF
1989,29,44,1529,373,829,29,99,344,730,178,244,90,145,235,189,29,29,140,128,953,SF
1989,29,36,1068,213,441,22,75,191,366,110,149,56,95,151,89,16,7,68,101,558,SF
1989,29,73,2377,480,1051,116,305,364,746,205,240,71,184,255,402,93,8,145,186,1281,PG
1989,29,45,1349,271,589,58,155,213,434,114,128,37,117,154,215,52,1,82,108,714,PG
1989,29,28,1028,209,462,58,150,151,312,91,112,34,67,101,187,41,7,63,78,567,PG
1989,25,74,1141,206,431,13,38,193,393,73,87,103,152,255,63,25,22,62,160,498,PF
1989,24,66,906,148,324,20,55,128,269,50,61,10,62,72,92,45,3,45,57,366,PG
1989,24,9,38,3,11,0,2,3,9,1,2,0,3,3,9,1,0,1,3,7,PG
1989,24,57,868,145,313,20,53,125,260,49,59,10,59,69,83,44,3,44,54,359,PG
1989,24,7,43,8,19,0,1,8,18,1,2,3,4,7,0,1,1,2,7,17,SG
1989,24,82,2401,460,914,0,3,460,911,207,403,255,421,676,61,102,103,180,221,1127,PF
1989,22,36,730,73,175,1,7,72,168,57,82,44,45,89,153,44,3,84,64,204,PG
1989,28,72,1082,145,348,49,141,96,207,32,38,62,169,231,98,44,12,54,100,371,PF
1989,30,82,2618,566,1152,2,11,564,1141,196,229,167,239,406,139,71,23,126,166,1330,SF
1989,22,81,2738,640,1285,4,21,636,1264,224,289,152,265,417,372,150,62,261,295,1508,SF
1989,28,68,1642,200,481,11,54,189,427,89,123,36,108,144,391,72,5,159,117,500,PG
1989,27,82,2777,615,1272,2,5,613,1267,363,440,115,332,447,138,48,91,208,185,1595,SF
1989,34,2,15,1,8,0,1,1,7,4,4,2,5,7,0,0,0,0,3,6,SF
1989,28,9,130,22,36,0,1,22,35,30,53,6,27,33,3,7,2,8,17,74,PF
1989,25,79,3088,700,1208,35,162,665,1046,602,799,403,583,986,325,126,67,254,262,2037,PF
1989,26,82,1672,287,628,11,34,276,594,194,238,30,110,140,197,42,9,104,125,779,SG
1989,24,79,2585,491,907,0,2,491,905,317,426,164,532,696,157,57,221,237,221,1299,C
1989,24,64,1406,255,567,65,160,190,407,131,166,57,140,197,80,37,22,82,197,706,SG
1989,24,69,1355,254,501,1,2,253,499,100,143,86,181,267,77,29,48,89,183,609,PF
1989,24,29,556,108,231,0,0,108,231,43,63,32,83,115,20,10,13,40,69,259,PF
1989,24,40,799,146,270,1,2,145,268,57,80,54,98,152,57,19,35,49,114,350,PF
1989,32,6,189,49,104,0,0,49,104,18,19,1,36,37,29,6,5,11,18,116,SF
1989,33,13,108,18,36,1,3,17,33,0,2,4,9,13,9,3,1,12,10,37,SG
1989,26,37,208,24,52,0,0,24,52,20,25,11,33,44,12,3,13,14,36,68,C
1989,29,78,2946,594,1249,30,85,564,1164,316,370,70,203,273,288,65,20,165,137,1534,SG
1989,24,79,1755,178,418,1,13,177,405,66,88,53,112,165,620,111,7,124,141,423,PG
1989,26,80,1769,127,344,20,91,107,253,40,66,116,346,462,27,11,345,79,226,314,C
1989,25,18,438,72,144,1,5,71,139,10,15,25,31,56,29,18,4,22,43,155,SG
1989,27,20,412,69,153,5,7,64,146,28,49,36,70,106,36,7,33,33,43,171,C
1989,31,38,267,28,86,8,31,20,55,8,16,7,25,32,24,16,2,14,41,72,SG
1989,25,67,811,202,436,7,31,195,405,87,120,63,69,132,60,45,3,64,99,498,SF
1989,28,48,513,86,179,0,0,86,179,28,51,51,84,135,22,9,37,29,59,200,C
1989,29,64,1822,337,654,0,2,337,652,201,281,148,258,406,131,102,35,165,252,875,C
1989,23,82,1372,156,371,55,153,101,218,61,69,19,75,94,306,69,3,65,116,428,PG
1989,25,66,1051,104,248,0,0,104,248,92,130,92,166,258,41,25,17,77,133,300,C
1989,28,14,91,14,45,2,9,12,36,6,8,7,8,15,5,3,0,7,14,36,SG
1989,28,29,274,36,73,2,7,34,66,18,23,15,14,29,21,12,4,10,28,92,SF
1989,23,56,803,120,247,0,0,120,247,40,69,65,114,179,33,20,7,41,144,280,PF
1989,22,33,140,20,48,0,3,20,45,16,20,9,19,28,2,1,2,17,28,56,C
1989,27,80,2536,314,630,0,4,314,626,197,265,276,489,765,126,92,52,124,184,825,PF
1989,26,63,787,158,345,2,21,156,324,70,83,53,77,130,47,37,6,62,108,388,SF
1989,27,78,1488,226,471,0,1,226,470,130,152,106,168,274,91,31,62,82,221,582,PF
1989,30,64,1996,363,810,0,0,363,810,176,220,118,355,473,105,71,81,143,193,902,C
1989,31,78,2333,365,768,0,0,365,768,236,308,152,369,521,90,21,41,190,234,966,C
1989,25,79,2077,334,681,1,5,333,676,153,254,230,342,572,75,46,25,120,250,822,PF
1989,29,5,16,2,3,0,0,2,3,2,5,0,2,2,0,0,2,2,2,6,C
1989,29,81,3002,774,1643,28,86,746,1557,509,598,143,541,684,231,87,55,231,271,2085,PF
1989,24,2,4,0,3,0,1,0,2,0,0,0,0,0,0,0,0,1,2,0,SF
1989,21,75,2219,526,1271,60,191,466,1080,155,195,74,113,187,176,70,25,113,167,1267,SG
1989,32,71,2298,336,696,1,13,335,683,151,195,39,144,183,554,105,17,116,114,824,PG
1989,21,81,1539,277,634,5,24,272,610,191,244,114,142,256,77,48,11,136,161,750,SF
1989,27,58,703,117,241,0,0,117,241,61,77,49,128,177,17,10,18,48,120,295,PF
1989,26,80,1425,203,457,3,25,200,432,125,167,62,120,182,225,69,14,64,158,534,PG
1989,24,67,1119,166,341,0,2,166,339,106,161,112,122,234,30,42,63,85,160,438,PF
1989,29,82,2532,309,676,13,37,296,639,212,269,100,255,355,604,181,5,181,132,843,PG
1989,30,66,1143,218,478,8,41,210,437,63,78,34,73,107,127,71,10,88,121,507,SG
1989,30,36,757,147,315,6,31,141,284,46,56,21,38,59,84,43,4,62,77,346,SG
1989,30,30,386,71,163,2,10,69,153,17,22,13,35,48,43,28,6,26,44,161,SG
1989,32,80,1943,213,494,80,210,133,284,81,93,33,158,191,314,72,32,94,186,587,SG
1989,32,79,1864,220,444,1,4,219,440,79,106,212,407,619,78,36,211,73,302,520,C
1989,26,77,1655,245,454,0,2,245,452,141,179,176,222,398,118,82,13,92,222,631,SF
1989,32,81,1483,203,440,2,8,201,432,71,96,92,223,315,103,29,45,93,134,479,C
1989,23,2,6,0,3,0,0,0,3,0,0,1,0,1,0,0,0,1,1,0,SF
1989,32,53,1096,197,394,0,2,197,392,72,97,84,197,281,47,29,18,111,160,466,PF
1989,27,80,2824,730,1563,7,15,723,1548,362,460,281,369,650,198,106,72,201,265,1829,SF
1989,31,82,2047,233,465,0,1,233,464,66,123,188,300,488,130,50,61,114,230,532,C
1989,24,48,813,256,521,19,55,237,466,40,46,26,78,104,50,42,4,44,68,571,SG
1989,28,69,1722,448,964,1,9,447,955,217,286,69,135,204,154,90,6,122,152,1114,SG
1989,32,73,2422,470,954,0,1,470,953,460,568,117,200,317,171,43,13,163,186,1400,SF
1989,32,42,1341,258,495,0,0,258,495,256,305,53,111,164,93,23,6,81,99,772,SF
1989,32,31,1081,212,459,0,1,212,458,204,263,64,89,153,78,20,7,82,87,628,SF
1989,23,78,2821,544,1012,1,3,543,1009,386,524,167,551,718,285,63,40,230,175,1475,C
1989,33,78,1395,183,379,32,102,151,277,99,123,14,94,108,242,48,18,92,151,497,PG
1989,30,49,545,81,190,4,15,77,175,19,26,47,67,114,31,11,5,22,58,185,SF
1989,25,33,258,49,102,1,10,48,92,28,34,16,21,37,14,13,5,12,39,127,SF
1989,25,2,7,1,5,0,1,1,4,2,2,1,0,1,0,0,0,0,1,4,SF
1989,25,31,251,48,97,1,9,47,88,26,32,15,21,36,14,13,5,12,38,123,SF
1989,34,81,1857,536,1076,20,69,516,1007,175,199,41,110,151,190,72,5,132,187,1267,SG
1989,32,14,48,9,19,0,0,9,19,9,18,3,4,7,1,0,1,4,13,27,C
1989,25,32,1083,177,400,0,4,177,396,100,112,32,69,101,224,55,0,111,64,454,PG
1989,22,80,1556,239,503,6,20,233,483,85,100,48,123,171,206,65,14,77,160,569,SG
1989,23,31,74,14,42,0,4,14,38,8,10,8,15,23,5,1,0,7,15,36,SF
1989,31,53,1746,193,337,0,0,193,337,95,124,158,412,570,38,24,81,83,111,481,C
1989,26,53,396,43,77,0,0,43,77,43,64,39,53,92,18,5,11,39,100,129,C
1989,26,78,3064,829,1672,27,104,802,1568,438,548,289,326,615,450,213,54,250,269,2123,SG
1989,24,79,2662,554,1161,0,2,554,1159,324,428,246,389,635,60,56,49,200,300,1432,C
1989,23,61,544,73,168,0,1,73,167,39,107,72,85,157,21,9,23,44,82,185,C
1989,25,69,2408,456,903,14,29,442,874,260,306,57,115,172,390,63,5,178,103,1186,SG
1989,33,34,321,12,35,0,0,12,35,9,12,30,30,60,25,12,1,6,35,33,SG
1989,22,80,1459,318,732,9,40,309,692,272,346,100,80,180,123,41,5,128,156,917,SG
1989,32,82,2914,188,407,0,0,188,407,132,200,227,616,843,83,40,315,142,290,508,C
1989,33,76,1254,211,422,0,2,211,420,133,194,68,163,231,49,11,31,72,226,555,C
1989,23,79,2349,470,1105,10,37,460,1068,144,193,85,177,262,349,139,27,246,154,1094,SG
1989,27,82,1867,249,524,39,100,210,424,71,117,100,195,295,266,110,19,116,161,608,SG
1989,28,82,3190,857,1710,162,339,695,1371,377,462,156,186,342,164,108,22,218,197,2253,SG
1989,22,11,50,11,29,0,0,11,29,6,10,5,11,16,7,1,0,3,12,28,PF
1989,35,82,2990,924,1881,2,8,922,1873,325,379,148,178,326,383,66,12,198,174,2175,SF
1989,26,80,2896,727,1282,0,6,727,1276,361,484,213,527,740,188,117,281,266,311,1815,C
1989,24,37,412,57,142,9,20,48,122,29,41,22,33,55,28,9,0,26,41,152,SG
1989,26,57,828,116,266,0,1,116,265,54,65,69,133,202,36,17,18,65,136,286,C
1989,24,12,34,1,18,0,0,1,18,7,8,4,9,13,1,0,1,6,7,9,C
1989,23,41,231,35,83,0,0,35,83,30,44,19,22,41,10,7,6,12,33,100,SF
1989,26,76,2552,419,814,3,23,416,791,243,304,85,225,310,494,77,12,192,212,1084,PG
1989,28,82,2788,396,893,109,292,287,601,261,309,48,258,306,709,124,11,253,196,1162,PG
1989,23,32,245,34,91,0,1,34,90,39,51,26,35,61,15,14,6,29,59,107,PF
1989,24,46,313,63,125,2,5,61,120,24,34,26,26,52,20,14,6,34,59,152,SF
1989,23,32,337,27,64,1,5,26,59,12,16,3,16,19,67,15,1,20,27,67,SG
1989,23,44,375,75,136,2,11,73,125,35,55,11,31,42,34,14,3,19,40,187,SF
1989,24,79,2661,466,1074,10,43,456,1031,203,251,101,227,328,505,175,14,187,216,1145,PG
1989,22,71,1499,176,359,0,13,176,346,102,127,37,119,156,243,78,9,116,141,454,SG
1989,24,2,9,0,1,0,0,0,1,1,2,0,1,1,0,0,0,0,2,1,PF
1989,23,24,84,6,19,0,0,6,19,13,23,7,16,23,2,2,4,5,29,25,C
1989,24,74,2120,468,930,0,0,468,930,240,323,165,376,541,52,54,27,140,176,1176,PF
1989,29,82,2739,556,1166,0,6,556,1160,297,341,213,556,769,138,46,106,129,142,1409,C
1989,26,27,244,38,95,3,11,35,84,26,40,15,21,36,34,13,1,17,36,105,SG
1989,23,7,22,3,10,0,0,3,10,2,4,8,3,11,0,0,0,2,6,8,PF
1989,24,72,528,59,142,0,10,59,132,59,80,47,45,92,42,18,3,36,71,177,PF
1989,23,71,1924,361,830,5,22,356,808,119,162,80,158,238,506,144,9,258,170,846,PG
1989,23,71,1193,181,390,0,1,181,389,34,57,75,88,163,79,35,29,28,147,396,PF
1989,23,79,2809,405,781,0,5,405,776,140,199,240,441,681,168,86,62,128,251,950,PF
1989,25,72,783,72,153,0,1,72,152,44,64,84,161,245,29,11,21,48,128,188,C
1989,21,55,1220,167,398,1,4,166,394,105,156,117,169,286,117,36,25,102,144,440,SF
1989,23,11,200,32,73,0,2,32,71,17,20,14,21,35,22,10,1,19,15,81,SG
1989,25,82,2510,401,758,4,17,397,741,282,359,258,481,739,103,94,55,119,172,1088,PF
1989,34,63,871,129,264,3,11,126,253,30,33,11,58,69,187,40,2,61,35,291,PG
1989,34,33,370,57,132,1,5,56,127,13,14,4,19,23,82,18,0,28,16,128,PG
1989,34,30,501,72,132,2,6,70,126,17,19,7,39,46,105,22,2,33,19,163,PG
1989,28,82,1277,194,422,0,3,194,419,129,170,157,237,394,76,47,18,125,172,517,PF
1989,31,67,1403,167,395,0,0,167,395,132,176,140,262,402,96,47,52,91,201,466,PF
1989,31,38,912,105,247,0,0,105,247,84,105,92,146,238,55,30,24,55,123,294,PF
1989,31,29,491,62,148,0,0,62,148,48,71,48,116,164,41,17,28,36,78,172,PF
1989,30,82,2382,466,1045,61,196,405,849,142,182,77,253,330,130,86,22,141,175,1135,SG
1989,30,5,70,9,25,0,0,9,25,3,4,5,11,16,5,1,1,8,15,21,C
1989,25,51,289,37,78,0,0,37,78,36,46,21,50,71,10,11,0,26,56,110,PF
1989,28,46,964,140,300,19,54,121,246,42,75,29,99,128,50,37,6,43,105,341,SG
1989,31,41,701,66,151,1,5,65,146,68,87,18,75,93,86,25,5,53,82,201,PF
1989,27,81,2968,538,1127,99,278,439,849,229,284,46,182,228,570,172,41,205,219,1404,PG
1989,25,82,2851,587,1149,29,116,558,1033,323,430,122,287,409,434,185,74,230,224,1526,SG
1989,25,3,7,1,4,0,0,1,4,2,2,0,2,2,0,1,0,0,1,4,SG
1989,28,75,1206,143,328,9,28,134,300,91,107,72,159,231,59,32,42,68,203,386,C
1989,22,79,2577,442,971,71,166,371,805,241,290,51,174,225,239,120,37,158,184,1196,SG
1989,33,65,986,144,348,33,107,111,241,104,127,17,51,68,140,42,3,73,121,425,PG
1989,29,81,1887,301,633,66,168,235,465,188,229,111,265,376,160,39,42,76,172,856,PF
1989,27,82,2542,495,1027,0,2,495,1025,318,420,152,370,522,71,34,121,165,298,1308,SF
1989,28,59,1204,203,430,75,180,128,250,48,57,23,66,89,146,43,4,57,90,529,SG
1989,28,10,92,16,36,4,12,12,24,3,4,2,3,5,8,2,0,5,8,39,SG
1989,28,49,1112,187,394,71,168,116,226,45,53,21,63,84,138,41,4,52,82,490,SG
1989,27,67,1696,215,504,3,14,212,490,120,143,30,75,105,424,66,12,119,165,553,PG
1989,24,77,1419,199,353,1,2,198,351,101,139,123,261,384,57,25,21,77,239,500,C
1989,23,62,1551,299,714,4,27,295,687,186,219,91,111,202,103,70,30,102,150,788,SG
1989,23,25,112,15,46,0,0,15,46,12,19,9,13,22,3,1,7,15,14,42,C
1989,25,78,2487,440,889,27,81,413,808,147,178,75,191,266,465,129,8,111,188,1054,SG
1989,32,31,191,28,63,0,0,28,63,17,25,14,26,40,11,6,0,9,20,73,SF
1989,28,26,224,28,64,7,22,21,42,7,12,6,13,19,35,17,2,11,30,70,PG
1989,26,73,2220,345,714,25,94,320,620,129,158,70,119,189,405,142,5,160,187,844,PG
1989,32,77,796,72,163,0,1,72,162,36,44,41,91,132,32,11,13,52,99,180,PF
1989,23,72,2477,479,1025,81,240,398,785,180,258,106,235,341,619,139,7,226,163,1219,PG
1989,24,14,70,9,24,2,6,7,18,1,2,1,3,4,11,3,0,4,12,21,PG
1989,23,43,291,29,83,1,9,28,74,9,16,11,13,24,73,21,3,18,34,68,PG
1989,25,67,1850,270,515,1,9,269,506,101,134,114,172,286,126,64,35,110,213,642,SF
1989,34,72,2309,277,638,7,50,270,588,160,195,31,159,190,472,94,21,175,211,721,PG
1989,29,70,2043,608,1224,71,172,537,1052,217,250,91,215,306,162,47,7,122,198,1504,SF
1989,30,67,879,109,246,1,6,108,240,75,93,22,57,79,181,42,0,102,91,294,PG
1989,22,81,3179,570,1128,2,22,568,1106,508,576,46,294,340,991,135,24,322,226,1650,PG
1989,29,77,2886,579,1137,59,188,520,949,513,563,111,496,607,988,138,22,312,172,1730,PG
1989,31,72,1477,296,565,0,0,296,565,129,245,135,223,358,105,20,44,140,254,721,C
1989,32,82,2073,462,996,13,44,449,952,193,263,109,146,255,242,74,17,105,155,1130,SG
1989,26,33,196,29,79,4,16,25,63,14,16,14,14,28,17,11,3,5,20,76,SG
1989,26,8,65,5,15,0,1,5,14,2,2,4,4,8,4,2,1,1,7,12,SG
1989,26,25,131,24,64,4,15,20,49,12,14,10,10,20,13,9,2,4,13,64,SG
1989,22,37,307,50,102,0,1,50,101,29,43,20,27,47,20,17,6,18,38,129,PF
1989,38,72,1279,77,183,0,1,77,182,48,61,88,212,300,59,24,85,83,166,202,PF
1989,31,53,1154,60,125,0,1,60,124,16,25,77,180,257,42,39,76,39,187,136,C
1989,27,43,516,38,82,1,3,37,79,33,53,54,86,140,18,18,16,22,49,110,PF
1989,22,51,682,93,209,0,1,93,208,58,80,32,81,113,42,21,15,47,58,244,SF
1989,22,7,92,9,25,0,0,9,25,8,13,6,10,16,7,2,2,7,8,26,SF
1989,22,2,13,3,5,0,0,3,5,0,0,2,0,2,2,3,0,1,0,6,SF
1989,22,42,577,81,179,0,1,81,178,50,67,24,71,95,33,16,13,39,50,212,SF
1989,25,81,3255,966,1795,27,98,939,1697,674,793,149,503,652,650,234,65,290,247,2633,SG
1989,25,79,1341,171,335,0,1,171,334,142,207,91,213,304,102,41,14,121,215,484,PF
1989,23,26,157,20,46,8,17,12,29,6,9,3,14,17,24,7,0,6,12,54,PG
1989,26,76,2716,533,1137,6,21,527,1116,258,372,246,383,629,243,137,84,167,277,1330,SF
1989,22,42,331,74,172,1,10,73,162,20,29,23,33,56,19,12,6,21,51,169,SF
1989,29,46,791,141,327,8,32,133,295,37,48,33,107,140,79,27,7,74,97,327,SF
1989,32,81,2559,654,1371,5,30,649,1341,361,441,133,251,384,294,64,13,227,219,1674,SF
1989,27,70,942,65,151,0,0,65,151,20,41,81,162,243,36,27,54,58,161,150,C
1989,27,58,729,49,121,0,0,49,121,14,31,66,124,190,29,23,46,46,118,112,C
1989,27,12,213,16,30,0,0,16,30,6,10,15,38,53,7,4,8,12,43,38,C
1989,27,75,1411,175,432,0,2,175,430,134,152,124,254,378,67,33,23,104,192,484,C
1989,27,47,913,116,303,0,1,116,302,81,88,75,166,241,35,18,18,67,126,313,C
1989,27,28,498,59,129,0,1,59,128,53,64,49,88,137,32,15,5,37,66,171,C
1989,24,19,176,12,33,0,1,12,32,6,11,4,7,11,20,9,0,13,22,30,SG
1989,25,74,1531,141,269,0,3,141,266,63,114,147,306,453,56,54,98,60,238,345,C
1989,24,80,2472,362,766,4,12,358,754,289,351,198,412,610,107,93,9,147,219,1017,PF
1989,31,81,2640,449,900,30,86,419,814,178,212,138,638,776,177,51,100,129,259,1106,C
1989,29,37,176,27,69,2,4,25,65,4,5,6,28,34,15,8,2,16,27,60,SF
1989,22,54,550,109,256,0,7,109,249,43,112,87,113,200,60,20,4,50,105,261,PF
1989,22,62,526,60,117,0,0,60,117,39,60,54,93,147,9,17,48,28,112,159,C
1989,31,55,627,65,188,5,41,60,147,44,60,13,40,53,127,25,5,62,61,179,SG
1989,22,75,779,120,220,0,0,120,220,79,113,48,151,199,16,8,22,69,174,319,C
1989,26,57,840,109,258,0,2,109,256,53,71,73,186,259,42,20,33,53,138,271,PF
1989,25,82,781,40,133,1,14,39,119,57,73,23,64,87,215,27,5,88,88,138,PG
1989,28,71,2745,558,1221,23,66,535,1155,270,344,187,475,662,559,195,20,157,178,1409,SG
1989,28,80,2184,300,568,1,5,299,563,133,191,194,304,498,75,97,70,105,270,734,PF
1989,25,42,336,58,121,1,3,57,118,19,39,35,26,61,15,11,3,24,28,136,SG
1989,23,81,2657,604,1242,3,22,601,1220,284,361,116,261,377,218,124,72,142,258,1495,SF
1989,30,82,1806,271,543,0,0,271,543,115,178,207,338,545,54,28,180,117,310,657,C
1989,22,20,110,9,32,0,0,9,32,12,15,14,18,32,4,3,4,13,15,30,PF
1989,24,77,1214,210,486,1,11,209,475,81,103,84,172,256,66,30,56,77,161,502,PF
1989,24,48,738,117,270,0,4,117,266,35,46,47,95,142,49,21,26,49,101,269,PF
1989,24,29,476,93,216,1,7,92,209,46,57,37,77,114,17,9,30,28,60,233,PF
1989,22,82,2435,336,692,0,5,336,687,304,406,240,306,546,149,122,48,201,337,976,PF
1989,32,68,919,147,359,8,20,139,339,70,76,18,59,77,80,29,3,57,84,372,SG
1989,32,44,767,128,319,8,20,120,299,59,63,16,50,66,65,29,1,48,68,323,SG
1989,32,24,152,19,40,0,0,19,40,11,13,2,9,11,15,0,2,9,16,49,SG
1989,29,14,250,8,25,0,2,8,23,7,11,6,28,34,93,14,0,9,28,23,SG
1989,35,74,842,119,299,18,68,101,231,54,77,22,57,79,260,60,1,66,53,310,PG
1989,30,72,1795,203,393,0,2,203,391,116,155,141,355,496,59,40,66,97,206,522,PF
1989,23,54,1354,181,432,27,82,154,350,78,127,62,147,209,130,63,14,48,139,467,SG
1989,27,76,2418,677,1410,1,19,676,1391,296,340,55,124,179,219,39,14,165,155,1651,SG
1989,25,80,3126,809,1559,5,16,804,1543,703,918,259,594,853,219,144,70,285,286,2326,PF
1989,33,81,2878,538,1096,0,12,538,1084,561,711,386,570,956,112,79,100,245,154,1637,C
1989,22,26,950,177,358,1,5,176,353,79,103,70,101,171,81,44,25,93,89,434,PF
1989,28,10,32,4,8,0,2,4,6,0,0,0,5,5,2,3,0,3,5,8,SF
1989,28,5,14,2,2,0,0,2,2,0,0,0,3,3,0,1,0,0,3,4,SF
1989,28,5,18,2,6,0,2,2,4,0,0,0,2,2,2,2,0,3,2,4,SF
1989,23,79,2065,357,827,32,129,325,698,181,243,49,153,202,301,86,8,178,136,927,SG
1989,26,81,1257,169,351,0,4,169,347,87,129,87,174,261,54,18,24,68,193,425,C
1989,27,68,2435,340,729,5,22,335,707,169,234,143,371,514,293,57,36,168,121,854,SF
1989,25,82,2385,677,1385,11,36,666,1349,312,426,177,256,433,134,84,40,210,231,1677,SF
1989,26,11,103,13,19,0,0,13,19,9,15,4,8,12,5,4,0,3,11,35,PF
1989,29,80,2027,434,917,93,255,341,662,77,144,73,116,189,116,80,12,124,184,1038,SG
1989,31,78,2876,661,1211,0,4,661,1207,436,533,223,414,637,172,26,97,196,223,1758,PF
1989,22,82,2804,487,970,30,89,457,881,301,375,167,297,464,219,105,70,188,264,1305,SF
1989,24,75,2341,199,485,15,70,184,415,119,189,143,245,388,696,156,42,211,236,532,PG
1989,29,39,318,32,64,0,0,32,64,49,78,38,62,100,10,4,3,24,51,113,C
1989,23,74,2536,398,831,98,244,300,587,287,340,73,219,292,227,93,29,143,170,1181,SG
1989,22,24,353,43,97,0,0,43,97,37,64,18,32,50,21,16,2,33,51,123,SF
1989,22,22,320,41,88,0,0,41,88,36,60,17,30,47,20,15,2,29,49,118,SF
1989,22,2,33,2,9,0,0,2,9,1,4,1,2,3,1,1,0,4,2,5,SF
1989,32,74,690,59,164,7,26,52,138,40,51,63,124,187,36,29,21,35,153,165,C
1989,31,62,1594,261,532,25,73,236,459,205,237,46,126,172,188,65,13,94,114,752,PG
1989,23,76,2096,414,905,64,175,350,730,182,254,188,209,397,119,102,60,190,250,1074,SF
1989,22,2,11,3,4,0,0,3,4,0,0,0,0,0,1,0,0,1,2,6,PG
1989,25,82,3093,830,1630,23,100,807,1530,493,553,152,331,483,415,176,39,296,178,2176,SF
1989,25,33,270,31,73,0,2,31,71,33,48,15,18,33,48,20,2,23,44,95,SG
1989,25,4,40,6,12,0,0,6,12,2,4,3,7,10,2,3,0,4,3,14,SG
1989,25,29,230,25,61,0,2,25,59,31,44,12,11,23,46,17,2,19,41,81,SG
1989,29,73,2526,496,920,0,4,496,916,267,334,156,425,581,159,57,206,117,186,1259,PF
1989,32,24,353,47,116,0,1,47,115,57,79,28,50,78,18,8,3,30,32,151,SF
1989,32,14,168,22,50,0,1,22,49,22,31,12,34,46,7,6,1,11,13,66,SF
1989,32,10,185,25,66,0,0,25,66,35,48,16,16,32,11,2,2,19,19,85,SF
1989,24,53,500,45,123,10,34,35,89,14,23,7,22,29,118,24,4,54,70,114,PG
1989,24,21,159,11,35,2,9,9,26,1,2,3,8,11,32,9,0,14,24,25,PG
1989,24,32,341,34,88,8,25,26,63,13,21,4,14,18,86,15,4,40,46,89,PG
1989,28,43,258,13,36,0,2,13,34,4,9,22,56,78,14,7,1,7,45,30,PF
1989,28,13,94,5,7,0,0,5,7,1,2,4,19,23,6,3,1,1,23,11,PF
1989,28,30,164,8,29,0,2,8,27,3,7,18,37,55,8,4,0,6,22,19,PF
1989,29,43,228,27,62,0,0,27,62,11,16,17,47,64,3,5,29,22,51,65,C
1989,25,81,2336,455,957,97,287,358,670,286,351,93,113,206,162,111,23,153,259,1293,SF
1989,33,53,1318,153,370,8,29,145,341,48,65,13,65,78,339,46,0,118,69,362,PG
1989,24,80,3020,638,1271,4,21,634,1250,170,270,245,422,667,277,106,66,206,223,1450,SF
1989,25,82,2604,426,835,12,48,414,787,197,255,343,518,861,187,104,14,248,270,1061,PF
1989,26,82,3024,790,1556,0,10,790,1546,454,652,338,767,1105,149,213,282,275,329,2034,C
1989,25,51,327,55,125,0,1,55,124,31,52,30,28,58,11,8,7,36,40,141,PF
1989,35,80,2840,596,1045,0,0,596,1045,294,409,342,654,996,175,79,116,200,209,1486,C
1989,31,57,1138,202,445,4,24,198,421,84,103,18,56,74,107,38,8,57,96,492,PG
1989,28,78,1738,246,513,44,133,202,380,31,36,13,81,94,308,53,6,71,162,567,PG
1989,23,30,190,29,72,0,0,29,72,8,14,18,27,45,11,4,6,15,38,66,C
1989,27,78,2860,445,959,7,38,438,921,274,329,235,453,688,127,76,92,141,224,1171,PF
1989,23,62,614,108,201,1,4,107,197,40,65,61,71,132,18,19,32,37,47,257,C
1989,24,80,3012,711,1453,63,205,648,1248,243,307,144,372,516,289,83,18,308,280,1728,SF
1989,26,66,1633,278,606,0,8,278,598,115,154,121,292,413,81,47,68,147,236,671,C
1989,29,75,2078,527,1018,8,36,519,982,255,297,82,115,197,156,77,19,112,193,1317,SG
1989,25,80,2012,319,622,0,6,319,616,280,350,166,283,449,118,83,66,119,202,918,PF
1989,25,51,1334,224,446,0,6,224,440,177,221,106,195,301,74,54,43,81,125,625,PF
1989,25,29,678,95,176,0,0,95,176,103,129,60,88,148,44,29,23,38,77,293,PF
1989,23,73,2413,413,867,21,77,392,790,201,301,138,307,445,256,139,61,199,261,1048,SF
1989,24,80,835,91,180,0,2,91,178,51,86,98,108,206,21,37,30,46,164,233,C
1989,24,17,106,16,40,0,0,16,40,2,4,12,15,27,8,1,3,10,17,34,PF
1989,24,10,68,11,25,0,0,11,25,1,2,5,11,16,6,1,2,6,9,23,PF
1989,24,7,38,5,15,0,0,5,15,1,2,7,4,11,2,0,1,4,8,11,PF
1989,25,81,3102,540,1146,79,219,461,927,272,324,85,282,367,770,146,8,248,187,1431,PG
1989,30,67,2170,307,648,12,55,295,593,187,241,73,189,262,439,119,44,184,221,813,SG
1989,24,13,124,9,31,0,2,9,29,5,9,3,12,15,26,4,0,11,11,23,PG
1989,24,10,107,8,25,0,0,8,25,5,9,3,11,14,22,4,0,11,9,21,PG
1989,24,3,17,1,6,0,2,1,4,0,0,0,1,1,4,0,0,0,2,2,PG
1989,25,80,2257,383,873,119,295,264,578,96,123,216,269,485,174,93,76,124,215,981,PF
1989,24,75,2728,529,1006,93,211,436,795,263,292,48,178,226,631,115,7,212,98,1414,PG
1989,30,75,2233,325,627,0,3,325,624,182,248,269,434,703,159,100,57,148,208,832,PF
1989,26,77,1308,257,577,0,0,257,577,69,81,105,182,287,49,29,41,49,194,583,C
1989,33,82,2152,519,1214,17,52,502,1162,152,196,82,220,302,153,53,20,106,235,1207,SF
1989,26,56,737,149,357,3,15,146,342,127,167,49,51,100,62,53,26,57,58,428,SG
1989,23,79,2717,649,1386,33,90,616,1296,410,506,158,310,468,334,82,13,269,223,1741,SG
1989,22,28,91,12,31,0,1,12,30,16,25,9,15,24,3,4,1,9,21,40,C
1989,24,47,440,49,122,1,6,48,116,35,42,13,30,43,106,23,9,61,50,134,PG
1989,27,76,2462,371,816,43,124,328,692,247,287,89,197,286,525,181,40,158,263,1032,PG
1989,28,71,1251,155,319,3,14,152,305,104,129,68,141,209,66,36,23,80,126,417,PF
1989,26,65,2287,465,962,9,45,456,917,183,253,157,227,384,393,197,36,231,259,1122,SG
1989,28,14,416,90,187,0,1,90,186,32,44,19,56,75,32,17,2,34,37,212,SF
1989,27,82,2208,316,531,6,26,310,505,97,155,327,445,772,99,55,76,126,292,735,SF
1989,33,60,583,62,138,0,1,62,137,12,19,38,101,139,19,11,38,22,89,136,C
1989,24,2,3,0,1,0,0,0,1,0,0,1,1,2,0,0,0,0,0,0,SG
1989,25,63,536,59,167,3,16,56,151,60,87,20,44,64,55,24,5,40,69,181,SF
1989,25,16,72,7,24,1,6,6,18,8,11,0,8,8,7,5,1,7,14,23,SF
1989,25,47,464,52,143,2,10,50,133,52,76,20,36,56,48,19,4,33,55,158,SF
1989,28,6,8,0,2,0,0,0,2,4,4,0,2,2,0,0,0,0,0,4,PF
1989,28,3,7,1,2,0,0,1,2,1,2,1,2,3,0,0,0,0,0,3,C
1989,23,34,517,80,162,1,1,79,161,65,81,56,81,137,24,10,12,18,69,226,PF
1989,24,67,1458,166,333,0,2,166,331,135,195,134,201,335,75,40,72,100,197,467,PF
1989,28,61,1086,164,365,3,8,161,357,62,95,105,202,307,77,31,65,90,170,393,C
1989,28,82,2102,332,733,3,10,329,723,97,135,98,209,307,133,89,32,104,230,764,SF
1989,29,76,1918,317,607,3,9,314,598,332,402,142,358,500,105,42,81,160,320,969,C
1989,28,69,774,135,349,42,110,93,239,46,57,58,107,165,36,37,24,48,136,358,PF
1989,26,69,1850,274,578,7,35,267,543,273,350,126,269,395,179,53,19,133,220,828,PF
1989,26,37,845,112,263,2,16,110,247,127,161,56,110,166,86,24,9,56,118,353,PF
1989,26,32,1005,162,315,5,19,157,296,146,189,70,159,229,93,29,10,77,102,475,PF
1989,27,74,2605,588,1198,77,193,511,1005,195,226,72,230,302,231,114,27,157,181,1448,SG
1989,23,78,1962,333,744,1,4,332,740,181,354,204,345,549,55,46,96,200,258,848,C
1989,26,80,1732,231,476,3,6,228,470,86,101,85,142,227,99,35,69,72,176,551,PF
1989,22,60,484,83,168,0,1,83,167,21,42,50,103,153,21,15,18,27,71,187,C
1989,24,65,944,121,248,0,2,121,246,115,167,96,136,232,22,14,13,46,94,357,C
1989,22,82,2301,297,686,0,13,297,673,109,132,119,257,376,472,78,27,188,211,703,SG
1989,31,65,1157,198,480,9,33,189,447,77,89,65,114,179,107,44,13,70,116,482,SF
1989,32,25,390,46,104,3,12,43,92,7,8,9,20,29,59,15,0,25,17,102,PG
1989,33,80,2587,360,835,82,216,278,619,266,294,141,482,623,289,85,61,145,300,1068,C
1989,24,80,1571,198,442,20,75,178,367,130,144,21,128,149,390,64,2,177,151,546,PG
1989,24,2,12,0,2,0,1,0,1,2,2,0,1,1,2,0,0,2,0,2,PG
1989,23,71,2161,435,878,0,3,435,875,285,393,173,292,465,103,68,89,146,273,1155,PF
1989,27,65,1295,216,496,7,31,209,465,129,188,61,106,167,128,43,23,88,164,568,SG
1989,27,29,600,111,276,3,15,108,261,64,95,30,51,81,60,19,8,44,64,289,SG
1989,27,36,695,105,220,4,16,101,204,65,93,31,55,86,68,24,15,44,100,279,SG
1989,23,81,3145,547,1183,46,128,501,1055,263,357,49,177,226,621,102,7,249,173,1403,PG
1989,31,80,1897,219,397,0,0,219,397,18,58,272,380,652,118,61,54,110,248,456,PF
1989,25,80,1597,311,715,7,37,304,678,174,218,128,202,330,140,88,40,129,165,803,SG
1989,22,82,2041,386,746,0,1,386,745,184,255,185,315,500,70,37,151,130,310,956,C
1989,26,43,623,72,153,0,0,72,153,49,76,42,87,129,12,13,58,48,102,193,PF
1989,30,80,2613,444,982,18,74,426,908,94,107,55,161,216,429,103,17,204,168,1000,PG
1989,23,36,316,51,125,10,26,41,99,34,52,15,26,41,27,23,3,39,36,146,SG
1989,22,35,209,23,72,2,10,21,62,17,22,11,12,23,37,9,4,29,22,65,PG
1989,29,27,244,33,78,5,9,28,69,32,37,13,19,32,16,11,1,13,32,103,PG
1989,26,82,3171,497,923,16,66,481,857,390,452,83,165,248,1118,263,14,308,241,1400,PG
1989,22,81,1358,265,567,19,59,246,508,172,231,51,109,160,319,98,3,148,142,721,PG
1989,30,5,22,2,5,0,0,2,5,0,0,5,9,14,3,0,2,3,3,4,PF
1989,30,4,20,2,5,0,0,2,5,0,0,5,9,14,3,0,2,2,1,4,PF
1989,23,1,1,0,1,0,0,0,1,0,0,0,0,0,0,0,0,0,0,0,PF
1989,27,68,1338,307,675,48,92,259,583,47,57,18,69,87,137,27,1,87,78,709,SG
1989,24,19,591,131,242,0,1,131,241,66,96,77,141,218,17,28,30,45,70,328,PF
1989,23,21,368,60,151,0,2,60,149,24,32,11,23,34,43,22,5,20,37,144,PG
1989,28,66,1569,409,859,2,12,407,847,182,225,110,153,263,96,79,17,116,173,1002,SF
1989,31,82,2517,497,1067,17,58,480,1009,285,335,86,156,242,387,108,16,194,236,1296,SG
1989,27,80,2924,569,1227,33,121,536,1106,287,351,49,224,273,663,133,20,298,209,1458,PG
1989,26,23,222,20,59,0,2,20,57,22,26,9,19,28,13,13,1,19,33,62,PF
1989,25,79,2273,349,716,0,4,349,712,156,224,241,331,572,176,56,105,189,260,854,SF
1989,27,76,2329,416,850,0,1,416,849,227,281,224,494,718,81,79,94,179,285,1059,C
1989,27,43,1276,247,536,0,1,247,535,152,188,120,272,392,44,46,55,117,153,646,C
1989,27,33,1053,169,314,0,0,169,314,75,93,104,222,326,37,33,39,62,132,413,C
1989,34,80,1994,291,521,0,1,291,520,156,230,157,310,467,48,58,59,97,224,738,C
1989,26,54,449,47,111,1,3,46,108,32,60,36,56,92,15,8,7,23,87,127,PF
1989,26,82,3135,521,961,0,2,521,959,328,450,272,515,787,202,82,37,225,259,1370,PF
1989,27,63,1220,235,476,11,30,224,446,63,77,31,86,117,238,83,4,77,155,544,PG
1989,24,79,2434,532,1036,0,4,532,1032,317,410,187,422,609,128,55,52,172,290,1381,PF
1989,24,48,1326,285,564,0,4,285,560,198,250,99,211,310,75,35,32,107,181,768,PF
1989,24,31,1108,247,472,0,0,247,472,119,160,88,211,299,53,20,20,65,109,613,PF
1989,30,50,341,40,94,0,0,40,94,23,37,31,57,88,16,13,13,35,55,103,PF
1989,23,14,117,17,37,0,3,17,34,6,12,7,14,21,7,2,4,2,20,40,SF
1989,26,2,9,1,5,0,3,1,2,0,1,1,1,2,0,0,0,2,1,2,PG
1989,29,71,2302,568,1215,30,84,538,1131,440,508,79,188,267,224,88,16,236,196,1606,SF
1989,29,81,1824,263,579,118,296,145,283,43,55,55,121,176,132,88,6,59,163,687,SG
1989,24,4,13,3,6,0,0,3,6,0,0,0,3,3,0,2,0,4,2,6,PG
1989,29,78,1746,151,353,2,7,149,346,33,56,109,178,287,144,90,8,60,209,337,SF
1989,32,70,1057,169,360,1,9,168,351,47,62,74,135,209,40,24,39,51,90,386,SF
1989,26,32,617,99,212,3,15,96,197,18,26,10,39,49,117,26,3,55,80,219,SG
1989,26,9,144,26,63,1,5,25,58,4,6,4,9,13,20,7,0,13,18,57,SG
1989,26,23,473,73,149,2,10,71,139,14,20,6,30,36,97,19,3,42,62,162,SG
1989,29,77,1086,136,319,3,14,133,305,91,112,22,81,103,174,57,7,83,88,366,SG
1989,30,45,934,200,426,19,48,181,378,80,89,26,45,71,69,19,11,41,78,499,PF
1989,30,18,432,103,217,16,38,87,179,29,33,11,24,35,34,7,4,18,40,251,PF
1989,30,27,502,97,209,3,10,94,199,51,56,15,21,36,35,12,7,23,38,248,PF
1989,29,29,646,104,257,1,3,103,254,40,60,38,72,110,27,6,4,42,63,249,SF
1989,29,5,95,13,38,1,2,12,36,5,9,2,16,18,5,1,1,5,11,32,SF
1989,29,24,551,91,219,0,1,91,218,35,51,36,56,92,22,5,3,37,52,217,SF
1989,25,70,1703,274,566,2,17,272,549,106,129,34,156,190,335,53,10,142,124,656,PG
1989,27,79,2565,286,681,0,9,286,672,142,184,135,372,507,496,155,23,184,215,714,PG
1989,24,79,1163,174,356,5,20,169,336,66,85,101,129,230,36,41,45,44,190,419,SF
1989,25,54,1065,164,387,1,14,163,373,82,104,49,74,123,226,73,4,122,101,411,PG
1989,25,81,1219,133,290,1,22,132,268,52,60,21,102,123,284,70,6,83,104,319,PG
1989,25,72,843,99,222,0,1,99,221,48,73,59,134,193,29,23,41,42,176,246,C
1989,25,65,1074,119,275,1,9,118,266,61,82,82,204,286,46,16,35,54,211,300,C
1989,28,82,2019,243,372,0,0,243,372,108,202,167,384,551,39,35,187,103,273,594,C
1989,26,8,90,12,33,0,0,12,33,10,11,2,14,16,22,7,1,11,15,34,PG
1989,29,28,354,45,87,0,1,45,86,15,20,17,14,31,54,27,0,24,26,105,PG
1989,29,8,143,24,42,0,0,24,42,8,10,5,7,12,21,8,0,6,9,56,PG
1989,29,20,211,21,45,0,1,21,44,7,10,12,7,19,33,19,0,18,17,49,PG
1989,23,38,436,62,120,0,0,62,120,34,42,34,36,70,17,10,1,26,40,158,SF
1989,23,1,2,0,1,0,0,0,1,0,0,0,0,0,0,0,0,0,1,0,SF
1989,23,37,434,62,119,0,0,62,119,34,42,34,36,70,17,10,1,26,39,158,SF
1989,32,57,622,72,182,0,0,72,182,31,47,49,85,134,19,23,4,24,115,175,C
1989,32,5,42,3,6,0,0,3,6,1,2,0,5,5,2,1,0,2,8,7,C
1989,32,52,580,69,176,0,0,69,176,30,45,49,80,129,17,22,4,22,107,168,C
1989,22,51,408,46,114,6,24,40,90,13,16,13,34,47,76,25,6,34,61,111,PG
1989,29,80,2997,814,1756,29,105,785,1651,442,524,256,297,553,211,117,52,181,138,2099,SF
1989,26,71,584,114,245,0,1,114,244,61,111,72,76,148,7,10,16,56,110,289,C
1989,25,81,2414,462,1025,51,172,411,853,186,246,95,149,244,274,115,22,169,166,1161,SG
1989,28,74,2446,373,702,0,3,373,699,213,320,249,447,696,78,61,36,142,223,959,PF
1989,30,76,2470,322,739,0,5,322,734,133,194,135,458,593,124,46,134,149,236,777,C
1989,30,46,1567,244,542,0,3,244,539,90,126,87,309,396,88,31,80,108,156,578,C
1989,30,30,903,78,197,0,2,78,195,43,68,48,149,197,36,15,54,41,80,199,C
1989,26,82,2125,356,700,1,4,355,696,235,314,173,304,477,108,77,134,102,188,948,PF
1989,22,82,2413,438,940,19,71,419,869,225,290,158,415,573,356,142,70,157,213,1120,SF
1989,27,50,547,81,200,1,6,80,194,46,59,28,42,70,53,30,11,52,91,209,SG
1989,27,41,433,67,168,1,6,66,162,40,51,19,31,50,36,25,8,42,74,175,SG
1989,27,9,114,14,32,0,0,14,32,6,8,9,11,20,17,5,3,10,17,34,SG
1989,22,49,358,47,129,2,9,45,120,31,47,9,18,27,70,13,3,42,44,127,PG
1989,24,63,1303,260,594,30,104,230,490,92,122,70,109,179,103,81,29,114,181,642,SF
1989,25,33,372,54,115,2,6,52,109,27,34,12,25,37,73,9,2,35,43,137,SG
1989,29,64,1120,130,286,3,6,127,280,28,41,26,54,80,111,23,2,32,43,291,SF
1989,29,31,416,50,117,2,4,48,113,16,22,6,20,26,32,10,0,12,12,118,SF
1989,29,33,704,80,169,1,2,79,167,12,19,20,34,54,79,13,2,20,31,173,SF
1989,24,66,1450,170,402,2,14,168,388,44,64,83,188,271,113,32,16,94,152,386,C
1989,30,81,2259,410,936,31,89,379,847,195,237,51,143,194,206,89,18,136,195,1046,SG
1989,29,74,1491,231,494,0,1,231,493,253,343,81,189,270,58,30,65,103,130,715,SF
1989,27,81,2960,702,1282,2,23,700,1259,251,321,169,320,489,288,108,56,182,175,1657,SF
1989,26,48,952,115,250,17,50,98,200,50,64,17,57,74,123,55,3,45,50,297,PG
1990,27,80,1691,138,285,3,4,135,281,83,120,154,277,431,67,36,25,70,248,362,C
1990,27,79,2690,398,989,158,432,240,557,267,314,49,176,225,495,121,3,141,133,1221,PG
1990,30,78,2005,438,898,31,93,407,805,192,254,117,188,305,145,34,19,121,201,1099,SF
1990,30,75,2727,506,1154,108,289,398,865,222,267,69,257,326,453,113,18,185,238,1342,PG
1990,26,82,1893,371,785,10,49,361,736,108,133,151,223,374,142,60,39,101,219,860,PF
1990,25,41,302,63,138,7,22,56,116,35,37,2,23,25,39,15,3,16,22,168,PG
1990,25,63,746,106,239,0,7,106,232,23,43,49,89,138,23,16,19,28,102,235,SG
1990,25,60,1291,219,432,0,0,219,432,91,170,112,261,373,24,32,54,80,176,529,PF
1990,22,81,1785,372,753,1,17,371,736,186,264,107,209,316,124,69,34,138,140,931,SG
1990,29,54,604,88,211,37,100,51,111,18,23,33,94,127,55,20,9,26,64,231,PF
1990,31,78,2089,379,841,3,21,376,820,165,197,81,214,295,143,72,13,78,143,926,SF
1990,23,82,2788,532,1082,7,26,525,1056,217,290,115,257,372,364,111,58,198,252,1288,SG
1990,22,72,1221,231,465,0,0,231,465,164,227,187,175,362,40,24,17,50,152,626,SF
1990,22,81,1291,190,392,3,6,187,386,69,78,19,83,102,199,46,6,83,105,452,PG
1990,29,54,1095,100,218,1,18,99,200,29,39,26,63,89,296,40,4,90,77,230,PG
1990,28,82,2583,470,977,0,8,470,969,222,285,116,294,410,137,32,100,139,175,1162,SF
1990,29,52,589,77,161,0,1,77,160,52,110,39,73,112,18,17,7,44,92,206,PF
1990,26,79,3085,706,1177,20,92,686,1085,557,744,361,548,909,307,148,50,243,250,1989,SF
1990,22,81,1630,299,738,95,238,204,500,89,110,35,97,132,205,53,1,123,97,782,PG
1990,27,60,1477,275,544,2,13,273,531,102,135,27,72,99,154,28,3,89,115,654,SG
1990,25,59,729,93,170,1,4,92,166,55,82,44,80,124,38,35,11,32,94,242,SG
1990,26,42,246,54,125,1,6,53,119,9,22,15,43,58,4,3,17,21,39,118,C
1990,25,71,2313,362,688,0,1,362,687,235,321,156,501,657,159,59,187,187,217,959,C
1990,24,55,990,137,286,0,0,137,286,64,96,84,104,188,54,23,10,62,133,338,SF
1990,33,75,2944,718,1517,65,195,653,1322,319,343,90,622,712,562,106,61,243,173,1820,SF
1990,27,47,531,39,98,0,0,39,98,20,37,29,79,108,25,1,22,35,102,98,C
1990,27,40,481,33,87,0,0,33,87,17,31,28,71,99,24,1,22,30,93,83,C
1990,27,7,50,6,11,0,0,6,11,3,6,1,8,9,1,0,0,5,9,15,C
1990,30,80,2934,626,1256,13,43,613,1213,287,340,88,192,280,289,77,21,174,128,1552,SG
1990,22,50,1267,212,571,18,80,194,491,63,81,42,98,140,210,82,14,111,110,505,PG
1990,25,81,2743,326,664,5,26,321,638,106,134,48,159,207,867,166,3,146,168,763,PG
1990,27,75,1310,56,169,9,48,47,121,25,49,33,243,276,36,13,238,51,194,146,C
1990,26,66,918,119,293,6,21,113,272,40,54,36,82,118,96,42,5,59,80,284,SG
1990,28,68,2207,347,834,10,31,337,803,294,379,206,484,690,91,38,121,125,211,998,C
1990,26,11,91,25,61,1,1,24,60,14,22,8,12,20,4,6,0,8,14,65,SF
1990,29,81,1879,298,696,0,1,298,695,126,193,154,263,417,97,42,108,96,196,722,C
1990,29,30,554,86,186,0,0,86,186,32,51,43,84,127,13,9,33,28,63,204,C
1990,29,51,1325,212,510,0,1,212,509,94,142,111,179,290,84,33,75,68,133,518,C
1990,30,78,1438,211,387,0,2,211,385,95,141,89,238,327,105,66,37,93,226,517,C
1990,24,72,975,119,276,31,79,88,197,50,57,15,49,64,207,47,0,38,105,319,PG
1990,21,75,1339,210,447,0,7,210,440,125,164,83,148,231,50,33,26,69,148,545,SF
1990,26,82,1397,177,344,1,2,176,342,157,199,111,262,373,47,32,28,88,187,512,C
1990,24,16,56,8,28,0,0,8,28,0,2,10,5,15,4,0,0,6,11,16,PF
1990,29,61,635,88,206,5,20,83,186,38,56,39,33,72,41,32,4,51,79,219,SF
1990,22,16,128,15,30,0,0,15,30,7,18,15,11,26,3,6,5,6,24,37,SF
1990,24,58,562,70,153,0,0,70,153,28,50,54,92,146,13,18,9,25,93,168,PF
1990,25,3,10,0,2,0,0,0,2,4,6,0,2,2,0,2,1,1,5,4,C
1990,23,18,75,9,33,0,1,9,32,5,6,5,2,7,10,2,1,11,10,23,SG
1990,23,13,33,3,12,0,0,3,12,0,2,3,6,9,1,0,0,3,8,6,C
1990,28,82,2595,325,645,0,0,325,645,148,212,306,515,821,70,79,45,94,232,798,C
1990,23,51,331,42,76,0,0,42,76,13,28,36,73,109,7,11,18,32,69,97,PF
1990,27,82,3164,723,1581,9,54,714,1527,448,569,209,242,451,213,111,31,251,260,1903,SG
1990,30,5,21,1,7,0,3,1,4,0,0,0,0,0,5,1,1,4,7,2,SG
1990,28,77,1727,356,721,0,7,356,714,237,298,115,207,322,119,30,68,125,247,949,PF
1990,28,44,803,128,248,0,4,128,244,79,102,50,99,149,53,15,34,54,128,335,PF
1990,28,33,924,228,473,0,3,228,470,158,196,65,108,173,66,15,34,71,119,614,PF
1990,31,76,1721,312,759,0,2,312,757,137,177,133,310,443,97,47,115,142,192,761,C
1990,31,46,1002,159,405,0,2,159,403,85,107,82,168,250,43,19,56,64,122,403,C
1990,31,30,719,153,354,0,0,153,354,52,70,51,142,193,54,28,59,78,70,358,C
1990,32,71,2160,292,598,0,0,292,598,227,280,137,328,465,145,38,34,123,243,811,C
1990,26,74,2462,546,1152,2,8,544,1144,341,486,271,292,563,72,36,17,181,201,1435,PF
1990,30,81,3046,810,1617,24,86,786,1531,557,647,121,450,571,190,88,47,218,260,2201,PF
1990,22,54,1762,377,924,47,142,330,782,144,192,52,127,179,132,46,6,100,113,945,SG
1990,33,81,2519,307,609,4,16,303,593,171,202,50,190,240,453,124,10,121,78,789,PG
1990,33,50,1766,215,450,1,9,214,441,114,137,39,128,167,302,82,5,85,46,545,PG
1990,33,31,753,92,159,3,7,89,152,57,65,11,62,73,151,42,5,36,32,244,PG
1990,22,55,591,105,220,3,9,102,211,80,111,35,55,90,31,26,5,45,70,293,SF
1990,22,41,492,90,178,3,8,87,170,61,87,28,47,75,27,23,4,40,59,244,SF
1990,22,14,99,15,42,0,1,15,41,19,24,7,8,15,4,3,1,5,11,49,SF
1990,28,22,305,46,97,0,1,46,96,34,41,31,56,87,12,7,7,26,54,126,PF
1990,27,73,977,142,297,0,5,142,292,77,95,55,121,176,148,47,10,38,98,361,PG
1990,30,82,2355,237,573,2,13,235,560,172,214,90,175,265,385,172,8,138,182,648,PG
1990,33,80,1851,191,493,50,157,141,336,83,94,59,168,227,215,67,36,91,206,515,SG
1990,33,79,1176,138,304,0,3,138,301,25,39,118,221,339,44,18,95,39,211,301,C
1990,24,23,110,31,68,1,5,30,63,11,14,4,6,10,9,1,1,19,12,74,SG
1990,27,82,3011,521,1083,0,11,521,1072,161,209,219,385,604,216,175,41,143,288,1203,SF
1990,33,6,79,11,29,0,0,11,29,0,2,7,11,18,2,2,0,8,7,22,C
1990,33,37,391,77,159,0,0,77,159,21,37,28,65,93,13,12,4,32,60,175,C
1990,28,81,2821,728,1532,19,59,709,1473,343,440,226,451,677,219,110,52,202,286,1818,PF
1990,25,67,1860,461,990,52,147,409,843,96,104,31,137,168,159,98,26,100,148,1070,SG
1990,29,30,491,97,240,1,5,96,235,52,66,18,33,51,34,12,0,34,63,247,SG
1990,33,45,1300,231,484,0,2,231,482,200,254,78,94,172,80,20,7,75,99,662,SF
1990,24,41,1438,244,509,0,2,244,507,202,287,77,296,373,130,29,22,110,108,690,C
1990,34,73,1292,179,365,35,104,144,261,77,100,12,81,93,242,47,9,86,151,470,PG
1990,31,53,429,58,158,7,25,51,133,7,8,25,56,81,18,10,8,20,52,130,SF
1990,22,63,884,122,262,0,1,122,261,54,87,93,136,229,25,25,28,68,171,298,PF
1990,35,69,1635,497,1033,6,46,491,987,207,227,46,133,179,155,59,9,102,160,1207,SG
1990,26,81,2865,465,950,22,66,443,884,210,244,48,199,247,601,121,9,214,159,1162,PG
1990,23,76,1858,297,643,10,32,287,611,135,155,39,159,198,250,64,10,111,182,739,SG
1990,22,33,362,44,109,1,9,43,100,26,30,13,27,40,75,19,2,37,30,115,PG
1990,21,82,1611,274,549,0,5,274,544,153,216,167,345,512,75,79,114,110,240,701,C
1990,32,73,2265,258,479,0,0,258,479,149,213,155,475,630,57,22,47,119,129,665,C
1990,23,81,2470,463,938,5,31,458,907,224,326,70,136,206,619,145,10,246,187,1155,PG
1990,23,9,92,9,27,0,1,9,26,4,8,7,8,15,3,6,2,7,10,22,SF
1990,27,49,307,20,53,0,0,20,53,25,34,21,66,87,8,4,14,19,69,65,C
1990,31,80,1333,170,383,32,81,138,302,46,60,12,86,98,217,47,4,95,92,418,PG
1990,27,73,2683,670,1357,30,106,640,1251,333,430,208,299,507,432,145,51,191,222,1703,SG
1990,25,82,2462,548,1146,0,0,548,1146,231,312,184,325,509,91,36,34,171,271,1327,C
1990,24,64,1356,146,355,0,0,146,355,58,182,174,249,423,39,41,72,84,164,350,PF
1990,24,37,684,79,203,0,0,79,203,26,77,88,115,203,20,19,41,48,83,184,PF
1990,24,27,672,67,152,0,0,67,152,32,105,86,134,220,19,22,31,36,81,166,PF
1990,26,75,2578,508,1058,22,55,486,1003,297,330,60,152,212,368,63,2,145,129,1335,SG
1990,35,5,43,4,14,2,9,2,5,7,8,0,2,2,10,1,0,8,7,17,PG
1990,34,65,657,44,97,0,2,44,95,26,39,56,82,138,43,41,4,19,67,114,SF
1990,23,78,1696,413,940,19,59,394,881,210,280,74,101,175,182,50,4,143,157,1055,SG
1990,33,82,2281,158,300,0,0,158,300,79,118,171,430,601,39,33,201,75,238,395,C
1990,24,82,1889,286,564,9,30,277,534,146,203,69,182,251,145,76,36,152,280,727,SF
1990,34,82,2283,462,928,0,3,462,925,265,354,112,233,345,63,23,37,133,295,1189,C
1990,21,4,26,3,7,0,2,3,5,1,3,1,1,2,4,1,0,1,4,7,SG
1990,24,78,2211,395,959,9,30,386,929,139,183,77,205,282,252,125,33,180,149,938,SG
1990,28,81,2894,436,940,104,248,332,692,126,185,147,292,439,371,126,23,161,226,1102,SG
1990,21,81,2032,311,647,1,9,310,638,187,216,127,170,297,154,45,14,112,172,810,SF
1990,29,55,2033,502,1011,96,256,406,755,193,236,90,148,238,110,59,7,119,124,1293,SG
1990,22,34,866,111,251,0,2,111,249,49,78,64,132,196,65,16,57,62,132,271,C
1990,36,80,2211,635,1293,2,5,633,1288,161,183,119,167,286,225,51,23,93,130,1433,SF
1990,27,82,3165,922,1673,1,4,921,1669,502,648,235,658,893,182,78,327,278,325,2347,C
1990,25,38,400,89,203,8,27,81,176,57,80,17,26,43,25,17,1,27,44,243,SG
1990,24,14,29,5,14,0,1,5,13,2,6,3,4,7,2,1,0,2,3,12,SF
1990,27,82,2876,467,919,12,34,455,885,230,294,118,204,322,610,92,10,206,213,1176,PG
1990,29,82,2630,362,803,89,234,273,569,187,232,46,152,198,600,94,11,204,159,1000,PG
1990,24,77,1762,278,607,0,0,278,607,179,234,151,234,385,85,51,27,134,282,735,PF
1990,24,9,81,4,12,1,2,3,10,1,4,1,4,5,26,4,0,10,11,10,SG
1990,24,71,990,137,301,3,18,134,283,85,107,42,70,112,119,28,8,44,77,362,SF
1990,25,79,1762,230,573,12,36,218,537,102,122,51,163,214,303,78,10,158,152,574,PG
1990,25,51,891,108,288,1,10,107,278,53,63,31,80,111,157,48,5,81,77,270,PG
1990,25,28,871,122,285,11,26,111,259,49,59,20,83,103,146,30,5,77,75,304,PG
1990,23,73,1721,208,421,4,21,204,400,88,114,34,128,162,289,90,7,117,151,508,SG
1990,25,63,941,148,269,1,1,147,268,75,110,75,122,197,39,35,31,67,150,372,PF
1990,26,21,339,93,197,0,3,93,194,65,89,29,36,65,8,20,7,12,47,251,PF
1990,25,76,2426,484,940,0,2,484,938,303,419,211,388,599,99,69,51,183,212,1271,PF
1990,25,16,267,52,121,0,0,52,121,39,56,26,44,70,8,6,5,17,28,143,PF
1990,25,60,2159,432,819,0,2,432,817,264,363,185,344,529,91,63,46,166,184,1128,PF
1990,30,81,2659,458,1002,3,17,455,985,193,235,196,491,687,128,43,102,98,136,1112,C
1990,24,44,1529,241,517,5,21,236,496,88,113,59,136,195,442,108,5,206,120,575,PG
1990,23,67,678,83,216,3,16,80,200,39,59,16,43,59,168,36,1,77,58,208,PG
1990,24,81,1846,284,601,0,8,284,593,96,137,138,204,342,131,52,43,85,194,664,PF
1990,24,80,2753,446,853,0,0,446,853,179,256,236,393,629,227,92,84,110,230,1071,PF
1990,26,58,560,42,99,0,5,42,94,32,47,40,105,145,19,15,26,24,90,116,C
1990,26,39,466,38,82,0,2,38,80,25,39,38,93,131,17,12,24,19,64,101,C
1990,26,19,94,4,17,0,3,4,14,7,8,2,12,14,2,3,2,5,26,15,C
1990,24,71,1427,224,487,1,8,223,479,99,152,94,123,217,107,48,10,82,125,548,SF
1990,26,82,2709,385,806,13,46,372,760,278,370,262,450,712,90,66,50,116,207,1061,PF
1990,35,69,927,100,231,1,11,99,220,43,51,9,45,54,182,51,1,62,60,244,PG
1990,29,73,1860,312,667,1,3,311,664,136,209,166,422,588,99,50,26,119,231,761,C
1990,32,37,205,22,52,0,0,22,52,16,29,24,54,78,12,4,9,16,40,60,PF
1990,31,82,1444,301,649,80,215,221,434,51,78,43,123,166,63,68,19,75,149,733,SG
1990,23,43,559,88,217,3,21,85,196,17,25,7,44,51,80,13,2,33,53,196,PG
1990,26,67,1084,138,347,0,1,138,346,85,125,115,185,300,26,18,12,72,170,361,PF
1990,26,11,58,9,20,0,0,9,20,7,7,7,11,18,4,0,1,7,7,25,PF
1990,26,56,1026,129,327,0,1,129,326,78,118,108,174,282,22,18,11,65,163,336,PF
1990,22,61,805,129,295,0,1,129,294,63,98,61,107,168,51,11,14,46,98,321,PF
1990,29,81,2174,265,568,54,154,211,414,33,64,66,163,229,149,52,11,79,194,617,SG
1990,32,81,1605,179,396,6,31,173,365,136,183,67,140,207,186,78,29,87,249,500,PF
1990,23,79,2663,464,985,23,84,441,901,211,276,57,253,310,689,165,12,260,232,1162,PG
1990,28,82,3007,567,1161,89,240,478,921,250,315,54,190,244,609,187,26,207,224,1473,PG
1990,26,35,1367,301,637,14,51,287,586,182,231,74,132,206,182,81,41,100,105,798,SG
1990,26,7,262,61,138,1,5,60,133,31,41,19,29,48,49,14,9,18,25,154,SG
1990,26,28,1105,240,499,13,46,227,453,151,190,55,103,158,133,67,32,82,80,644,SG
1990,26,15,93,14,40,0,0,14,40,3,4,5,5,10,1,7,1,5,9,31,SG
1990,29,40,166,10,33,3,12,7,21,19,22,7,25,32,8,3,3,7,31,42,PF
1990,23,82,2856,522,1136,84,200,438,936,387,436,85,219,304,261,130,28,185,217,1515,SG
1990,34,57,464,53,109,17,38,36,71,12,15,11,32,43,74,16,2,24,50,135,PG
1990,34,11,129,11,26,3,7,8,19,2,2,3,9,12,13,8,0,8,14,27,PG
1990,34,46,335,42,83,14,31,28,52,10,13,8,23,31,61,8,2,16,36,108,PG
1990,22,11,50,3,8,0,0,3,8,8,10,2,2,4,3,2,2,1,5,14,SF
1990,22,5,32,3,8,0,0,3,8,7,8,1,2,3,2,1,0,1,1,13,SF
1990,30,82,1993,304,632,67,193,237,439,234,285,120,302,422,129,47,53,93,184,909,PF
1990,28,25,793,145,286,0,0,145,286,86,99,61,111,172,22,14,27,52,87,376,PF
1990,29,63,1055,145,331,87,181,58,150,30,33,11,42,53,110,30,2,30,87,407,SG
1990,28,16,109,14,26,0,0,14,26,1,2,1,1,2,16,1,0,13,19,29,PG
1990,25,10,135,16,41,0,0,16,41,8,10,19,17,36,6,2,1,8,26,40,C
1990,24,79,2551,474,1093,32,101,442,992,271,342,113,166,279,151,100,51,168,183,1251,SG
1990,24,35,236,18,62,0,0,18,62,15,24,19,40,59,2,5,16,14,33,51,C
1990,26,67,2278,483,901,40,98,443,803,173,202,86,227,313,337,117,14,125,144,1179,SG
1990,22,45,374,80,162,0,4,80,158,42,69,59,49,108,19,9,5,39,63,202,PF
1990,29,60,892,83,202,20,49,63,153,23,34,15,55,70,116,48,1,39,87,209,PG
1990,27,81,2818,496,1005,21,70,475,935,224,285,80,189,269,472,156,11,151,253,1237,PG
1990,23,50,488,96,203,5,14,91,189,61,91,30,44,74,47,28,1,39,40,258,SG
1990,22,28,160,25,69,0,3,25,66,17,21,16,8,24,13,13,1,18,16,67,SG
1990,24,82,2428,327,749,35,131,292,618,120,165,106,212,318,604,109,4,211,121,809,PG
1990,25,17,58,3,11,1,2,2,9,3,6,2,5,7,8,5,0,4,3,10,PG
1990,24,53,575,55,142,1,4,54,138,29,40,21,22,43,162,26,1,48,55,140,PG
1990,26,82,2832,504,1019,2,17,502,1002,205,270,113,268,381,252,104,62,167,321,1215,SF
1990,35,75,2036,206,475,1,24,205,451,118,140,48,153,201,485,81,14,117,179,531,PG
1990,30,64,1811,411,907,70,184,341,723,188,205,69,177,246,107,32,10,108,174,1080,SF
1990,23,48,272,20,84,1,6,19,78,13,17,8,20,28,64,17,2,26,49,54,PG
1990,23,74,2782,578,1159,8,41,570,1118,501,598,42,228,270,846,95,14,263,143,1665,PG
1990,30,79,2937,546,1138,106,276,440,862,567,637,128,394,522,907,132,34,289,167,1765,PG
1990,33,10,99,12,32,2,3,10,29,14,17,8,9,17,9,0,1,10,12,40,SF
1990,32,25,259,48,92,0,0,48,92,21,35,19,34,53,17,3,5,31,56,117,C
1990,32,4,17,0,2,0,0,0,2,0,0,0,3,3,1,0,0,6,4,0,C
1990,32,21,242,48,90,0,0,48,90,21,35,19,31,50,16,3,5,25,52,117,C
1990,33,82,1972,334,775,5,34,329,741,131,196,108,148,256,255,71,13,123,143,804,SG
1990,23,6,13,4,11,1,1,3,10,2,2,2,0,2,0,0,1,1,0,11,SF
1990,23,15,74,14,37,0,3,14,34,7,11,11,10,21,1,3,7,5,11,35,PF
1990,27,66,650,72,194,4,13,68,181,47,69,33,49,82,29,32,16,42,77,195,SG
1990,39,72,885,67,144,1,5,66,139,38,54,76,154,230,20,20,27,48,146,173,PF
1990,32,81,2240,94,185,0,0,94,185,68,105,145,359,504,139,50,197,76,296,256,C
1990,26,82,3197,1034,1964,92,245,942,1719,593,699,143,422,565,519,227,54,247,241,2753,SG
1990,20,81,1120,203,424,2,12,201,412,117,159,146,200,346,26,47,70,107,204,525,PF
1990,26,71,1061,153,312,0,1,153,311,77,114,51,167,218,118,30,9,80,144,383,PF
1990,24,78,1664,192,432,73,144,119,288,63,73,12,86,98,248,45,7,74,59,520,PG
1990,27,82,2843,519,1085,3,20,516,1065,269,390,251,439,690,188,121,63,144,304,1310,SF
1990,23,80,1615,293,678,14,43,279,635,101,140,100,153,253,88,68,8,84,224,701,SF
1990,23,48,892,151,359,2,10,149,349,61,82,52,85,137,39,38,2,47,117,365,SF
1990,23,32,723,142,319,12,33,130,286,40,58,48,68,116,49,30,6,37,107,336,SF
1990,23,10,50,7,16,0,0,7,16,2,2,4,3,7,5,4,0,4,4,16,PG
1990,33,82,2687,711,1459,3,23,708,1436,412,513,129,275,404,376,51,7,248,230,1837,SF
1990,23,82,1777,267,530,0,1,267,529,194,267,169,215,384,87,38,58,119,215,728,PF
1990,28,71,1515,101,234,1,1,100,233,27,54,131,246,377,76,31,51,76,201,230,C
1990,28,81,1365,176,367,0,4,176,363,83,100,117,238,355,46,15,27,64,170,435,C
1990,26,54,977,78,127,0,1,78,126,42,79,58,168,226,23,38,34,47,182,198,C
1990,23,57,438,42,114,5,20,37,94,24,39,25,46,71,21,14,3,23,54,113,PF
1990,25,16,381,43,118,0,2,43,116,26,33,16,60,76,25,10,2,19,41,112,PF
1990,32,81,2675,380,785,57,158,323,627,164,192,166,614,780,171,57,84,98,278,981,C
1990,23,67,956,145,309,0,5,145,304,44,120,144,217,361,105,53,17,85,189,334,PF
1990,23,74,1011,97,174,0,0,97,174,64,98,83,188,271,21,22,133,41,171,258,C
1990,23,4,32,2,7,0,0,2,7,2,2,2,2,4,3,2,0,1,7,6,SG
1990,23,77,764,125,222,0,0,125,222,81,109,48,144,192,19,15,23,63,157,331,C
1990,23,11,83,11,29,0,1,11,28,6,6,4,4,8,6,2,0,4,12,28,SG
1990,22,22,127,13,31,0,1,13,30,6,14,10,17,27,1,3,9,8,26,32,C
1990,26,7,92,5,14,0,1,5,13,13,17,3,4,7,21,3,0,10,9,23,PG
1990,26,6,86,5,14,0,1,5,13,11,13,3,4,7,20,3,0,7,6,21,PG
1990,24,4,28,2,8,0,0,2,8,0,0,0,0,0,1,0,0,2,8,4,PG
1990,29,79,2832,568,1283,36,87,532,1196,271,337,230,504,734,517,168,13,156,172,1443,SG
1990,29,75,1706,216,424,1,5,215,419,83,122,113,206,319,80,55,41,49,216,516,PF
1990,26,7,26,4,7,0,0,4,7,2,2,4,2,6,0,1,0,2,3,10,SG
1990,26,4,6,0,1,0,0,0,1,0,0,0,0,0,0,0,0,1,1,0,SG
1990,26,3,20,4,6,0,0,4,6,2,2,4,2,6,0,1,0,1,2,10,SG
1990,24,79,2522,540,1089,4,15,536,1074,256,317,109,238,347,225,88,63,120,216,1340,SG
1990,23,79,1326,250,514,0,14,250,500,130,174,49,102,151,116,55,13,95,145,630,SG
1990,31,3,40,4,8,0,1,4,7,4,7,5,3,8,2,1,0,0,8,12,C
1990,30,21,123,30,53,0,0,30,53,9,16,8,10,18,11,3,0,20,12,69,SG
1990,30,2,10,1,2,0,0,1,2,0,0,0,0,0,0,0,0,4,3,2,SG
1990,30,19,113,29,51,0,0,29,51,9,16,8,10,18,11,3,0,16,9,67,SG
1990,25,80,1943,305,663,47,137,258,526,75,103,98,300,398,168,58,88,109,211,732,PF
1990,25,28,590,94,202,1,16,93,186,21,26,21,89,110,62,14,22,45,66,210,PF
1990,25,52,1353,211,461,46,121,165,340,54,77,77,211,288,106,44,66,64,145,522,PF
1990,23,81,1856,257,532,0,3,257,529,172,241,156,246,402,96,91,38,139,300,686,PF
1990,33,48,1030,174,384,10,29,164,355,46,55,26,57,83,85,45,5,75,66,404,SG
1990,30,80,1744,73,229,2,9,71,220,39,54,41,122,163,337,73,4,63,114,187,PG
1990,36,49,938,109,291,26,87,83,204,42,55,19,71,90,238,45,2,85,59,286,PG
1990,31,75,2271,313,630,2,9,311,621,183,256,167,401,568,98,44,103,104,251,811,PF
1990,24,73,2244,296,698,19,80,277,618,198,260,144,286,430,188,100,32,82,177,809,SG
1990,28,75,2567,781,1592,1,6,780,1586,257,293,54,152,206,243,48,6,125,116,1820,SG
1990,26,82,3122,914,1627,16,43,898,1584,696,913,232,679,911,226,121,50,304,259,2540,PF
1990,34,81,2735,517,1077,1,9,516,1068,493,631,364,448,812,130,47,84,232,158,1528,C
1990,23,71,2269,440,826,0,5,440,821,274,370,142,280,422,187,91,39,188,261,1154,PF
1990,23,24,162,16,58,0,2,16,56,19,29,15,9,24,11,7,1,14,16,51,SG
1990,25,75,1695,289,557,10,39,279,518,317,403,84,137,221,121,94,7,137,230,905,SG
1990,23,69,1351,170,414,2,15,168,399,91,129,78,81,159,44,41,16,47,97,433,SG
1990,23,21,108,14,40,0,0,14,40,9,15,11,23,34,7,2,2,11,20,37,PF
1990,30,1,13,1,3,0,1,1,2,2,2,0,0,0,5,0,0,0,0,4,PG
1990,24,79,1987,275,627,28,105,247,522,136,211,50,178,228,296,84,10,143,148,714,SG
1990,24,49,1118,133,306,15,52,118,254,59,95,35,106,141,146,42,5,71,79,340,SG
1990,24,30,869,142,321,13,53,129,268,77,116,15,72,87,150,42,5,72,69,374,SG
1990,25,10,62,7,21,0,0,7,21,12,14,4,8,12,6,2,2,6,7,26,SF
1990,22,13,65,8,26,0,0,8,26,6,8,1,5,6,2,3,1,1,11,22,SF
1990,22,44,413,45,144,13,40,32,104,15,19,12,30,42,45,19,3,36,56,118,SF
1990,27,18,116,10,29,0,0,10,29,10,19,8,19,27,3,3,1,10,24,30,C
1990,28,82,3238,537,1043,11,42,526,1001,273,348,192,477,669,377,60,70,174,176,1358,SF
1990,26,69,2432,611,1233,5,17,606,1216,244,333,165,282,447,171,73,36,187,231,1471,SF
1990,30,14,280,42,87,8,23,34,64,10,21,11,25,36,16,8,1,14,28,102,SF
1990,32,82,2722,648,1181,23,69,625,1112,393,440,201,476,677,172,30,157,183,250,1712,PF
1990,23,80,2748,468,949,3,23,465,926,315,403,170,319,489,187,87,81,192,247,1254,SF
1990,25,7,104,8,32,0,1,8,31,2,4,4,8,12,7,6,1,7,15,18,SG
1990,25,82,2338,207,438,11,31,196,407,98,153,127,276,403,598,140,37,187,289,523,SG
1990,30,33,190,38,86,0,0,38,86,26,40,22,41,63,3,2,1,21,31,102,C
1990,26,26,148,19,44,0,0,19,44,17,23,7,23,30,7,4,3,9,12,55,PF
1990,24,82,3192,661,1287,150,362,511,925,544,627,95,200,295,311,110,18,222,175,2016,SG
1990,26,80,2414,372,834,0,9,372,825,268,349,180,282,462,89,66,54,96,301,1012,PF
1990,33,38,449,63,150,0,1,63,149,25,36,27,72,99,17,8,10,26,76,151,C
1990,31,53,516,47,126,8,34,39,92,16,27,16,36,52,82,32,3,39,55,118,PG
1990,24,80,2449,449,1065,61,193,388,872,228,316,194,228,422,143,130,79,185,219,1187,SF
1990,22,36,153,23,68,2,7,21,61,24,30,7,13,20,11,2,0,23,20,72,SG
1990,22,37,402,48,161,7,30,41,131,43,62,7,25,32,67,18,4,51,30,146,SG
1990,26,78,2830,682,1272,87,234,595,1038,505,568,130,333,463,319,123,45,239,142,1956,SF
1990,26,82,2493,260,552,16,43,244,509,144,203,207,357,564,106,76,60,61,229,680,C
1990,26,52,751,89,225,0,7,89,218,66,100,33,63,96,135,35,11,76,109,244,SG
1990,26,24,208,15,45,0,1,15,44,16,31,10,18,28,35,15,2,18,39,46,SG
1990,26,28,543,74,180,0,6,74,174,50,69,23,45,68,100,20,9,58,70,198,SG
1990,30,62,2065,412,807,1,1,411,806,186,239,162,354,516,161,54,122,110,185,1011,PF
1990,33,14,164,20,31,0,0,20,31,17,22,10,25,35,9,1,0,5,14,57,SF
1990,29,46,503,37,70,0,2,37,68,30,41,46,92,138,28,16,4,17,67,104,PF
1990,30,3,9,2,2,0,0,2,2,0,0,0,3,3,1,0,1,2,3,4,C
1990,26,80,2277,374,786,45,142,329,644,239,299,60,131,191,180,95,22,143,254,1032,SF
1990,31,38,314,38,91,0,1,38,90,14,30,22,39,61,6,4,18,12,45,90,C
1990,22,20,109,14,39,0,0,14,39,11,16,8,18,26,5,3,1,7,15,39,SF
1990,25,70,2334,484,949,7,16,477,933,153,242,143,327,470,160,78,59,190,196,1128,SF
1990,26,61,2196,336,641,0,3,336,638,217,285,258,469,727,146,64,16,165,220,889,PF
1990,27,82,3124,806,1609,1,6,805,1603,382,536,299,850,1149,234,174,376,316,314,1995,C
1990,32,6,45,3,6,0,0,3,6,3,7,4,12,16,1,2,3,4,9,9,C
1990,32,3,36,1,3,0,0,1,3,2,5,4,11,15,0,2,3,3,6,4,C
1990,32,3,9,2,3,0,0,2,3,1,2,0,1,1,1,0,0,1,3,5,C
1990,26,13,64,19,42,1,2,18,40,3,5,8,7,15,7,2,1,5,15,42,PF
1990,36,79,2396,505,871,0,0,505,871,233,312,259,537,796,103,38,69,169,189,1243,C
1990,23,28,181,27,79,0,1,27,78,18,22,15,15,30,10,3,7,21,37,72,SF
1990,32,72,1283,191,422,5,20,186,402,73,90,24,53,77,137,33,5,54,115,460,PG
1990,29,82,2365,365,708,33,92,332,616,56,68,27,92,119,335,83,6,85,176,819,PG
1990,23,35,216,47,108,4,10,43,98,16,18,11,15,26,10,7,6,20,37,114,SF
1990,24,77,884,111,268,0,5,111,263,72,104,88,126,214,46,19,26,65,150,294,C
1990,28,76,2668,435,883,6,28,429,855,330,424,209,363,572,175,88,64,148,225,1206,SF
1990,24,60,612,100,195,1,1,99,194,53,90,79,73,152,17,21,22,47,76,254,C
1990,25,77,2714,605,1242,94,253,511,989,211,270,126,319,445,230,53,20,170,217,1515,SF
1990,27,43,592,60,141,0,1,60,140,52,73,49,111,160,23,17,20,36,103,172,C
1990,25,77,967,207,427,34,74,173,353,135,160,50,61,111,116,23,2,96,134,583,SG
1990,30,59,1709,503,987,46,133,457,854,307,366,64,103,167,133,50,7,129,158,1359,SG
1990,26,77,1082,135,249,0,1,135,248,92,119,93,132,225,68,34,42,56,126,362,PF
1990,24,82,3148,562,1150,28,112,534,1038,199,295,150,397,547,444,211,101,278,298,1351,SF
1990,25,79,1085,156,289,1,2,155,287,47,99,128,172,300,15,25,21,35,187,360,C
1990,26,80,2781,448,969,89,238,359,731,421,472,59,213,272,726,151,4,245,150,1406,PG
1990,31,57,1400,239,506,6,43,233,463,144,190,59,113,172,244,71,23,109,149,628,SG
1990,26,72,1603,240,566,46,148,194,418,110,141,94,215,309,149,58,36,88,148,636,SF
1990,25,73,2706,489,1066,152,374,337,692,300,338,66,185,251,666,114,5,214,89,1430,PG
1990,23,31,193,19,58,0,2,19,56,2,3,9,19,28,11,3,4,4,27,40,SG
1990,31,74,1904,190,373,0,3,190,370,82,127,156,369,525,135,100,37,104,208,462,PF
1990,31,16,448,58,116,0,1,58,115,30,55,48,72,120,28,32,10,29,45,146,PF
1990,31,58,1456,132,257,0,2,132,255,52,72,108,297,405,107,68,27,75,163,316,PF
1990,27,81,1995,445,895,0,1,445,894,111,134,174,420,594,82,40,104,75,300,1001,C
1990,21,82,2757,358,814,0,5,358,809,192,289,199,492,691,101,92,54,172,292,908,C
1990,34,72,1202,175,447,10,32,165,415,54,86,34,117,151,90,38,16,45,153,414,SF
1990,34,12,85,13,33,1,3,12,30,4,8,1,7,8,8,2,2,1,17,31,SF
1990,34,60,1117,162,414,9,29,153,385,50,78,33,110,143,82,36,14,44,136,383,SF
1990,27,67,1817,309,741,1,14,308,727,239,322,91,232,323,180,93,64,139,162,858,SF
1990,22,77,2311,470,1071,17,69,453,1002,91,124,100,252,352,138,67,27,113,198,1048,SF
1990,23,82,2581,426,925,23,83,403,842,63,107,55,162,217,554,133,25,141,143,938,PG
1990,24,78,2799,640,1287,34,95,606,1192,406,469,98,262,360,223,98,24,201,210,1720,SG
1990,25,52,724,80,197,0,5,80,192,59,78,30,55,85,155,31,0,88,53,219,PG
1990,28,48,1526,218,480,24,66,194,414,138,170,47,153,200,264,116,22,98,151,598,PG
1990,29,82,2235,330,666,2,11,328,655,195,249,107,204,311,147,56,25,130,210,857,PF
1990,27,81,2599,476,946,4,26,472,920,197,266,230,329,559,445,207,17,217,280,1153,SG
1990,23,82,1565,298,751,12,44,286,707,138,251,110,198,308,72,53,53,129,226,746,PF
1990,24,82,3002,690,1300,0,2,690,1298,613,837,303,680,983,164,138,319,257,259,1993,C
1990,28,82,2377,288,496,1,9,287,487,142,217,336,456,792,72,52,60,90,276,719,SF
1990,34,48,674,57,125,0,1,57,124,11,16,58,95,153,24,13,53,35,83,125,C
1990,22,42,412,37,86,0,1,37,85,7,14,44,76,120,20,8,13,16,70,81,C
1990,26,71,1061,159,420,18,52,141,368,150,201,34,78,112,115,51,6,85,144,486,SF
1990,29,14,112,14,32,0,0,14,32,22,26,17,12,29,5,1,2,10,19,50,PF
1990,24,44,559,78,179,1,2,77,177,68,83,44,87,131,22,18,11,25,58,225,PF
1990,23,66,746,117,255,0,1,117,254,153,197,69,68,137,43,32,8,81,107,387,SF
1990,27,77,850,111,259,16,56,95,203,35,53,12,43,55,177,22,1,88,81,273,PG
1990,25,82,1914,209,408,1,4,208,404,174,244,154,285,439,67,51,153,97,282,593,PF
1990,29,26,417,48,129,1,4,47,125,12,23,11,73,84,28,14,22,34,66,109,C
1990,24,31,182,13,40,0,0,13,40,2,4,17,22,39,9,4,4,15,27,28,PF
1990,29,82,1531,225,479,5,14,220,465,55,75,78,152,230,89,43,23,79,220,510,SF
1990,30,53,1194,163,330,0,4,163,326,225,264,117,225,342,61,41,45,72,200,551,C
1990,27,78,2573,424,822,17,48,407,774,402,490,149,471,620,247,59,16,180,271,1267,PF
1990,28,77,2593,472,1005,93,220,379,785,160,209,51,191,242,274,77,31,122,180,1197,SG
1990,24,74,2409,486,968,0,1,486,967,256,431,253,513,766,78,78,124,236,258,1228,C
1990,27,59,700,103,254,0,5,103,249,58,73,39,50,89,33,17,22,46,74,264,PF
1990,27,45,587,84,198,0,3,84,195,49,61,31,39,70,32,11,19,34,63,217,PF
1990,27,14,113,19,56,0,2,19,54,9,12,8,11,19,1,6,3,12,11,47,PF
1990,23,70,1557,247,535,0,1,247,534,79,115,180,299,479,56,40,35,116,183,573,C
1990,25,14,51,4,14,0,0,4,14,2,6,4,9,13,1,1,2,2,10,10,C
1990,32,82,2213,432,950,10,35,422,915,198,237,101,147,248,145,66,20,119,202,1072,SF
1990,26,3,18,0,4,0,1,0,3,0,0,0,0,0,2,1,1,2,2,0,PG
1990,33,35,496,50,125,3,12,47,113,18,22,3,16,19,94,16,2,22,40,121,PG
1990,33,34,469,50,119,3,12,47,107,15,18,3,16,19,92,16,2,22,39,118,PG
1990,33,1,27,0,6,0,0,0,6,3,4,0,0,0,2,0,0,0,1,3,PG
1990,34,71,2250,344,827,68,199,276,628,230,260,109,383,492,229,76,48,139,244,986,C
1990,25,70,1460,190,464,52,132,138,332,104,119,23,136,159,334,36,4,90,126,536,PG
1990,22,60,519,59,133,0,7,59,126,53,76,14,55,69,103,35,3,36,75,171,PG
1990,24,78,2732,595,1145,1,12,594,1133,454,572,177,347,524,114,86,119,162,294,1645,PF
1990,28,75,1405,261,514,16,36,245,478,130,186,62,110,172,109,35,20,85,198,668,SF
1990,24,79,2421,378,811,26,83,352,728,161,196,18,139,157,445,79,8,169,143,943,PG
1990,24,46,1747,280,607,22,59,258,548,106,131,11,109,120,303,57,7,122,98,688,PG
1990,24,33,674,98,204,4,24,94,180,55,65,7,30,37,142,22,1,47,45,255,PG
1990,32,74,1300,101,213,0,2,101,211,20,55,180,272,452,69,56,28,70,203,222,PF
1990,24,65,620,136,286,2,28,134,258,53,64,40,60,100,79,9,1,54,51,327,PF
1990,26,65,1644,348,708,10,40,338,668,169,222,117,183,300,147,76,57,102,174,875,SF
1990,23,82,2404,515,967,0,1,515,966,241,297,135,377,512,142,45,169,143,328,1271,C
1990,27,13,107,10,24,0,0,10,24,1,6,11,23,34,1,4,11,9,18,21,C
1990,31,82,1756,210,510,8,40,202,470,59,77,37,101,138,298,49,4,99,140,487,PG
1990,27,78,2915,472,918,47,113,425,805,354,432,57,149,206,1134,207,18,272,233,1345,PG
1990,26,11,34,1,9,0,0,1,9,2,2,2,3,5,0,0,0,3,8,4,PF
1990,23,82,2140,343,756,8,30,335,726,174,278,90,169,259,468,127,14,170,160,868,PG
1990,23,51,1019,170,386,6,21,164,365,83,130,43,83,126,219,70,8,85,71,429,PG
1990,23,31,1121,173,370,2,9,171,361,91,148,47,86,133,249,57,6,85,89,439,PG
1990,28,63,867,148,363,44,100,104,263,44,52,15,56,71,102,25,0,52,69,384,SG
1990,25,45,1648,314,696,0,6,314,690,130,172,189,400,589,67,79,70,117,160,758,PF
1990,22,17,114,21,52,3,13,18,39,6,9,5,6,11,5,5,3,10,9,51,SG
1990,23,10,37,0,6,0,1,0,5,11,16,4,8,12,1,0,0,5,4,11,PF
1990,29,82,2376,538,1122,3,14,535,1108,244,294,114,253,367,155,91,15,144,231,1323,SF
1990,32,76,2350,517,1178,26,105,491,1073,378,443,75,146,221,407,60,12,226,194,1438,SG
1990,28,81,2993,579,1322,42,136,537,1186,292,377,74,234,308,765,139,19,322,206,1492,PG
1990,26,79,2142,375,727,2,4,373,723,115,185,238,313,551,166,54,89,156,237,867,SF
1990,28,82,2126,223,471,1,5,222,466,107,134,175,455,630,106,65,71,150,313,554,C
1990,35,70,1883,281,562,0,0,281,562,144,204,173,304,477,43,33,73,79,207,706,C
1990,27,56,592,48,112,1,3,47,109,26,51,45,88,133,17,20,12,35,105,123,PF
1990,27,82,2947,547,998,0,10,547,988,307,446,258,476,734,261,66,24,229,270,1401,PF
1990,28,65,1481,303,599,8,32,295,567,130,157,43,72,115,216,65,8,77,164,744,PG
1990,25,79,2937,726,1383,0,6,726,1377,306,391,185,410,595,108,54,54,153,251,1758,PF
1990,24,70,1347,218,442,5,18,213,424,175,241,122,241,363,58,23,25,79,191,616,PF
1990,27,64,968,87,250,23,63,64,187,67,83,14,46,60,174,33,0,73,106,264,PG
1990,27,32,286,30,72,7,13,23,59,21,25,3,11,14,52,10,0,21,35,88,PG
1990,27,32,682,57,178,16,50,41,128,46,58,11,35,46,122,23,0,52,71,176,PG
1990,30,79,2404,442,1029,38,104,404,925,310,351,82,240,322,224,75,16,176,220,1232,SF
1990,30,81,1725,253,606,95,245,158,361,66,86,57,117,174,173,74,8,73,159,667,SG
1990,25,11,115,11,38,0,2,11,36,4,4,4,4,8,23,8,0,12,6,26,PG
1990,25,3,31,2,13,0,1,2,12,0,0,3,2,5,3,1,0,4,1,4,PG
1990,25,8,84,9,25,0,1,9,24,4,4,1,2,3,20,7,0,8,5,22,PG
1990,23,36,315,58,122,0,3,58,119,40,65,22,28,50,22,17,7,26,40,156,PF
1990,27,60,1105,132,308,2,10,130,298,42,54,52,175,227,53,23,12,61,161,308,PF
1990,29,59,818,110,209,0,2,110,207,56,71,88,133,221,27,15,47,45,135,276,C
1990,27,40,387,64,146,4,15,60,131,28,37,9,32,41,54,27,1,27,53,160,SG
1990,27,14,131,12,39,2,5,10,34,4,6,3,10,13,28,2,1,12,19,30,SG
1990,27,3,4,1,3,0,1,1,2,0,0,0,0,0,0,0,0,0,0,2,SG
1990,27,23,252,51,104,2,9,49,95,24,31,6,22,28,26,25,0,15,34,128,SG
1990,31,22,563,102,231,10,19,92,212,44,48,15,38,53,41,15,3,26,28,258,SF
1990,30,41,459,86,183,1,2,85,181,41,49,20,42,62,18,18,5,33,52,214,SF
1990,30,17,259,45,105,1,1,44,104,33,37,13,23,36,8,10,2,14,23,124,SF
1990,30,24,200,41,78,0,1,41,77,8,12,7,19,26,10,8,3,19,29,90,SF
1990,26,63,1657,258,564,1,14,257,550,188,214,37,157,194,354,65,20,132,108,705,PG
1990,24,1,4,1,3,0,0,1,3,0,0,2,0,2,0,0,0,0,0,2,PF
1990,25,72,937,137,284,13,34,124,250,70,120,52,67,119,83,36,22,52,166,357,C
1990,28,81,2883,316,696,2,21,314,675,138,201,173,541,714,652,139,30,173,220,772,PG
1990,25,68,1595,204,384,2,5,202,379,125,173,131,212,343,49,33,52,60,178,535,PF
1990,26,82,2184,294,616,1,19,293,597,162,186,38,163,201,477,105,12,141,185,751,PG
1990,26,27,198,23,61,0,0,23,61,19,25,18,30,48,9,6,8,15,58,65,C
1990,26,13,56,7,23,0,0,7,23,1,2,7,5,12,5,1,0,6,21,15,C
1990,26,14,142,16,38,0,0,16,38,18,23,11,25,36,4,5,8,9,37,50,C
1990,26,60,814,105,234,0,4,105,230,60,75,64,134,198,41,20,21,50,144,270,C
1990,22,52,378,53,135,3,11,50,124,26,32,24,46,70,18,10,6,31,61,135,SG
1990,29,82,2399,331,530,0,0,331,530,199,288,212,516,728,45,36,184,126,277,861,C
1990,22,55,707,93,252,1,14,92,238,50,89,78,95,173,21,24,6,47,124,237,PF
1990,30,66,1852,416,853,0,3,416,850,192,237,133,153,286,104,85,1,87,165,1024,SG
1990,23,40,638,92,208,17,46,75,162,28,38,13,39,52,114,45,3,63,65,229,PG
1990,30,80,2888,810,1672,59,183,751,1489,459,569,217,304,521,200,126,47,174,141,2138,SF
1990,27,79,972,141,310,0,2,141,308,89,147,114,151,265,16,18,18,73,152,371,C
1990,26,82,2609,472,1032,39,125,433,907,208,259,133,238,371,330,95,21,194,188,1191,SG
1990,29,82,2801,413,754,0,1,413,753,288,408,250,550,800,116,69,39,168,285,1114,PF
1990,31,81,2199,295,665,2,9,293,656,108,159,76,315,391,119,51,106,106,243,700,C
1990,27,82,2776,528,1070,0,0,528,1070,325,440,220,443,663,168,86,167,143,214,1381,PF
1990,23,18,632,130,274,2,18,128,256,65,84,27,109,136,84,21,9,43,33,327,SF
1990,23,28,329,60,119,0,3,60,116,36,46,12,20,32,81,22,1,33,39,156,PG
1990,23,6,26,2,10,0,0,2,10,1,2,1,0,1,4,0,0,5,0,5,PG
1990,23,22,303,58,109,0,3,58,106,35,44,11,20,31,77,22,1,28,39,151,PG
1990,26,16,88,6,14,0,1,6,13,3,6,5,17,22,2,3,7,3,28,15,PF
1990,26,5,14,0,4,0,0,0,4,0,0,0,1,1,0,0,0,0,2,0,SF
1990,25,47,743,131,338,6,37,125,301,52,68,28,55,83,53,32,14,45,102,320,SF
1990,25,5,133,21,57,0,5,21,52,18,21,8,7,15,10,9,1,9,7,60,SF
1990,25,32,542,91,239,6,27,85,212,30,41,17,43,60,38,22,10,32,79,218,SF
1990,25,10,68,19,42,0,5,19,37,4,6,3,5,8,5,1,3,4,16,42,SF
1990,27,81,2273,418,805,2,7,416,798,168,246,253,392,645,57,63,47,144,259,1006,PF
1990,26,78,1856,220,491,0,13,220,478,87,112,62,133,195,208,89,18,127,154,527,SG
1990,30,61,544,62,122,1,2,61,120,5,6,4,26,30,39,7,4,23,21,130,SF
1990,25,77,1325,155,392,5,25,150,367,55,71,63,169,232,62,30,24,77,129,370,C
1990,27,28,200,16,49,4,21,12,28,14,16,1,11,12,47,6,0,8,16,50,SG
1990,31,61,972,160,405,12,41,148,364,62,86,25,63,88,66,42,11,49,100,394,SG
1990,30,62,1421,306,550,0,5,306,545,176,240,49,136,185,96,39,46,73,160,788,SF
1990,24,6,16,2,3,0,0,2,3,2,2,0,3,3,2,3,0,0,3,6,PG
1990,28,80,2960,711,1298,15,49,696,1249,248,317,160,318,478,288,99,49,160,190,1685,SF
1990,27,82,1393,138,328,16,59,122,269,91,112,29,93,122,231,82,4,80,84,383,PG
1990,29,45,459,92,194,8,26,84,168,27,38,36,50,86,24,25,3,15,47,219,SF
1991,22,43,290,55,116,0,0,55,116,25,44,27,62,89,12,4,12,22,39,135,PF
1991,21,67,1505,417,1009,24,100,393,909,84,98,34,87,121,206,55,4,110,149,942,PG
1991,28,68,1313,109,214,1,3,108,211,66,101,140,219,359,25,25,25,42,218,285,C
1991,28,66,2346,560,1421,167,564,393,857,465,529,58,198,256,693,147,6,240,162,1752,PG
1991,31,78,2006,420,909,24,78,396,831,240,317,134,240,374,139,47,20,128,209,1104,SF
1991,31,80,1710,337,714,102,251,235,463,114,138,45,160,205,285,63,13,100,195,890,SG
1991,27,42,587,99,225,5,21,94,204,41,48,41,76,117,45,15,8,40,88,244,PF
1991,26,34,236,59,117,7,23,52,94,26,31,10,14,24,22,8,1,16,11,151,PG
1991,26,68,924,116,270,0,1,116,269,60,115,97,221,318,16,35,45,84,140,292,PF
1991,26,26,247,27,73,0,1,27,72,16,28,26,49,75,3,8,9,22,29,70,PF
1991,26,1,18,4,4,0,0,4,4,0,0,4,2,6,1,2,0,1,4,8,PF
1991,26,41,659,85,193,0,0,85,193,44,87,67,170,237,12,25,36,61,107,214,PF
1991,23,70,1971,400,857,17,58,383,799,173,259,92,294,386,106,74,44,113,145,990,SG
1991,32,82,2340,512,1055,9,43,503,1012,165,198,103,264,367,115,65,13,100,163,1198,SF
1991,24,75,2592,453,991,7,35,446,956,170,213,68,283,351,358,79,46,167,226,1083,SG
1991,23,67,877,144,263,0,0,144,263,91,127,122,131,253,25,27,7,32,125,379,SF
1991,23,82,1731,304,632,15,30,289,602,97,111,25,124,149,301,70,4,107,118,720,PG
1991,24,7,85,12,25,0,0,12,25,9,11,7,4,11,13,2,0,6,21,33,SG
1991,23,39,266,34,81,6,25,28,56,12,25,30,38,68,19,16,13,11,46,86,SF
1991,22,12,52,6,19,0,0,6,19,7,12,6,3,9,4,1,1,5,7,19,PF
1991,29,82,2486,399,872,0,3,399,869,219,271,101,306,407,124,53,91,130,160,1017,PF
1991,22,7,26,3,8,0,0,3,8,2,2,5,6,11,0,0,2,2,5,8,PF
1991,30,47,339,43,81,0,1,43,80,25,65,34,62,96,9,5,7,25,73,111,PF
1991,27,67,2498,665,1167,44,155,621,1012,475,658,258,422,680,284,110,33,210,173,1849,SF
1991,23,66,750,154,311,32,81,122,230,78,85,17,54,71,111,23,1,54,40,418,PG
1991,28,79,1863,397,862,14,49,383,813,270,316,34,125,159,217,45,6,113,145,1078,SG
1991,26,56,945,133,282,3,24,130,258,70,93,83,93,176,62,60,18,53,108,339,SG
1991,26,16,263,38,86,0,2,38,84,20,29,21,32,53,15,19,6,17,25,96,SG
1991,26,40,682,95,196,3,22,92,174,50,64,62,61,123,47,41,12,36,83,243,SG
1991,27,60,562,106,242,5,13,101,229,55,78,55,76,131,32,2,36,32,76,272,C
1991,26,70,2236,386,778,0,0,386,778,210,295,157,566,723,119,54,145,235,184,982,C
1991,26,39,1337,229,465,0,0,229,465,123,169,95,374,469,74,26,91,138,110,581,C
1991,26,31,899,157,313,0,0,157,313,87,126,62,192,254,45,28,54,97,74,401,C
1991,25,27,334,40,107,0,0,40,107,35,47,30,34,64,28,8,2,20,50,115,SF
1991,34,60,2277,462,1017,77,198,385,819,163,183,53,456,509,431,108,58,187,118,1164,SF
1991,31,80,2965,634,1316,40,114,594,1202,282,326,63,193,256,301,69,19,159,153,1590,SG
1991,24,38,214,26,61,2,16,24,45,10,14,4,16,20,26,9,2,18,35,64,SG
1991,23,72,2585,432,1039,14,91,418,948,139,176,67,182,249,441,169,40,207,180,1017,PG
1991,26,81,2299,241,524,0,12,241,512,86,108,58,158,216,669,137,3,120,160,568,PG
1991,28,82,1522,65,164,1,14,64,150,24,41,66,284,350,20,16,247,63,184,155,C
1991,22,34,750,103,230,0,0,103,230,44,76,59,102,161,49,39,5,41,62,250,PF
1991,29,62,1916,314,723,4,22,310,701,169,231,176,304,480,147,43,90,141,175,801,C
1991,30,73,1505,197,435,0,0,197,435,35,79,114,231,345,73,35,80,69,132,429,C
1991,31,75,1912,372,706,0,2,372,704,198,248,129,297,426,131,86,43,160,255,942,PF
1991,25,80,980,159,370,45,135,114,235,61,72,28,44,72,204,53,5,51,122,424,PG
1991,22,74,1485,263,502,0,4,263,498,101,144,78,135,213,80,26,24,94,130,627,SF
1991,22,82,1945,284,612,7,34,277,578,137,157,41,141,182,344,83,14,137,161,712,PG
1991,27,82,1391,129,284,0,0,129,284,132,178,109,228,337,49,29,24,82,166,390,C
1991,30,7,27,2,3,1,1,1,2,0,0,0,4,4,3,0,0,4,8,5,SF
1991,30,23,267,28,77,2,11,26,66,20,23,24,15,39,13,4,0,12,39,78,SG
1991,25,53,781,99,203,0,1,99,202,74,101,65,125,190,27,15,12,33,120,272,PF
1991,22,74,859,94,226,1,4,93,222,43,66,61,80,141,51,33,15,26,79,232,SF
1991,23,18,63,14,31,0,3,14,28,11,17,6,8,14,2,3,0,3,10,39,PF
1991,22,76,1928,341,773,4,30,337,743,229,293,111,151,262,107,72,24,144,275,915,SF
1991,24,9,37,5,19,0,0,5,19,4,6,8,8,16,1,0,0,4,9,14,C
1991,29,82,2141,226,445,0,3,226,442,70,112,177,381,558,89,85,58,83,194,522,C
1991,24,42,343,35,83,0,1,35,82,7,17,43,57,100,8,19,10,30,35,77,PF
1991,24,64,678,75,192,0,2,75,190,55,79,25,53,78,61,22,7,51,98,205,SG
1991,22,52,380,56,123,0,0,56,123,32,49,40,56,96,10,11,38,16,71,144,PF
1991,28,77,2893,652,1502,16,61,636,1441,358,446,161,185,346,214,121,48,190,204,1678,SG
1991,29,77,2527,628,1228,0,3,628,1225,295,389,163,257,420,191,45,101,171,315,1551,PF
1991,32,11,96,13,36,0,0,13,36,11,12,3,21,24,11,1,8,12,18,37,C
1991,33,79,2273,318,649,0,0,318,649,124,178,167,319,486,126,32,15,113,167,760,C
1991,27,51,1459,292,632,0,5,292,627,161,258,168,187,355,58,34,9,107,113,745,PF
1991,22,76,1719,210,413,0,0,210,413,105,165,141,250,391,69,49,148,96,225,525,C
1991,21,63,730,204,419,1,6,203,413,110,166,77,73,150,35,22,5,69,70,519,SF
1991,31,76,2475,556,1271,20,73,536,1198,379,459,104,386,490,194,65,52,177,235,1511,PF
1991,23,70,2100,410,922,48,148,362,774,234,282,45,146,191,250,73,16,131,167,1102,PG
1991,34,76,2147,241,483,5,20,236,463,105,129,22,151,173,435,128,10,108,138,592,PG
1991,23,18,110,17,46,0,0,17,46,9,16,11,7,18,2,3,1,6,16,43,SF
1991,25,52,320,28,75,0,1,28,74,12,22,42,37,79,3,6,4,5,45,68,SF
1991,23,74,2602,514,1100,13,38,501,1062,323,442,269,490,759,163,71,99,217,217,1364,PF
1991,22,82,1355,162,393,6,34,156,359,71,95,56,97,153,232,65,12,98,149,401,PG
1991,28,19,251,23,56,5,14,18,42,7,10,5,21,26,37,11,1,11,27,58,PG
1991,31,74,1008,96,207,0,5,96,202,68,94,21,91,112,165,85,2,58,75,260,PG
1991,31,35,489,58,111,0,2,58,109,29,42,11,46,57,58,37,1,27,38,145,PG
1991,31,39,519,38,96,0,3,38,93,39,52,10,45,55,107,48,1,31,37,115,PG
1991,23,58,1121,118,283,0,3,118,280,71,129,134,192,326,26,35,72,50,100,307,PF
1991,34,67,746,57,145,0,1,57,144,33,42,54,134,188,22,7,61,22,120,147,C
1991,28,82,3196,587,1311,2,10,585,1301,296,371,185,404,589,347,162,53,209,257,1472,SF
1991,34,28,147,17,38,0,0,17,38,13,22,10,23,33,4,5,5,2,18,47,C
1991,34,4,26,4,6,0,0,4,6,7,10,3,2,5,0,0,0,2,8,15,PF
1991,29,67,2195,503,1039,7,33,496,1006,164,240,194,327,521,157,61,30,131,225,1177,PF
1991,33,9,159,8,24,0,1,8,23,1,3,6,30,36,3,0,3,6,16,17,PF
1991,26,76,1515,337,715,32,86,305,629,96,114,47,152,199,166,75,25,80,125,802,SG
1991,30,30,299,73,155,0,1,73,154,38,62,11,21,32,16,7,1,19,25,184,SG
1991,34,10,126,19,50,1,3,18,47,18,26,8,5,13,9,5,0,6,8,57,SF
1991,25,76,2946,605,1155,0,3,605,1152,435,579,177,653,830,253,74,46,211,191,1645,C
1991,35,80,1426,159,373,22,85,137,288,91,118,13,105,118,230,45,17,77,212,431,PG
1991,23,55,996,115,236,1,2,114,234,69,124,107,159,266,39,18,28,36,129,300,PF
1991,36,71,1483,403,862,11,36,392,826,107,117,71,110,181,125,80,3,88,150,924,SG
1991,36,39,1044,316,667,10,33,306,634,86,94,52,71,123,84,62,3,63,108,728,SG
1991,36,32,439,87,195,1,3,86,192,21,23,19,39,58,41,18,0,25,42,196,SG
1991,27,4,124,26,41,1,4,25,37,10,11,0,16,16,28,3,0,8,4,63,PG
1991,23,4,17,4,7,1,1,3,6,0,0,2,0,2,0,0,0,1,0,9,SF
1991,23,12,149,14,34,0,0,14,34,8,9,0,12,12,19,2,0,13,15,36,PG
1991,23,10,144,13,33,0,0,13,33,8,9,0,11,11,19,2,0,13,12,34,PG
1991,23,2,5,1,1,0,0,1,1,0,0,0,1,1,0,0,0,0,3,2,PG
1991,22,82,2310,360,637,5,14,355,623,196,279,205,461,666,92,106,127,146,247,921,C
1991,33,82,2800,327,615,0,0,327,615,165,229,201,526,727,69,34,93,146,181,819,C
1991,24,73,2562,532,1055,4,31,528,1024,284,414,78,131,209,624,121,5,270,178,1352,PG
1991,28,73,1031,98,194,0,2,98,192,63,105,66,189,255,51,24,29,57,178,259,C
1991,32,48,496,54,125,14,33,40,92,17,22,5,29,34,118,15,1,49,40,139,PG
1991,28,82,2852,645,1338,61,191,584,1147,416,524,212,334,546,493,144,60,232,226,1767,SG
1991,26,81,2511,521,1084,0,2,521,1082,240,311,177,354,531,89,33,34,186,251,1282,C
1991,25,61,1560,170,417,0,0,170,417,94,176,229,282,511,37,39,153,80,217,434,C
1991,27,80,3046,622,1292,14,45,608,1247,371,417,62,125,187,443,89,7,189,135,1629,SG
1991,35,17,217,21,47,1,4,20,43,9,10,20,22,42,24,12,1,7,30,52,SG
1991,24,67,1616,345,762,14,59,331,703,164,222,47,81,128,136,47,10,115,121,868,SG
1991,34,80,2580,169,292,0,0,169,292,71,112,182,485,667,51,39,188,99,298,409,C
1991,25,62,1611,244,464,6,24,238,440,82,117,51,150,201,108,57,29,105,203,576,SF
1991,35,72,1903,383,792,1,2,382,790,215,295,91,186,277,65,12,30,126,249,982,C
1991,25,79,2000,380,927,24,84,356,843,171,213,80,125,205,240,129,46,163,151,955,SG
1991,29,82,2766,344,773,49,149,295,624,95,140,142,246,388,376,121,34,160,209,832,SG
1991,27,3,20,2,7,1,2,1,5,1,2,0,1,1,1,0,0,3,2,6,SG
1991,27,30,624,77,152,3,8,74,144,74,87,46,63,109,44,19,10,27,83,231,SF
1991,22,82,3044,478,976,20,64,458,912,325,402,142,314,456,238,69,33,147,190,1301,SF
1991,30,51,1424,340,718,57,157,283,561,120,166,66,107,173,95,49,8,81,112,857,SG
1991,30,30,800,181,391,27,89,154,302,62,84,28,64,92,64,33,3,49,59,451,SG
1991,30,21,624,159,327,30,68,129,259,58,82,38,43,81,31,16,5,32,53,406,SG
1991,23,76,1942,326,636,0,6,326,630,139,214,224,361,585,102,49,157,146,268,791,C
1991,23,70,1443,251,572,3,31,248,541,111,157,66,81,147,177,25,15,114,127,616,SG
1991,37,79,1748,322,734,0,1,322,733,119,140,108,146,254,105,40,25,101,141,763,SF
1991,28,81,3104,845,1645,0,6,845,1639,464,623,194,711,905,244,80,258,291,287,2154,C
1991,26,27,456,101,223,5,23,96,200,48,65,29,39,68,38,13,2,38,58,255,SG
1991,26,2,13,2,7,0,1,2,6,2,2,2,3,5,0,0,0,1,0,6,SG
1991,26,25,443,99,216,5,22,94,194,46,63,27,36,63,38,13,2,37,58,249,SG
1991,28,52,372,52,140,0,3,52,137,33,44,29,71,100,8,3,12,25,52,137,C
1991,25,78,1165,174,356,2,3,172,353,125,156,97,82,179,55,33,27,78,151,475,SF
1991,24,81,1661,275,643,23,77,252,566,124,152,99,187,286,142,43,25,120,230,697,PF
1991,28,69,1929,356,671,4,18,352,653,161,221,83,131,214,369,76,13,137,116,877,PG
1991,30,82,1850,386,939,48,176,338,763,185,246,52,107,159,317,95,17,140,122,1005,PG
1991,22,54,606,97,211,0,5,97,206,42,61,52,99,151,37,12,22,45,112,236,PF
1991,26,35,475,67,168,0,0,67,168,43,60,36,48,84,44,22,13,40,50,177,SF
1991,25,10,226,28,70,5,21,23,49,22,26,4,10,14,91,10,2,23,25,83,SG
1991,25,82,2706,548,933,0,7,548,926,185,227,85,182,267,256,100,34,148,237,1281,SF
1991,26,69,1702,221,519,4,26,217,493,118,157,46,152,198,317,97,10,116,189,564,PG
1991,24,67,949,100,236,0,22,100,214,60,79,40,87,127,223,62,2,66,101,260,SG
1991,26,72,1552,243,457,0,2,243,455,164,248,136,243,379,44,48,67,102,211,650,PF
1991,22,56,594,80,193,0,2,80,191,32,40,19,28,47,104,25,5,42,58,192,PG
1991,27,56,743,164,394,7,28,157,366,90,114,40,70,110,30,19,19,45,88,425,PF
1991,22,82,1944,376,836,2,14,374,822,152,182,105,158,263,303,104,39,163,186,906,SG
1991,26,75,2644,487,1001,0,2,487,999,268,329,220,378,598,105,69,53,174,185,1242,PF
1991,26,25,949,195,380,0,0,195,380,104,128,86,148,234,27,34,21,64,65,494,PF
1991,26,50,1695,292,621,0,2,292,619,164,201,134,230,364,78,35,32,110,120,748,PF
1991,23,51,606,149,340,2,17,147,323,52,76,54,48,102,42,28,9,41,76,352,SF
1991,31,80,2196,357,808,2,14,355,794,128,158,186,396,582,93,40,56,85,99,844,C
1991,31,30,791,109,284,1,8,108,276,53,63,71,130,201,33,16,34,31,41,272,C
1991,31,50,1405,248,524,1,6,247,518,75,95,115,266,381,60,24,22,54,58,572,C
1991,23,10,20,5,12,0,1,5,11,3,4,0,2,2,0,1,4,0,5,13,C
1991,30,26,168,30,58,9,17,21,41,10,21,20,30,50,8,2,8,11,33,79,PF
1991,25,68,2105,265,587,9,39,256,548,51,74,69,140,209,587,103,12,210,192,590,PG
1991,24,22,107,10,27,1,3,9,24,5,6,1,9,10,20,9,0,10,12,26,PG
1991,25,77,2842,609,1224,2,15,607,1209,185,249,179,378,557,204,91,61,125,232,1405,PF
1991,25,78,2641,401,733,1,6,400,727,197,277,266,393,659,178,95,69,92,203,1000,PF
1991,27,8,37,4,12,0,0,4,12,3,3,2,8,10,0,0,1,2,6,11,C
1991,25,82,1422,210,485,0,3,210,482,101,147,111,135,246,123,48,9,86,98,521,SG
1991,27,82,2164,258,542,11,55,247,487,223,302,201,315,516,71,59,23,99,117,750,PF
1991,36,79,2248,334,722,8,36,326,686,117,141,33,104,137,413,57,6,108,130,793,PG
1991,30,66,1099,177,384,0,3,177,381,89,105,98,215,313,52,32,13,89,172,443,PF
1991,33,63,1018,85,169,0,2,85,167,69,94,61,160,221,52,29,25,71,172,239,PF
1991,32,75,1005,174,445,48,138,126,307,34,45,17,73,90,37,42,7,48,100,430,SG
1991,24,7,50,8,21,0,2,8,19,1,2,2,2,4,9,3,1,4,4,17,PG
1991,27,78,1178,161,343,0,0,161,343,112,181,140,216,356,31,20,21,63,199,434,PF
1991,23,70,1023,155,336,0,4,155,332,57,79,58,148,206,43,15,7,54,108,367,PF
1991,30,36,811,96,256,19,69,77,187,18,36,33,63,96,90,20,5,34,72,229,SG
1991,24,82,3215,739,1551,97,252,642,1299,306,381,87,245,332,793,214,12,270,228,1881,PG
1991,29,77,2879,572,1226,89,246,483,980,286,391,59,174,233,548,147,14,177,222,1519,PG
1991,27,39,1383,285,729,48,148,237,581,145,217,58,130,188,209,66,35,129,111,763,SG
1991,23,6,41,4,16,0,2,4,14,2,4,0,1,1,0,1,0,3,5,10,SG
1991,30,27,113,16,28,3,4,13,24,13,13,14,14,28,7,0,0,7,23,48,PF
1991,24,80,3110,590,1251,108,270,482,981,479,550,48,262,310,299,178,39,213,182,1767,SG
1991,35,23,392,50,117,7,21,43,96,16,21,8,29,37,62,12,2,28,43,123,PG
1991,22,68,690,79,189,18,54,61,135,38,42,14,37,51,131,32,0,43,83,214,PG
1991,23,7,61,6,10,0,0,6,10,4,7,4,1,5,2,0,2,4,16,16,SF
1991,31,82,2024,259,559,73,220,186,339,185,226,109,245,354,113,52,37,65,198,776,SF
1991,22,50,464,97,212,3,19,94,193,28,33,18,45,63,35,8,1,49,53,225,SF
1991,22,74,1192,147,299,0,0,147,299,96,152,157,226,383,19,33,30,72,264,390,PF
1991,29,9,91,20,39,0,0,20,39,1,3,6,13,19,4,0,3,6,14,41,PF
1991,30,73,843,146,344,44,115,102,229,26,27,10,32,42,97,34,2,35,74,362,SG
1991,26,30,155,24,44,0,2,24,42,16,22,18,21,39,3,3,1,13,29,64,C
1991,26,19,112,18,32,0,1,18,31,8,10,14,16,30,3,2,1,12,18,44,C
1991,26,11,43,6,12,0,1,6,11,8,12,4,5,9,0,1,0,1,11,20,C
1991,25,61,728,104,244,1,5,103,239,55,83,49,60,109,65,25,14,59,79,264,SF
1991,27,80,2733,544,1051,61,146,483,905,201,224,74,247,321,409,111,16,130,185,1350,SG
1991,28,80,2726,482,960,60,161,422,799,191,239,57,163,220,538,129,7,151,237,1215,PG
1991,24,33,316,60,129,1,5,59,124,50,61,24,21,45,24,15,2,16,32,171,SG
1991,25,72,1595,250,508,13,51,237,457,117,160,62,135,197,452,60,9,135,81,630,PG
1991,23,37,202,43,113,5,19,38,94,22,27,9,21,30,27,6,1,20,24,113,SG
1991,25,37,505,112,254,24,60,88,194,52,72,26,53,79,32,15,5,37,59,300,PF
1991,23,21,105,11,36,0,1,11,35,6,9,17,20,37,1,1,3,3,16,28,C
1991,25,68,959,130,277,1,9,129,268,59,87,22,55,77,230,47,4,74,62,320,PG
1991,25,21,217,29,68,0,4,29,64,21,32,9,12,21,77,14,2,27,22,79,PG
1991,25,47,742,101,209,1,5,100,204,38,55,13,43,56,153,33,2,47,40,241,PG
1991,27,73,2279,416,873,2,15,414,858,157,216,108,222,330,142,81,47,122,240,991,SF
1991,31,81,2085,543,1122,39,120,504,1002,229,257,107,164,271,111,58,9,122,181,1354,SG
1991,31,15,312,88,186,6,21,82,165,21,29,16,30,46,17,9,2,24,37,203,SG
1991,31,66,1773,455,936,33,99,422,837,208,228,91,134,225,94,49,7,98,144,1151,SG
1991,24,77,2772,591,1145,9,44,582,1101,519,616,54,217,271,781,163,11,269,174,1710,PG
1991,31,79,2933,466,976,80,250,386,726,519,573,105,446,551,989,102,17,314,150,1531,PG
1991,33,24,228,34,63,0,0,34,63,22,37,18,39,57,17,4,4,25,50,90,C
1991,34,82,2390,406,936,11,34,395,902,135,209,110,170,280,271,75,15,118,166,958,SG
1991,33,62,1499,67,124,0,0,67,124,29,50,119,240,359,48,51,124,46,199,163,C
1991,27,82,3034,990,1837,29,93,961,1744,571,671,118,374,492,453,223,83,202,229,2580,SG
1991,21,81,2442,462,909,2,12,460,897,288,436,267,412,679,144,77,123,202,319,1214,PF
1991,25,57,905,99,223,28,62,71,161,45,53,5,32,37,131,29,4,40,52,271,PG
1991,28,73,2359,424,887,4,13,420,874,232,327,169,312,481,227,101,76,149,251,1084,SF
1991,24,78,1259,199,468,0,4,199,464,88,131,115,221,336,31,17,26,108,189,486,C
1991,24,44,473,59,145,3,14,56,131,19,33,40,60,100,18,22,15,35,93,140,SF
1991,24,62,1004,159,418,19,65,140,353,92,119,42,77,119,76,30,8,77,158,429,SG
1991,34,64,2401,713,1511,8,37,705,1474,383,485,114,205,319,292,56,16,255,187,1817,SF
1991,24,76,1198,156,334,0,2,156,332,107,152,72,136,208,65,24,42,91,134,419,PF
1991,29,82,2225,166,338,0,0,166,338,63,123,189,399,588,59,25,81,102,298,395,C
1991,29,72,850,102,218,0,2,102,216,54,69,71,173,244,21,15,14,53,108,258,C
1991,23,64,792,131,308,6,25,125,283,71,118,20,51,71,191,20,7,76,83,339,PG
1991,26,5,21,0,3,0,0,0,3,3,6,2,1,3,4,0,0,2,4,3,SG
1991,27,77,1931,140,321,1,8,139,313,32,54,101,274,375,124,74,76,50,265,313,C
1991,24,32,157,23,62,5,18,18,44,7,13,10,14,24,9,5,1,11,28,58,PF
1991,33,82,2668,372,778,37,125,335,653,123,147,173,564,737,157,38,56,98,242,904,C
1991,24,62,1383,202,461,1,4,201,457,58,141,280,298,578,123,51,14,105,192,463,PF
1991,24,63,1152,109,189,0,1,109,188,93,130,113,190,303,27,17,127,45,168,311,C
1991,24,72,1122,131,294,0,0,131,294,62,111,82,213,295,39,14,22,69,192,324,C
1991,24,32,378,39,96,0,0,39,96,16,27,27,60,87,18,4,11,25,69,94,C
1991,24,40,744,92,198,0,0,92,198,46,84,55,153,208,21,10,11,44,123,230,C
1991,23,48,265,19,71,3,15,16,56,25,28,7,23,30,34,11,2,20,39,66,PG
1991,24,10,148,25,72,3,12,22,60,5,6,8,10,18,12,2,0,4,20,58,SG
1991,27,55,1399,119,268,71,154,48,114,86,103,18,93,111,299,57,4,75,141,395,PG
1991,25,7,99,14,29,0,1,14,28,6,9,1,6,7,7,2,1,8,9,34,PG
1991,30,4,86,9,23,0,3,9,20,11,14,3,12,15,12,6,3,10,5,29,SG
1991,30,78,1013,127,282,1,4,126,278,59,91,99,126,225,56,29,43,50,143,314,PF
1991,25,79,2878,598,1219,1,13,597,1206,281,340,119,291,410,201,98,85,147,234,1478,SG
1991,22,76,1171,216,513,17,57,199,456,58,92,117,104,221,64,48,19,71,153,507,SF
1991,24,29,860,166,378,14,47,152,331,59,69,49,63,112,72,46,8,33,65,405,SG
1991,32,77,1552,188,393,0,1,188,392,115,202,121,362,483,93,20,90,106,282,491,C
1991,23,1,2,1,1,0,0,1,1,2,2,0,0,0,0,0,0,0,0,4,SF
1991,26,81,1219,179,415,33,119,146,296,37,54,59,158,217,75,50,74,60,170,428,PF
1991,24,80,2514,276,561,1,6,275,555,181,230,225,343,568,176,119,43,156,295,734,PF
1991,34,25,256,35,85,2,6,33,79,24,25,9,23,32,18,9,2,14,17,96,SG
1991,32,80,2439,261,559,0,9,261,550,189,240,151,470,621,118,79,56,127,276,711,C
1991,25,77,2281,397,821,30,86,367,735,227,298,168,250,418,216,106,40,114,162,1051,SF
1991,29,69,2466,525,1034,1,6,524,1028,231,252,36,170,206,143,50,6,108,128,1282,SG
1991,27,82,3302,847,1608,4,14,843,1594,684,888,236,731,967,270,89,79,244,268,2382,PF
1991,35,82,1912,280,598,0,7,280,591,309,372,271,396,667,68,30,74,137,134,869,C
1991,24,73,2197,470,905,0,3,470,902,219,306,169,257,426,196,117,62,188,281,1159,PF
1991,26,50,987,183,365,1,6,182,359,178,246,51,67,118,85,62,4,75,136,545,SG
1991,24,74,1334,214,507,27,88,187,419,68,100,53,78,131,65,37,31,49,104,523,PG
1991,24,3,21,2,4,0,0,2,4,6,8,3,2,5,0,1,0,0,6,10,PF
1991,23,35,161,27,60,0,0,27,60,28,45,23,35,58,4,4,9,13,26,82,PF
1991,25,82,2870,504,1247,172,510,332,737,217,296,41,197,238,303,127,15,171,179,1397,SG
1991,22,64,2145,294,724,72,197,222,527,255,331,54,124,178,253,81,11,159,169,915,PG
1991,23,74,1070,131,351,43,124,88,227,38,49,35,83,118,150,40,11,91,141,343,SF
1991,28,56,689,93,187,0,3,93,184,66,90,56,109,165,32,11,14,45,91,252,C
1991,29,74,2561,336,679,13,39,323,640,159,198,153,407,560,259,70,51,129,203,844,PF
1991,27,81,2634,590,1186,0,8,590,1178,193,267,173,384,557,187,76,46,184,264,1373,SF
1991,27,15,529,139,290,0,3,139,287,49,69,36,45,81,38,26,4,40,50,327,SF
1991,27,66,2105,451,896,0,5,451,891,144,198,137,339,476,149,50,42,144,214,1046,SF
1991,33,68,2067,504,912,15,37,489,875,228,275,145,335,480,126,25,146,140,194,1251,PF
1991,24,73,2503,438,847,4,19,434,828,235,278,172,251,423,169,91,56,158,220,1115,SF
1991,26,78,1434,132,305,17,48,115,257,57,93,71,180,251,371,104,20,122,211,338,SG
1991,31,2,13,0,1,0,0,0,1,0,0,0,4,4,0,0,0,0,1,0,C
1991,27,13,53,7,28,1,1,6,27,2,4,3,7,10,8,7,4,6,5,17,PF
1991,25,82,2972,596,1164,112,322,484,842,551,600,81,200,281,331,109,13,163,165,1855,SG
1991,23,55,819,134,288,0,4,134,284,47,66,82,147,229,33,35,29,43,100,315,PF
1991,23,17,279,56,120,0,2,56,118,16,22,31,57,88,16,16,9,18,44,128,PF
1991,23,38,540,78,168,0,2,78,166,31,44,51,90,141,17,19,20,25,56,187,PF
1991,27,82,3121,445,1010,0,9,445,1001,307,396,188,332,520,133,66,57,104,338,1197,PF
1991,34,36,257,21,59,3,9,18,50,12,15,20,47,67,9,8,3,7,58,57,C
1991,33,72,1096,117,240,21,64,96,176,82,105,31,97,128,104,50,9,66,112,337,SG
1991,25,79,2553,409,962,45,179,364,783,179,244,210,311,521,220,138,96,167,248,1042,SF
1991,23,66,1207,120,274,4,12,116,262,113,139,41,62,103,243,61,18,107,112,357,SF
1991,27,82,3315,777,1449,40,133,737,1316,513,580,141,302,443,329,173,63,245,176,2107,SF
1991,23,11,29,3,7,0,0,3,7,7,12,5,9,14,1,1,2,5,5,13,PF
1991,27,52,1063,90,227,1,17,89,210,70,105,92,163,255,60,25,20,32,101,251,PF
1991,21,62,825,106,228,0,1,106,227,56,87,51,118,169,36,15,14,61,109,268,PF
1991,27,8,103,10,23,0,1,10,22,9,11,2,16,18,14,3,3,14,14,29,SG
1991,31,80,2927,635,1211,2,8,633,1203,265,330,201,485,686,237,66,200,131,219,1537,PF
1991,26,10,125,14,35,3,9,11,26,13,22,2,14,16,37,4,0,19,26,44,PG
1991,30,55,573,45,97,5,16,40,81,28,38,44,107,151,36,24,4,19,46,123,PF
1991,27,81,2477,478,1017,30,84,448,933,385,476,94,160,254,188,100,17,189,278,1371,SF
1991,26,70,2309,520,1037,6,32,514,1005,173,275,177,320,497,159,63,63,139,192,1219,SF
1991,22,21,85,7,16,0,0,7,16,7,11,5,12,17,4,1,1,4,18,21,C
1991,27,76,2739,307,595,0,2,307,593,239,305,305,615,920,204,62,17,215,288,853,PF
1991,23,31,261,24,55,0,2,24,53,6,10,15,34,49,2,6,27,8,53,54,C
1991,28,56,2062,487,959,0,4,487,955,213,277,219,551,770,131,121,221,174,221,1187,C
1991,33,4,19,3,6,0,0,3,6,0,0,0,3,3,0,0,0,0,1,6,C
1991,22,73,800,111,272,5,18,106,254,52,71,18,62,80,88,34,4,50,76,279,SG
1991,25,70,1181,212,506,6,24,206,482,74,93,38,80,118,90,20,6,71,71,504,SF
1991,22,28,85,15,45,0,1,15,44,10,15,6,15,21,6,3,4,6,20,40,C
1991,37,81,2441,485,811,0,1,485,810,237,309,271,585,856,66,66,103,153,197,1207,C
1991,30,82,1971,317,578,42,96,275,482,34,41,15,76,91,297,62,3,69,136,710,PG
1991,24,47,444,68,189,4,18,64,171,26,29,17,49,66,16,10,6,21,43,166,SF
1991,22,82,2244,259,575,1,13,258,562,69,97,108,135,243,528,165,15,180,249,588,PG
1991,25,74,972,116,235,0,3,116,232,75,112,122,214,336,47,23,57,75,147,307,C
1991,29,73,2504,368,744,18,64,350,680,229,279,167,371,538,108,64,78,103,247,983,PF
1991,25,46,587,75,144,0,5,75,139,43,70,53,73,126,27,23,43,32,60,193,C
1991,26,80,2566,620,1231,69,203,551,1028,165,229,121,296,417,238,56,17,184,221,1474,SF
1991,28,62,834,114,236,1,4,113,232,50,76,69,131,200,27,13,41,48,153,279,C
1991,26,61,1015,243,493,23,65,220,428,114,137,51,59,110,86,43,1,81,132,623,SG
1991,26,18,133,32,71,1,6,31,65,15,22,10,8,18,20,6,0,12,21,80,SG
1991,26,43,882,211,422,22,59,189,363,99,115,41,51,92,66,37,1,69,111,543,SG
1991,31,78,2167,561,1156,46,116,515,1040,430,471,67,124,191,168,60,13,147,170,1598,SG
1991,31,46,1327,359,720,37,93,322,627,282,311,37,80,117,96,38,11,93,90,1037,SG
1991,31,32,840,202,436,9,23,193,413,148,160,30,44,74,72,22,2,54,80,561,SG
1991,27,70,1165,131,243,0,1,131,242,104,116,155,186,341,45,61,43,45,147,366,PF
1991,25,82,3014,600,1153,21,68,579,1085,240,340,163,432,595,511,193,93,232,270,1461,SF
1991,26,79,2092,316,564,0,1,316,563,146,252,220,333,553,42,43,32,88,192,778,C
1991,26,48,960,165,303,0,0,165,303,67,114,114,156,270,16,26,19,53,94,397,C
1991,26,31,1132,151,261,0,1,151,260,79,138,106,177,283,26,17,13,35,98,381,C
1991,26,19,64,13,32,0,0,13,32,9,10,7,7,14,2,1,2,6,12,35,PF
1991,27,81,2665,486,944,130,313,356,631,279,339,52,230,282,649,158,12,189,151,1381,PG
1991,32,70,1683,201,426,16,57,185,369,110,133,50,126,176,271,63,32,130,174,528,SG
1991,26,16,571,97,195,18,53,79,142,59,62,8,37,45,166,42,2,56,23,271,PG
1991,23,62,773,88,229,5,31,83,198,62,77,16,49,65,81,30,8,59,104,243,PG
1991,24,68,1011,139,303,15,43,124,260,26,36,65,80,145,53,22,13,52,100,319,SG
1991,32,62,900,83,167,0,2,83,165,60,85,77,189,266,64,25,11,45,107,226,PF
1991,28,70,2325,405,885,2,5,403,880,63,93,170,508,678,70,52,132,81,307,875,C
1991,22,80,2467,360,773,0,2,360,771,182,259,154,348,502,89,87,47,153,286,902,C
1991,35,3,37,2,14,0,0,2,14,0,0,2,7,9,4,1,3,3,3,4,SF
1991,28,80,1843,344,793,10,34,334,759,336,419,88,211,299,203,95,56,172,123,1034,SG
1991,23,77,2646,550,1193,71,184,479,1009,171,209,85,296,381,189,101,26,166,216,1342,SF
1991,24,82,3154,635,1350,42,128,593,1222,89,165,82,204,286,734,131,13,174,114,1401,PG
1991,25,77,3027,703,1424,40,115,663,1309,394,465,147,305,452,238,126,34,230,207,1840,SG
1991,29,79,2586,444,1020,88,262,356,758,221,262,47,206,253,340,148,47,125,216,1197,PG
1991,30,82,2114,357,670,4,25,353,645,170,209,107,174,281,135,63,29,135,190,888,PF
1991,28,81,2598,438,904,23,63,415,841,199,263,191,268,459,444,246,16,212,273,1098,SG
1991,24,82,1940,373,806,6,19,367,787,205,314,123,226,349,151,78,76,133,263,957,PF
1991,25,82,3095,754,1366,1,7,753,1359,592,777,335,728,1063,208,127,320,270,264,2101,C
1991,23,36,425,62,150,0,1,62,149,15,27,29,22,51,35,16,1,27,49,139,SG
1991,23,24,170,24,59,0,0,24,59,8,15,15,8,23,11,9,1,16,23,56,SG
1991,23,12,255,38,91,0,1,38,90,7,12,14,14,28,24,7,0,11,26,83,SG
1991,24,47,674,108,242,2,11,106,231,47,80,20,51,71,132,32,8,76,65,265,PG
1991,29,82,2747,276,560,6,30,270,530,111,176,361,665,1026,85,65,55,94,281,669,SF
1991,35,37,202,14,33,0,0,14,33,8,14,13,29,42,4,2,20,15,35,36,C
1991,28,82,874,124,285,17,61,107,224,59,71,14,52,66,216,36,2,102,92,324,PG
1991,26,74,1649,179,377,0,1,179,376,186,256,137,190,327,70,52,112,91,240,544,PF
1991,30,25,348,34,93,1,5,33,88,5,19,41,70,111,17,11,17,27,54,74,C
1991,25,3,43,6,14,0,0,6,14,1,2,3,6,9,1,1,1,1,6,13,PF
1991,30,80,1357,206,494,4,20,202,474,47,57,73,112,185,106,37,26,65,198,463,SF
1991,31,82,2228,298,597,0,5,298,592,274,328,174,361,535,98,55,61,106,264,870,C
1991,23,39,227,20,39,0,0,20,39,19,21,21,24,45,9,6,2,4,20,59,C
1991,22,42,398,68,155,0,2,68,153,22,40,28,93,121,17,2,29,34,64,158,C
1991,28,82,2632,432,831,15,40,417,791,441,539,178,482,660,301,58,22,175,262,1320,PF
1991,29,82,2630,501,1051,71,219,430,832,118,148,54,192,246,177,95,21,85,146,1191,SG
1991,22,82,2336,503,1183,125,334,378,849,153,204,62,173,235,134,62,25,127,203,1284,SG
1991,25,64,2171,395,822,2,6,393,816,258,417,207,502,709,95,51,86,205,213,1050,C
1991,26,57,510,51,116,0,0,51,116,48,79,58,76,134,11,14,20,27,75,150,C
1991,24,79,2772,442,942,3,27,439,915,204,249,104,266,370,602,105,34,223,206,1091,PG
1991,35,77,1940,295,691,46,135,249,556,166,197,108,333,441,143,65,64,130,218,802,C
1991,22,79,2978,549,1301,3,11,546,1290,320,435,193,504,697,315,113,85,230,249,1421,SF
1991,26,79,2714,462,1039,93,228,369,811,340,377,57,213,270,660,89,4,252,192,1357,PG
1991,23,5,30,3,7,0,0,3,7,3,5,0,2,2,6,1,0,3,7,9,PG
1991,25,74,2703,548,1168,0,7,548,1161,384,484,216,392,608,134,81,145,165,267,1480,SF
1991,27,5,45,2,4,0,0,2,4,3,6,2,2,4,4,1,0,1,3,7,SG
1991,29,2,16,1,4,0,1,1,3,3,4,0,0,0,5,1,1,1,3,5,SF
1991,25,78,2699,522,1003,49,135,473,868,287,340,36,127,163,554,106,11,237,131,1380,PG
1991,33,81,1923,128,263,0,0,128,263,12,50,302,407,709,88,83,22,93,265,268,PF
1991,25,47,389,95,200,6,24,89,176,22,27,21,35,56,43,6,2,37,27,218,PF
1991,27,75,1885,407,902,9,46,398,856,221,301,176,213,389,169,85,35,140,190,1044,SF
1991,22,64,695,97,220,0,7,97,213,40,57,24,47,71,135,28,12,69,80,234,SG
1991,24,76,1690,342,705,0,0,342,705,144,189,116,241,357,84,24,111,86,246,828,C
1991,28,15,95,9,27,0,0,9,27,6,12,7,19,26,4,3,3,3,27,24,C
1991,28,5,25,6,11,0,0,6,11,2,4,3,4,7,1,2,0,2,9,14,C
1991,28,10,70,3,16,0,0,3,16,4,8,4,15,19,3,1,3,1,18,10,C
1991,32,80,2375,371,756,31,78,340,678,58,83,45,141,186,362,83,16,126,189,831,PG
1991,23,81,2099,195,381,0,1,195,380,182,252,272,369,641,25,48,121,77,337,572,C
1991,25,61,1173,180,410,27,93,153,317,79,105,30,101,131,204,59,17,74,137,466,SG
1991,24,3,6,2,3,0,0,2,3,2,2,0,0,0,2,0,0,0,0,6,PG
1991,28,82,3103,496,978,58,168,438,810,363,434,46,191,237,1164,234,16,298,233,1413,PG
1991,24,58,2076,314,651,11,33,303,618,161,211,57,162,219,463,117,11,156,125,800,PG
1991,29,24,225,43,107,15,35,28,72,11,11,3,6,9,24,7,0,16,11,112,SG
1991,26,5,171,43,79,0,1,43,78,16,18,16,39,55,12,6,9,13,20,102,C
1991,30,82,1498,335,757,0,9,335,748,145,177,82,99,181,82,31,8,83,165,815,SG
1991,33,81,2955,583,1247,52,144,531,1103,292,343,69,160,229,378,85,35,252,231,1510,SG
1991,25,26,108,17,50,0,0,17,50,12,21,14,17,31,10,4,1,13,24,46,PF
1991,29,48,1657,289,665,19,65,270,600,179,229,35,125,160,446,75,10,185,118,776,PG
1991,30,3,14,1,4,0,0,1,4,0,0,0,0,0,1,1,0,1,0,2,SG
1991,27,73,1481,205,411,0,4,205,407,89,124,120,192,312,111,32,48,117,161,499,SF
1991,29,82,1946,276,565,1,5,275,560,72,104,154,409,563,147,63,63,168,265,625,C
1991,36,72,1077,113,228,0,2,113,226,62,88,74,154,228,21,23,23,47,112,288,C
1991,28,12,110,4,13,0,0,4,13,8,10,1,14,15,1,0,3,9,18,16,PF
1991,28,82,3039,549,988,3,7,546,981,334,480,287,559,846,197,73,20,217,278,1435,PF
1991,29,80,2066,433,835,10,35,423,800,137,173,25,74,99,273,113,8,138,191,1013,PG
1991,26,33,1116,262,542,0,1,262,541,136,170,75,178,253,66,23,28,82,99,660,PF
1991,25,62,1371,183,433,7,21,176,412,127,172,87,188,275,76,35,38,80,195,500,PF
1991,25,47,470,50,124,12,32,38,92,25,33,32,35,67,31,14,2,24,58,137,SF
1991,31,77,1289,187,412,15,45,172,367,152,167,46,130,176,159,33,13,92,130,541,SF
1991,31,65,1194,191,434,64,153,127,281,17,27,33,72,105,111,44,9,46,120,463,SG
1991,26,70,1407,168,383,12,33,156,350,64,87,36,116,152,311,63,0,95,124,412,PG
1991,28,71,1683,259,532,6,15,253,517,85,112,108,255,363,97,29,10,126,234,609,PF
1991,28,48,514,104,231,7,29,97,202,55,64,20,35,55,86,28,5,39,77,270,SG
1991,31,65,1841,230,496,6,25,224,471,143,172,37,135,172,351,98,12,126,170,609,PG
1991,32,75,2420,458,927,51,141,407,786,259,288,78,102,180,110,42,10,108,122,1226,SF
1991,22,73,1178,175,359,0,2,175,357,49,74,124,225,349,40,20,23,49,135,399,PF
1991,27,49,975,152,353,3,19,149,334,99,120,17,90,107,197,30,5,91,74,406,PG
1991,27,31,166,24,52,0,0,24,52,10,18,15,36,51,4,1,29,24,43,58,C
1991,27,13,116,24,57,6,17,18,40,9,11,0,7,7,15,2,3,12,14,63,SG
1991,29,71,2305,230,535,0,9,230,526,93,154,140,358,498,459,78,33,154,199,553,PG
1991,26,54,771,83,191,0,1,83,190,64,82,63,94,157,13,18,30,30,92,230,SF
1991,27,75,2197,359,803,54,168,305,635,231,266,41,133,174,417,118,6,146,180,1003,PG
1991,27,77,1455,181,415,1,5,180,410,74,94,101,239,340,69,46,59,51,230,437,C
1991,23,75,824,118,246,0,1,118,245,58,84,56,80,136,48,35,23,41,115,294,SG
1991,30,82,1957,247,382,0,0,247,382,135,206,171,393,564,37,32,161,86,266,629,C
1991,23,79,1901,265,665,6,37,259,628,159,225,173,331,504,63,81,44,131,308,695,PF
1991,24,34,350,45,108,6,12,39,96,17,25,4,13,17,73,24,0,34,37,113,PG
1991,31,81,3078,770,1640,85,249,685,1391,476,574,261,471,732,265,123,65,201,156,2101,SF
1991,28,68,668,114,255,0,1,114,254,51,90,69,111,180,15,17,7,50,91,279,C
1991,27,68,2164,380,804,9,43,371,761,169,206,78,129,207,275,82,23,161,181,938,SG
1991,30,80,2582,358,595,0,0,358,595,217,308,227,524,751,97,47,47,137,247,933,PF
1991,32,60,1832,332,655,0,4,332,651,83,130,86,271,357,95,30,88,113,197,747,C
1991,28,43,1293,199,430,0,1,199,429,107,164,111,179,290,100,36,69,63,126,505,C
1991,22,52,508,72,161,1,2,71,159,37,56,41,70,111,16,9,6,40,92,182,PF
1991,24,33,941,164,393,10,41,154,352,73,97,42,135,177,133,39,6,68,63,411,SF
1991,21,75,527,93,179,0,3,93,176,34,50,56,75,131,31,11,31,41,81,220,PF
1991,24,73,1706,261,523,1,7,260,516,290,330,49,127,176,348,150,17,150,202,813,PG
1991,26,73,1896,384,855,57,157,327,698,166,197,133,173,306,133,113,41,112,253,991,SF
1991,26,22,354,61,127,14,26,47,101,35,41,17,42,59,46,20,11,36,64,171,SF
1991,26,51,1542,323,728,43,131,280,597,131,156,116,131,247,87,93,30,76,189,820,SF
1991,22,51,337,53,104,1,2,52,102,20,28,42,56,98,16,12,13,23,51,127,PF
1991,28,80,2373,444,881,4,10,440,871,159,238,259,445,704,99,60,40,153,235,1051,PF
1991,22,25,162,21,70,0,2,21,68,13,26,16,24,40,11,5,1,17,13,55,PF
1991,24,64,607,98,245,8,20,90,225,35,45,34,33,67,25,16,13,30,70,239,SF
1991,27,25,563,53,138,1,9,52,129,29,41,24,51,75,46,19,5,42,66,136,SG
1991,31,41,355,35,79,0,5,35,74,4,6,6,27,33,25,10,4,10,9,74,SF
1991,26,74,1593,234,519,2,15,232,504,69,83,136,264,400,107,60,31,95,244,539,C
1991,26,82,1421,148,349,28,90,120,259,108,133,107,139,246,94,58,16,89,236,432,SF
1991,28,12,222,25,63,12,38,13,25,19,21,5,14,19,49,5,0,12,10,81,SG
1991,32,15,171,26,77,1,7,25,70,11,13,3,10,13,15,5,5,12,18,64,SG
1991,32,11,125,21,54,1,6,20,48,10,12,2,9,11,10,5,4,7,11,53,SG
1991,32,4,46,5,23,0,1,5,22,1,1,1,1,2,5,0,1,5,7,11,SG
1991,31,53,1823,490,983,0,4,490,979,350,439,141,220,361,119,69,23,152,145,1330,SF
1991,25,73,2034,234,515,12,50,222,465,101,133,51,191,242,353,87,7,135,162,581,PG
1991,29,78,3008,716,1455,26,90,690,1365,212,266,107,249,356,275,104,35,127,117,1670,SF
1991,23,15,164,19,47,0,1,19,46,16,24,12,33,45,3,4,5,11,28,54,PF
1991,23,4,20,2,3,0,0,2,3,1,1,1,5,6,0,0,0,2,3,5,PF
1991,23,8,136,15,41,0,0,15,41,13,21,10,27,37,3,3,5,9,23,43,PF
1991,23,3,8,2,3,0,1,2,2,2,2,1,1,2,0,1,0,0,2,6,PF
1991,26,6,39,3,12,0,1,3,11,6,8,1,2,3,8,1,0,4,1,12,PG
1991,28,75,897,103,271,36,104,67,167,41,45,22,53,75,141,50,7,50,49,283,PG
1992,23,71,934,178,361,0,0,178,361,76,101,81,179,260,30,25,16,66,132,432,PF
1992,22,81,1538,356,845,31,94,325,751,94,108,22,92,114,192,44,4,117,130,837,PG
1992,29,68,926,78,151,1,3,77,148,51,67,97,155,252,22,25,15,33,140,208,C
1992,29,78,2795,485,1233,125,386,360,847,313,360,58,252,310,594,145,9,212,162,1408,PG
1992,27,76,1175,187,432,14,49,173,383,56,76,65,100,165,68,28,28,46,109,444,SF
1992,32,75,1582,339,787,15,71,324,716,158,230,67,169,236,126,51,11,105,171,851,SF
1992,32,81,1595,299,676,78,230,221,446,108,131,40,108,148,202,73,13,70,148,784,SG
1992,22,80,1350,243,459,0,1,243,458,103,149,106,230,336,32,45,62,91,176,589,C
1992,27,82,2793,389,854,0,4,389,850,167,268,337,604,941,78,88,65,201,263,945,PF
1992,21,64,1086,187,480,3,13,184,467,73,98,38,89,127,203,67,9,97,68,450,PG
1992,24,60,2203,482,1042,30,85,452,957,202,303,98,286,384,163,97,33,126,132,1196,SG
1992,33,82,2432,469,1008,42,127,427,881,143,163,96,182,278,135,86,11,109,128,1123,SF
1992,25,57,1889,312,685,13,56,299,629,107,138,62,238,300,302,54,51,140,151,744,SG
1992,24,10,45,8,18,0,0,8,18,5,6,2,4,6,2,0,0,3,7,21,SF
1992,24,8,32,5,11,0,0,5,11,5,6,2,2,4,2,0,0,3,6,15,SF
1992,24,2,13,3,7,0,0,3,7,0,0,0,2,2,0,0,0,0,1,6,SF
1992,24,82,1510,161,435,8,55,153,380,117,158,33,103,136,314,59,9,98,170,447,PG
1992,24,82,1875,335,697,35,87,300,610,104,129,19,126,145,266,46,5,94,88,809,PG
1992,25,80,1496,193,379,1,10,192,369,111,160,89,144,233,188,47,23,84,128,498,SG
1992,24,59,843,84,205,25,73,59,132,26,37,65,77,142,38,40,15,47,109,219,SF
1992,23,82,2505,440,899,1,6,439,893,213,320,191,229,420,201,124,27,181,161,1094,SG
1992,22,31,112,21,46,0,0,21,46,19,30,11,24,35,5,2,2,8,20,61,C
1992,23,9,35,6,13,0,0,6,13,6,8,2,9,11,6,1,0,5,0,18,C
1992,31,73,1742,223,506,10,42,213,464,68,95,38,123,161,480,57,4,148,123,524,PG
1992,30,84,2104,368,836,0,2,368,834,215,270,122,363,485,78,35,117,108,160,951,PF
1992,30,13,327,39,101,0,1,39,100,44,55,23,55,78,19,5,15,21,31,122,PF
1992,30,71,1777,329,735,0,1,329,734,171,215,99,308,407,59,30,102,87,129,829,PF
1992,28,75,2881,622,1126,32,137,590,989,454,653,271,559,830,308,136,44,235,196,1730,SF
1992,24,75,1331,238,493,83,186,155,307,60,79,17,64,81,125,51,4,56,84,619,PG
1992,29,76,1637,316,659,2,17,314,642,145,171,19,93,112,159,36,5,91,116,779,SG
1992,27,16,92,11,17,0,1,11,16,10,12,4,12,16,4,2,2,4,10,32,SG
1992,27,8,46,3,4,0,0,3,4,8,8,3,6,9,0,1,0,2,4,14,SG
1992,27,8,46,8,13,0,1,8,12,2,4,1,6,7,4,1,2,2,6,18,SG
1992,28,32,363,50,121,0,1,50,120,14,22,24,39,63,12,6,18,15,56,114,C
1992,27,63,1941,354,740,0,2,354,738,171,249,130,383,513,76,39,118,175,185,879,C
1992,26,54,833,80,211,0,1,80,210,35,50,63,99,162,38,19,9,33,122,195,SF
1992,26,52,831,79,209,0,1,79,208,35,50,62,99,161,38,19,9,33,121,193,SF
1992,26,2,2,1,2,0,0,1,2,0,0,1,0,1,0,0,0,0,1,2,SF
1992,23,77,1161,175,375,3,14,172,361,81,100,105,191,296,34,19,44,71,124,434,SF
1992,35,45,1662,353,758,52,128,301,630,150,162,46,388,434,306,42,33,125,82,908,SF
1992,32,75,2527,535,1161,65,169,470,992,239,266,78,161,239,204,50,22,153,134,1374,SG
1992,25,43,189,25,55,6,16,19,39,8,11,9,13,22,19,14,1,14,26,64,SG
1992,24,72,2548,429,993,12,54,417,939,126,177,101,168,269,492,170,40,152,182,996,PG
1992,27,82,2790,317,671,2,27,315,644,94,120,58,177,235,743,170,6,156,156,730,PG
1992,29,71,1267,49,128,0,9,49,119,12,26,54,168,222,22,11,205,41,139,110,C
1992,23,79,2287,294,658,1,4,293,654,151,241,192,293,485,125,94,26,133,194,740,PF
1992,28,52,1721,312,633,17,44,295,589,117,136,70,175,245,163,55,38,107,101,758,SG
1992,30,71,2179,421,947,8,25,413,922,212,280,203,375,578,186,41,120,150,212,1062,C
1992,21,82,1605,252,601,1,23,251,578,100,124,49,113,162,316,81,22,136,107,605,PG
1992,31,67,1176,161,344,0,1,161,343,41,77,98,183,281,89,27,99,41,117,363,C
1992,32,65,1556,306,584,3,6,303,578,125,163,97,247,344,122,60,23,112,223,740,SF
1992,22,37,270,43,97,2,11,41,86,17,21,13,26,39,11,8,2,18,19,105,SF
1992,26,82,1082,167,374,32,90,135,284,51,63,27,72,99,205,66,7,51,82,417,PG
1992,23,42,431,60,128,0,3,60,125,30,49,31,51,82,26,12,7,29,48,150,SF
1992,23,6,50,5,10,0,0,5,10,5,8,2,4,6,3,3,0,2,7,15,SF
1992,23,36,381,55,118,0,3,55,115,25,41,29,47,76,23,9,7,27,41,135,SF
1992,23,31,883,149,350,5,22,144,328,60,78,15,64,79,164,33,7,59,74,363,PG
1992,28,82,1783,221,488,0,1,221,487,190,285,187,289,476,81,42,34,105,196,632,C
1992,22,4,23,4,6,1,3,3,3,0,0,0,3,3,6,1,0,4,2,9,PG
1992,23,56,535,77,169,0,6,77,163,38,58,26,43,69,59,35,12,42,68,192,PG
1992,31,57,655,102,249,19,63,83,186,48,66,32,52,84,48,30,5,35,82,271,SF
1992,31,22,254,39,89,7,22,32,67,18,29,9,19,28,16,12,1,14,31,103,SF
1992,31,35,401,63,160,12,41,51,119,30,37,23,33,56,32,18,4,21,51,168,SF
1992,26,56,800,95,198,0,3,95,195,40,60,87,114,201,41,26,8,30,105,230,PF
1992,23,28,290,29,71,0,1,29,70,12,21,18,34,52,23,19,7,13,31,70,SF
1992,23,2,29,4,8,0,0,4,8,0,0,2,0,2,2,2,1,1,2,8,SF
1992,23,11,140,15,30,0,0,15,30,3,9,6,16,22,11,8,3,5,18,33,SF
1992,23,15,121,10,33,0,1,10,32,9,12,10,18,28,10,9,3,7,11,29,SF
1992,24,80,1278,205,447,64,166,141,281,38,50,73,150,223,75,26,21,56,129,512,PF
1992,23,68,1585,280,622,6,15,274,607,196,245,76,168,244,123,46,37,119,186,762,SF
1992,29,31,356,74,160,1,6,73,154,38,54,10,24,34,59,16,4,33,58,187,SG
1992,30,82,2461,307,542,0,5,307,537,106,171,266,462,728,92,99,55,78,237,720,PF
1992,22,7,58,4,18,1,5,3,13,2,3,1,4,5,12,1,0,5,8,11,PG
1992,23,81,1876,220,491,0,2,220,489,138,223,155,268,423,59,53,159,73,203,578,C
1992,29,78,2441,527,1137,13,37,514,1100,240,299,141,145,286,229,84,31,165,206,1307,SF
1992,30,81,1867,359,732,1,5,358,727,162,212,128,218,346,63,32,96,114,264,881,PF
1992,34,64,1471,208,445,0,0,208,445,96,159,93,231,324,87,22,14,75,131,512,C
1992,28,78,2430,457,922,0,4,457,918,240,346,257,292,549,109,58,16,138,196,1154,PF
1992,23,80,2291,250,455,0,1,250,454,136,222,196,384,580,59,47,215,124,281,636,C
1992,22,64,725,176,365,1,6,175,359,109,148,60,92,152,50,16,11,71,52,462,SF
1992,32,69,1948,426,989,18,49,408,940,258,311,86,315,401,142,57,37,103,196,1128,PF
1992,24,21,545,108,240,8,27,100,213,36,53,9,45,54,86,14,8,42,47,260,PG
1992,24,1,22,5,12,0,2,5,10,0,0,1,3,4,3,1,0,3,4,10,SG
1992,35,56,1086,115,249,3,6,112,243,26,43,29,66,95,185,83,0,36,73,259,PG
1992,23,69,817,113,250,2,2,111,248,23,28,78,109,187,38,32,17,41,70,251,PF
1992,24,65,2207,483,958,23,76,460,882,300,393,203,415,618,205,54,98,248,168,1289,PF
1992,23,81,1976,295,649,10,52,285,597,216,262,69,120,189,366,73,13,167,151,816,PG
1992,24,45,381,48,101,0,0,48,101,24,32,33,36,69,12,9,7,27,40,120,C
1992,32,81,1420,103,239,0,7,103,232,81,115,63,121,184,294,97,10,79,86,287,PG
1992,24,22,115,15,25,0,0,15,25,4,6,13,21,34,2,5,4,3,10,34,PF
1992,35,35,344,35,82,0,0,35,82,7,11,38,63,101,21,4,27,15,57,77,C
1992,27,33,132,22,40,0,0,22,40,4,13,14,22,36,3,2,6,8,29,48,C
1992,26,10,48,7,23,0,2,7,21,2,2,1,6,7,5,2,0,4,5,16,SG
1992,29,80,2207,303,630,0,4,303,626,174,201,163,309,472,140,82,20,97,193,780,SF
1992,29,11,344,57,142,0,1,57,141,44,53,24,45,69,33,12,6,26,31,158,SF
1992,29,69,1863,246,488,0,3,246,485,130,148,139,264,403,107,70,14,71,162,622,SF
1992,23,51,741,77,193,10,37,67,156,91,104,18,60,78,141,45,2,74,94,255,PG
1992,22,51,328,43,112,13,30,30,82,15,18,16,25,41,17,7,2,13,35,114,SF
1992,30,70,2149,514,1053,5,13,509,1040,177,249,247,384,631,102,58,34,115,210,1210,PF
1992,27,77,2020,504,1038,74,183,430,855,127,152,57,202,259,177,93,20,134,156,1209,SG
1992,31,11,98,9,37,0,1,9,36,13,16,2,10,12,4,5,1,10,6,31,SG
1992,26,73,2643,576,1010,0,2,576,1008,414,533,191,569,760,262,65,78,185,190,1566,C
1992,36,33,429,38,86,5,18,33,68,11,15,4,29,33,66,11,3,27,57,92,PG
1992,22,64,1301,154,279,0,1,154,278,87,152,158,252,410,30,27,74,49,191,395,PF
1992,24,68,2149,256,531,0,5,256,526,181,285,228,444,672,57,26,29,117,202,693,PF
1992,37,46,741,185,403,5,16,180,387,82,94,20,50,70,68,29,1,45,69,457,SF
1992,28,82,2815,394,902,36,101,358,801,164,186,42,185,227,567,89,5,183,158,988,PG
1992,22,48,905,171,324,0,0,171,324,95,142,115,157,272,33,41,53,86,139,437,PF
1992,23,36,979,157,317,5,19,152,298,86,112,87,160,247,60,55,35,88,114,405,C
1992,34,58,1075,112,245,0,0,112,245,61,86,99,190,289,33,8,49,48,103,285,C
1992,34,44,994,107,227,0,0,107,227,59,84,97,173,270,31,8,44,41,86,273,C
1992,34,14,81,5,18,0,0,5,18,2,2,2,17,19,2,0,5,7,17,12,C
1992,25,42,752,117,253,1,10,116,243,73,107,13,50,63,172,25,9,68,78,308,PG
1992,25,5,98,16,31,0,1,16,30,5,7,1,5,6,19,4,0,8,10,37,PG
1992,25,37,654,101,222,1,9,100,213,68,100,12,45,57,153,21,9,60,68,271,PG
1992,29,60,509,43,87,1,1,42,86,30,40,22,74,96,25,10,16,31,123,117,C
1992,29,76,2751,694,1476,114,338,580,1138,401,505,166,334,500,512,138,70,240,229,1903,SG
1992,27,82,2222,362,786,0,3,362,783,156,226,151,346,497,99,38,37,143,264,880,C
1992,26,82,1902,190,472,0,0,190,472,80,171,343,396,739,58,38,179,79,275,460,C
1992,28,82,3192,587,1311,49,120,538,1191,412,475,82,106,188,375,71,12,193,145,1635,SG
1992,25,65,1463,355,759,7,35,348,724,139,187,39,139,178,125,47,7,75,145,856,SG
1992,35,81,2023,107,240,0,0,107,240,52,87,150,341,491,40,36,205,60,239,266,C
1992,24,4,13,2,9,0,0,2,9,0,0,0,1,1,0,0,0,0,3,4,C
1992,26,81,2283,433,830,39,103,394,727,113,146,86,212,298,137,81,46,122,236,1018,SF
1992,36,72,1437,250,538,0,1,250,537,198,271,55,147,202,53,24,33,72,236,698,C
1992,26,81,1840,325,716,7,32,318,684,162,191,56,155,211,170,99,20,120,138,819,PG
1992,30,63,2016,310,684,69,167,241,517,87,123,94,213,307,238,78,22,104,150,776,SG
1992,28,79,1677,221,424,23,70,198,354,155,182,69,158,227,174,68,15,83,159,620,SG
1992,23,82,3120,514,1040,25,82,489,958,285,331,143,296,439,214,84,29,152,149,1338,SF
1992,31,81,2191,485,1034,138,329,347,705,164,212,92,161,253,104,57,18,119,151,1272,SF
1992,22,29,103,17,50,0,0,17,50,9,19,12,12,24,1,6,9,11,11,43,C
1992,24,66,2511,547,1014,1,3,546,1011,227,312,217,523,740,190,62,177,196,222,1322,C
1992,24,81,1665,366,846,6,34,360,812,148,176,74,94,168,143,32,9,89,160,886,SG
1992,29,82,3150,796,1525,1,6,795,1519,377,511,228,693,921,156,88,245,209,277,1970,C
1992,29,34,175,33,77,0,0,33,77,16,19,21,40,61,6,2,3,19,22,82,C
1992,26,66,1598,331,632,11,33,320,599,166,218,105,105,210,92,49,17,99,134,839,SF
1992,25,68,937,134,328,17,48,117,280,61,73,53,160,213,75,22,15,46,135,346,PF
1992,29,82,1737,294,610,6,27,288,583,132,179,69,140,209,266,56,7,140,134,726,PG
1992,31,82,1662,286,704,37,123,249,581,135,170,34,116,150,239,57,21,128,128,744,PG
1992,23,49,548,89,193,0,1,89,192,35,49,43,102,145,35,6,12,36,83,213,PF
1992,22,81,1535,241,525,23,70,218,455,139,184,73,147,220,126,78,30,123,230,644,SF
1992,26,10,140,18,33,0,0,18,33,10,15,8,18,26,8,5,4,5,24,46,PF
1992,27,66,852,161,370,4,17,157,353,63,92,75,69,144,71,40,26,58,91,389,SF
1992,26,82,2496,480,908,9,31,471,877,139,157,80,206,286,219,75,37,97,200,1108,SF
1992,27,78,2209,333,750,9,28,324,722,171,199,67,123,190,411,98,22,175,206,846,PG
1992,25,40,549,59,143,1,4,58,139,18,26,12,44,56,98,36,4,44,54,137,SG
1992,25,19,374,44,93,0,1,44,92,10,16,8,33,41,63,21,1,30,33,98,SG
1992,25,15,112,11,33,1,2,10,31,6,8,2,7,9,18,7,3,10,14,29,SG
1992,25,6,63,4,17,0,1,4,16,2,2,2,4,6,17,8,0,4,7,10,SG
1992,24,54,612,117,206,0,4,117,202,72,109,75,107,182,16,31,36,44,101,306,PF
1992,27,82,2223,423,799,0,2,423,797,196,285,177,403,580,131,59,69,140,273,1042,PF
1992,23,70,1037,165,386,1,6,164,380,87,106,36,69,105,162,41,3,82,98,418,SG
1992,23,79,2906,666,1427,6,25,660,1402,284,381,165,237,402,329,154,46,180,237,1622,SG
1992,27,81,2771,512,1001,0,2,512,999,343,425,234,426,660,118,51,85,166,176,1367,PF
1992,24,75,1822,383,871,16,54,367,817,77,125,107,153,260,175,66,30,103,171,859,SF
1992,32,35,499,90,199,1,3,89,196,21,28,37,81,118,31,11,16,20,37,202,C
1992,24,78,1718,305,682,55,141,250,541,126,170,72,159,231,175,96,21,91,193,791,SG
1992,27,3,25,2,4,0,0,2,4,6,10,3,8,11,1,1,1,3,4,10,PF
1992,26,78,2049,275,595,15,51,260,544,44,54,34,150,184,538,138,14,187,181,609,PG
1992,25,68,891,99,225,7,18,92,207,20,24,14,55,69,217,45,2,46,76,225,PG
1992,25,13,57,0,8,0,0,0,8,1,2,1,3,4,18,8,0,5,3,1,PG
1992,25,55,834,99,217,7,18,92,199,19,22,13,52,65,199,37,2,41,73,224,PG
1992,26,64,2388,489,1022,1,8,488,1014,176,220,157,275,432,170,74,27,109,178,1155,SF
1992,26,81,2859,457,790,0,2,457,788,235,317,344,463,807,217,100,131,98,196,1149,PF
1992,26,82,1659,309,689,19,66,290,623,102,153,129,128,257,150,64,13,105,142,739,SG
1992,28,82,2902,382,803,12,56,370,747,340,457,306,456,762,117,91,36,111,141,1116,PF
1992,37,26,367,46,103,1,4,45,99,13,18,3,21,24,68,17,1,18,28,106,PG
1992,21,35,256,62,158,2,10,60,148,15,28,22,20,42,22,13,6,27,31,141,SG
1992,31,80,1127,147,344,0,0,147,344,73,89,92,250,342,36,29,11,62,148,367,PF
1992,28,49,394,31,84,0,0,31,84,14,29,31,64,95,7,7,8,25,75,76,C
1992,24,37,984,195,400,0,1,195,399,50,82,49,136,185,36,22,13,58,118,440,PF
1992,31,68,809,79,178,7,27,72,151,8,22,17,60,77,69,27,3,28,134,173,SG
1992,31,2,40,4,9,0,2,4,7,0,0,2,2,4,1,1,0,0,6,8,SG
1992,31,66,769,75,169,7,25,68,144,8,22,15,58,73,68,26,3,28,128,165,SG
1992,25,81,3332,734,1592,127,376,607,1216,298,389,81,229,310,807,164,13,267,208,1893,PG
1992,30,65,2252,448,1011,58,186,390,825,198,261,49,121,170,373,101,17,154,150,1152,PG
1992,28,82,3144,569,1292,64,211,505,1081,293,398,120,327,447,417,152,72,252,199,1495,SG
1992,31,40,421,17,50,0,9,17,41,24,28,30,68,98,26,10,15,22,56,58,C
1992,25,81,3013,521,1127,91,229,430,898,403,461,53,218,271,248,157,43,189,174,1536,SG
1992,36,16,96,12,32,3,8,9,24,9,11,1,7,8,10,3,0,8,12,36,PG
1992,36,8,34,4,11,0,3,4,8,4,6,1,1,2,5,0,0,4,4,12,PG
1992,36,8,62,8,21,3,5,5,16,5,5,0,6,6,5,3,0,4,8,24,PG
1992,23,50,386,52,144,23,48,29,96,23,29,17,24,41,82,15,1,40,50,150,PG
1992,25,43,566,83,161,0,1,83,160,25,44,33,66,99,27,16,25,37,60,191,PF
1992,32,25,535,87,211,33,95,54,116,48,59,30,55,85,22,15,13,15,75,255,SF
1992,23,6,36,4,15,0,1,4,14,7,7,2,6,8,4,2,0,4,6,15,SF
1992,23,32,580,123,262,6,24,117,238,24,29,27,67,94,37,14,6,37,52,276,PF
1992,23,82,1886,254,487,0,1,254,486,163,235,182,411,593,47,73,43,106,315,671,C
1992,22,51,1058,163,328,0,0,163,328,100,150,118,157,275,39,25,23,75,128,426,PF
1992,31,56,555,93,242,36,96,57,146,16,17,7,17,24,54,14,1,22,33,238,SG
1992,27,11,40,2,7,0,0,2,7,5,10,1,9,10,2,0,0,3,6,9,C
1992,26,71,1314,276,593,12,47,264,546,179,253,105,101,206,102,67,39,100,115,743,SG
1992,26,2,10,1,2,0,0,1,2,0,0,0,0,0,0,1,0,0,2,2,SG
1992,26,69,1304,275,591,12,47,263,544,179,253,105,101,206,102,66,39,100,113,741,SG
1992,28,81,3078,635,1240,83,189,552,1051,279,315,106,301,407,411,158,31,170,218,1632,SG
1992,24,27,318,54,104,1,2,53,102,22,31,17,34,51,14,11,8,15,55,131,SF
1992,29,71,2261,377,803,42,144,335,659,195,249,44,140,184,466,119,13,148,210,991,PG
1992,24,52,1280,160,355,59,136,101,219,107,128,27,71,98,194,33,1,92,79,486,PG
1992,24,5,54,11,23,0,0,11,23,4,6,5,5,10,3,2,0,4,7,26,SG
1992,26,81,2461,367,747,11,43,356,704,171,222,95,210,305,694,112,13,211,153,916,PG
1992,24,48,378,79,191,8,28,71,163,25,27,22,21,43,33,17,0,24,39,191,SG
1992,26,65,866,164,403,29,90,135,313,61,76,35,77,112,25,16,11,43,94,418,SF
1992,24,31,87,9,24,0,1,9,23,7,11,12,18,30,1,1,5,3,17,25,C
1992,26,69,1235,158,330,4,15,154,315,66,101,13,67,80,266,61,9,110,89,386,PG
1992,26,20,463,55,108,1,5,54,103,24,32,5,30,35,100,21,3,45,43,135,PG
1992,26,49,772,103,222,3,10,100,212,42,69,8,37,45,166,40,6,65,46,251,PG
1992,28,80,2202,290,633,1,9,289,624,104,143,95,217,312,158,72,49,104,234,685,SF
1992,32,81,2366,534,1164,27,107,507,1057,291,338,118,174,292,161,55,11,130,199,1386,SF
1992,25,78,2899,539,1125,10,46,529,1079,448,555,61,231,292,836,116,23,272,180,1536,PG
1992,22,82,3047,616,1258,5,22,611,1236,339,409,323,576,899,292,81,51,160,225,1576,PF
1992,35,60,1350,202,499,19,60,183,439,55,85,67,115,182,145,41,14,74,93,478,SG
1992,34,75,1365,33,90,0,0,33,90,20,40,105,212,317,62,43,92,39,214,86,C
1992,28,80,3102,943,1818,27,100,916,1718,491,590,91,420,511,489,182,75,200,201,2404,SG
1992,22,64,1808,362,718,0,3,362,715,270,361,264,401,665,86,70,124,156,261,994,PF
1992,26,48,847,121,237,32,74,89,163,45,54,14,64,78,110,27,10,31,29,319,PG
1992,29,77,2553,398,852,1,8,397,844,174,262,241,392,633,243,114,71,151,254,971,SF
1992,25,77,1197,158,383,0,0,158,383,94,115,114,200,314,34,17,32,58,185,410,PF
1992,25,34,277,44,111,4,13,40,98,20,31,13,19,32,17,10,6,15,37,112,SG
1992,32,6,59,11,30,2,7,9,23,7,8,1,10,11,5,3,0,2,7,31,SF
1992,22,40,213,27,71,0,1,27,70,34,45,20,29,49,12,4,5,18,42,88,C
1992,25,79,1268,215,425,2,5,213,420,119,158,87,118,205,77,21,25,76,129,551,PF
1992,30,72,1479,94,215,0,1,94,214,40,68,156,246,402,44,30,57,61,212,228,C
1992,30,70,991,144,293,4,8,140,285,34,48,94,202,296,32,23,14,27,99,326,C
1992,24,42,631,103,217,4,13,99,204,33,48,16,30,46,112,24,3,58,58,243,PG
1992,27,44,239,25,53,1,7,24,46,15,26,6,20,26,51,2,2,20,26,66,SG
1992,28,77,1489,111,284,0,12,111,272,19,29,62,199,261,132,50,67,54,207,241,C
1992,27,79,1848,293,660,0,5,293,655,128,169,131,298,429,114,54,12,115,218,714,PF
1992,34,81,2234,342,727,32,85,310,642,67,75,104,347,451,160,51,54,102,225,783,C
1992,25,14,177,14,46,0,0,14,46,9,27,32,34,66,17,2,1,14,28,37,PF
1992,25,9,141,10,40,0,0,10,40,8,19,22,22,44,13,2,1,10,18,28,PF
1992,25,3,30,3,5,0,0,3,5,0,6,9,9,18,4,0,0,3,9,6,PF
1992,25,2,6,1,1,0,0,1,1,1,2,1,3,4,0,0,0,1,1,3,PF
1992,25,81,1965,248,475,0,1,248,474,126,164,170,376,546,43,48,201,87,306,622,C
1992,25,59,716,79,154,0,1,79,153,38,51,49,157,206,31,9,18,39,114,196,C
1992,27,46,307,50,116,10,37,40,79,10,19,17,18,35,22,11,1,12,39,120,SG
1992,24,5,13,4,6,0,0,4,6,2,2,3,2,5,1,1,0,1,3,10,C
1992,28,62,712,74,192,45,131,29,61,38,47,11,52,63,143,31,3,42,58,231,PG
1992,31,31,884,135,349,17,52,118,297,60,80,56,105,161,107,46,12,36,73,347,SG
1992,31,79,1020,125,251,1,6,124,245,60,96,109,118,227,66,27,45,42,134,311,PF
1992,26,82,3070,703,1397,5,21,698,1376,292,343,117,277,394,185,125,105,136,258,1703,SG
1992,23,75,1527,275,621,17,50,258,571,131,180,144,164,308,58,66,29,90,165,698,SF
1992,25,68,1176,173,376,1,9,172,367,99,118,36,82,118,74,43,12,72,131,446,SG
1992,33,26,293,44,79,0,0,44,79,14,33,21,71,92,14,5,16,20,61,102,C
1992,27,70,1081,162,360,57,144,105,216,27,41,65,184,249,74,40,71,46,144,408,PF
1992,25,82,3063,440,890,6,22,434,868,326,404,259,432,691,225,139,40,185,248,1212,PF
1992,23,66,991,114,249,0,0,114,249,53,80,67,190,257,53,35,64,83,157,281,C
1992,23,55,819,93,223,3,8,90,215,35,46,30,55,85,83,37,9,44,107,224,SG
1992,22,76,2304,333,889,4,30,329,859,135,185,80,140,220,168,154,14,155,242,805,SG
1992,26,82,2853,551,1153,87,228,464,925,229,303,148,335,483,274,131,43,102,158,1418,SF
1992,30,81,2922,691,1353,1,12,690,1341,256,285,49,184,233,180,56,5,140,126,1639,SG
1992,28,81,3054,798,1516,3,17,795,1499,673,865,225,684,909,241,108,51,248,226,2272,PF
1992,36,82,2511,440,929,3,8,437,921,396,504,320,424,744,93,74,64,150,136,1279,C
1992,25,82,2904,650,1199,0,5,650,1194,279,385,229,335,564,285,135,122,210,293,1579,PF
1992,27,72,2117,491,912,3,10,488,902,376,477,68,140,208,243,116,10,193,237,1361,SG
1992,25,82,2198,203,399,0,0,203,399,167,260,216,357,573,106,46,20,101,229,573,PF
1992,24,18,90,10,25,0,0,10,25,9,15,7,18,25,0,1,1,9,21,29,PF
1992,24,1,9,1,5,0,0,1,5,0,0,0,0,0,0,0,0,0,2,2,PF
1992,24,3,13,0,3,0,0,0,3,1,2,1,3,4,0,1,0,4,2,1,PF
1992,24,7,46,4,9,0,0,4,9,2,4,2,7,9,0,0,1,2,7,10,PF
1992,24,7,22,5,8,0,0,5,8,6,9,4,8,12,0,0,0,3,10,16,PF
1992,26,80,2700,502,1216,162,473,340,743,206,267,37,206,243,326,104,28,178,200,1372,SG
1992,23,24,255,30,99,15,41,15,58,24,36,3,13,16,35,16,2,31,41,99,SG
1992,23,21,215,28,94,14,39,14,55,20,30,3,12,15,32,14,1,28,32,90,SG
1992,23,3,40,2,5,1,2,1,3,4,6,0,1,1,3,2,1,3,9,9,SG
1992,23,2,32,6,14,3,6,3,8,2,2,1,1,2,1,0,0,3,4,17,PG
1992,27,26,129,13,33,0,1,13,32,4,13,12,18,30,6,6,4,7,23,30,SF
1992,24,51,892,128,313,32,94,96,219,50,64,45,87,132,116,26,11,62,95,338,SF
1992,29,22,108,14,33,0,0,14,33,14,21,14,20,34,9,2,0,8,18,42,C
1992,30,75,2106,271,622,25,85,246,537,110,153,149,319,468,219,48,30,115,180,677,SF
1992,28,82,2344,488,1021,12,39,476,982,137,192,176,284,460,149,57,24,147,241,1125,SF
1992,34,56,1398,323,634,0,13,323,621,134,163,119,211,330,82,11,59,82,112,780,PF
1992,25,52,1757,285,604,19,50,266,554,188,222,95,173,268,120,61,47,114,142,777,SF
1992,27,2,9,2,9,0,0,2,9,0,0,0,1,1,0,0,0,0,1,4,SG
1992,27,72,1652,177,405,27,98,150,307,54,84,92,160,252,359,129,29,112,218,435,PG
1992,26,82,3120,562,1121,129,341,433,780,442,515,82,236,318,314,105,26,157,210,1695,SG
1992,24,82,1714,310,670,8,23,302,647,114,152,187,266,453,84,48,41,82,200,742,PF
1992,28,82,2151,307,725,2,11,305,714,209,266,158,315,473,94,53,39,97,230,825,PF
1992,23,38,313,53,144,6,27,47,117,19,23,12,21,33,27,12,2,23,19,131,SG
1992,26,42,782,130,325,30,84,100,241,65,78,31,51,82,48,32,4,44,97,355,SF
1992,26,77,2394,346,726,22,110,324,616,165,231,199,295,494,197,129,81,171,211,879,SF
1992,24,4,54,3,12,0,1,3,11,8,9,3,4,7,5,1,0,4,3,14,SG
1992,24,21,216,33,81,2,15,31,66,24,29,3,16,19,27,12,1,24,20,92,SF
1992,28,81,3346,830,1584,64,175,766,1409,350,420,127,323,450,286,173,62,202,171,2074,SF
1992,23,50,478,76,183,5,26,71,157,46,61,21,33,54,92,30,7,50,52,203,PG
1992,28,47,429,39,80,1,2,38,78,19,34,36,74,110,11,9,8,18,40,98,PF
1992,22,52,545,92,193,0,0,92,193,49,71,45,100,145,45,21,16,51,59,233,PF
1992,25,71,2716,428,869,0,0,428,869,321,500,316,554,870,156,43,210,252,273,1177,C
1992,32,81,2880,556,1032,0,6,556,1026,263,320,213,457,670,232,80,243,87,200,1375,PF
1992,31,52,505,62,121,20,50,42,71,16,24,25,86,111,37,16,2,17,45,160,PF
1992,32,4,9,1,3,0,0,1,3,0,0,0,1,1,1,0,0,3,2,2,C
1992,28,55,1651,295,618,13,46,282,572,236,308,71,108,179,146,70,14,129,181,839,SF
1992,27,77,2009,402,821,4,28,398,793,121,226,158,290,448,125,53,66,100,145,929,SF
1992,28,82,2309,210,402,0,3,210,399,86,117,256,444,700,133,67,15,123,258,506,PF
1992,24,43,367,46,84,0,0,46,84,16,30,30,44,74,7,5,28,19,73,108,C
1992,29,70,2636,591,1177,0,1,591,1176,328,428,246,599,845,157,127,304,187,263,1510,C
1992,23,34,279,33,100,0,4,33,96,15,22,10,20,30,20,10,2,24,33,81,SG
1992,22,27,252,39,98,1,9,38,89,17,22,9,18,27,20,9,2,9,22,96,SG
1992,22,80,2510,468,891,1,9,467,882,204,312,243,396,639,188,90,65,179,276,1141,PF
1992,22,20,80,9,32,0,0,9,32,8,10,8,7,15,3,5,4,2,11,26,SF
1992,22,72,894,115,272,0,10,115,262,102,127,32,65,97,140,40,4,92,101,332,PG
1992,38,79,2285,468,874,0,0,468,874,179,232,219,486,705,70,68,97,131,172,1115,C
1992,31,79,1946,257,487,12,44,245,443,29,37,21,75,96,241,49,9,44,142,555,PG
1992,25,49,353,65,145,5,12,60,133,9,13,13,41,54,17,16,8,19,34,144,SF
1992,23,81,2549,331,734,3,23,328,711,99,148,123,172,295,506,147,21,174,248,764,PG
1992,26,77,1007,152,278,1,2,151,276,45,91,108,204,312,80,16,43,72,133,350,C
1992,30,63,2332,361,803,15,69,346,734,304,372,192,364,556,141,64,62,83,192,1041,PF
1992,22,50,437,49,129,1,7,48,122,27,41,14,25,39,78,34,3,50,36,126,PG
1992,22,10,66,6,15,0,2,6,13,1,2,2,5,7,14,9,1,13,10,13,PG
1992,22,40,371,43,114,1,5,42,109,26,39,12,20,32,64,25,2,37,26,113,PG
1992,26,80,2483,413,789,3,8,410,781,153,215,204,347,551,134,44,116,141,237,982,PF
1992,27,81,2923,616,1284,132,354,484,930,133,197,114,312,426,382,68,18,216,247,1497,SF
1992,29,27,169,18,40,0,2,18,38,7,10,12,33,45,9,5,6,5,35,43,PF
1992,27,82,3027,668,1315,123,277,545,1038,232,287,97,161,258,252,105,11,215,248,1691,SG
1992,22,10,65,12,28,0,2,12,26,7,11,4,4,8,4,3,1,8,3,31,SG
1992,32,78,2658,620,1306,33,123,587,1183,417,455,93,140,233,241,86,20,189,213,1690,SG
1992,28,81,1917,203,378,0,1,203,377,207,255,252,312,564,62,70,56,73,158,613,PF
1992,26,82,3164,687,1359,16,80,671,1279,330,434,185,445,630,572,155,93,253,242,1720,SF
1992,27,76,1834,244,470,0,1,244,469,125,201,195,341,536,46,45,20,83,165,613,C
1992,27,5,26,3,7,0,1,3,6,1,2,2,3,5,3,2,1,4,5,7,PF
1992,28,82,2784,521,1129,128,324,393,805,315,368,51,204,255,477,127,12,188,155,1485,PG
1992,33,56,759,60,161,3,21,57,140,28,41,22,73,95,142,29,19,64,86,151,SG
1992,27,72,2138,438,897,101,261,337,636,270,285,38,135,173,535,94,12,159,113,1247,PG
1992,24,11,136,16,34,0,3,16,31,14,18,1,10,11,30,3,4,11,17,46,PG
1992,25,39,326,43,124,13,41,30,83,16,26,16,35,51,12,16,8,16,32,115,SG
1992,25,24,190,28,73,10,26,18,47,8,14,9,15,24,7,7,6,8,21,74,SG
1992,25,15,136,15,51,3,15,12,36,8,12,7,20,27,5,9,2,8,11,41,SG
1992,33,28,381,38,82,0,0,38,82,14,18,23,83,106,37,12,14,25,46,90,PF
1992,24,54,441,68,149,3,16,65,133,32,43,39,32,71,33,12,3,25,39,171,PF
1992,24,15,67,10,22,0,2,10,20,6,8,4,5,9,7,0,0,6,8,26,PF
1992,24,39,374,58,127,3,14,55,113,26,35,35,27,62,26,12,3,19,31,145,PF
1992,29,81,1968,347,726,5,23,342,703,30,40,94,299,393,107,35,48,51,233,729,C
1992,23,51,1257,213,435,0,3,213,432,134,190,96,221,317,81,49,23,84,159,560,C
1992,29,46,1159,197,518,3,24,194,494,158,189,47,102,149,151,63,17,96,69,555,SG
1992,24,79,3007,672,1432,155,396,517,1036,266,318,84,310,394,184,90,35,145,170,1765,SF
1992,25,82,2922,587,1261,53,155,534,1106,123,178,91,210,301,685,119,25,204,152,1350,PG
1992,26,80,3095,685,1465,103,268,582,1197,330,406,62,257,319,411,92,34,247,231,1803,SG
1992,27,15,122,10,30,0,1,10,29,10,11,10,9,19,21,7,1,17,14,30,PG
1992,30,59,1657,226,533,26,92,200,441,163,196,23,124,147,233,111,19,92,166,641,PG
1992,31,80,1746,311,645,19,37,292,608,128,171,103,154,257,122,52,40,122,177,769,PF
1992,21,55,1118,236,446,0,1,236,445,101,196,113,223,336,39,22,83,78,221,573,C
1992,29,82,2463,396,922,67,210,329,712,151,198,175,175,350,360,210,32,223,263,1010,SG
1992,31,9,78,11,27,0,1,11,26,7,8,7,12,19,9,5,0,7,4,29,PF
1992,25,82,2124,398,854,1,11,397,843,219,330,140,276,416,137,85,107,154,274,1016,SF
1992,26,68,2564,592,1074,1,8,591,1066,393,561,261,568,829,181,158,305,182,219,1578,C
1992,24,1,6,1,5,0,0,1,5,0,0,2,0,2,1,0,0,1,3,2,SG
1992,25,81,2220,423,928,34,104,389,824,175,275,64,155,219,446,105,24,206,178,1055,PG
1992,30,82,3301,342,635,32,101,310,534,84,140,523,1007,1530,191,68,70,140,248,800,PF
1992,36,59,697,46,86,0,0,46,86,26,30,61,110,171,15,14,62,18,85,118,C
1992,25,60,718,80,178,0,0,80,178,92,133,65,59,124,34,25,7,39,73,252,SF
1992,29,65,538,75,188,11,47,64,141,32,42,15,39,54,109,15,1,49,64,193,SG
1992,33,13,209,20,38,0,0,20,38,11,16,16,31,47,5,7,4,20,45,51,C
1992,27,72,1774,249,486,0,3,249,483,186,260,106,190,296,116,49,110,102,222,684,PF
1992,31,10,108,9,29,0,2,9,27,4,6,11,19,30,4,3,8,10,14,22,C
1992,26,12,117,20,45,0,0,20,45,7,9,9,17,26,9,5,3,5,15,47,SF
1992,31,31,633,92,161,1,3,91,158,36,47,27,69,96,53,24,10,22,83,221,SF
1992,31,10,81,11,22,0,0,11,22,5,6,0,8,8,11,2,1,6,8,27,SF
1992,31,21,552,81,139,1,3,80,136,31,41,27,61,88,42,22,9,16,75,194,SF
1992,32,43,726,83,199,0,0,83,199,74,96,58,110,168,34,19,19,41,98,240,C
1992,24,11,61,6,9,0,0,6,9,9,12,10,4,14,0,3,1,1,10,21,C
1992,24,4,15,2,2,0,0,2,2,5,6,2,1,3,0,0,1,0,2,9,C
1992,24,7,46,4,7,0,0,4,7,4,6,8,3,11,0,3,0,1,8,12,C
1992,23,33,400,50,117,0,4,50,113,10,12,43,75,118,20,6,28,19,67,110,C
1992,29,80,2605,496,925,23,71,473,854,365,441,202,568,770,312,62,37,191,286,1380,PF
1992,30,82,2679,460,1005,54,157,406,848,244,291,74,236,310,226,105,28,119,140,1218,SG
1992,23,18,608,133,331,29,89,104,242,64,71,14,52,66,35,20,9,31,49,359,SF
1992,26,79,2800,463,947,0,3,463,944,370,505,307,627,934,109,40,121,216,278,1296,C
1992,29,43,226,41,88,0,1,41,87,20,26,15,27,42,14,1,10,15,20,102,PF
1992,25,72,1399,205,422,0,1,205,421,63,95,145,270,415,46,38,51,62,205,473,C
1992,25,63,1423,209,513,5,23,204,490,72,91,50,154,204,250,57,22,99,115,495,PG
1992,25,17,436,70,164,0,7,70,157,35,40,11,58,69,89,12,10,32,29,175,PG
1992,25,46,987,139,349,5,16,134,333,37,51,39,96,135,161,45,12,67,86,320,PG
1992,23,78,2895,527,1162,1,5,526,1157,281,365,149,485,634,337,135,132,218,205,1336,SF
1992,27,75,2377,359,868,91,250,268,618,248,277,36,166,202,544,74,5,233,188,1057,PG
1992,26,49,1310,251,539,0,6,251,533,212,270,95,206,301,56,41,98,69,159,714,SF
1992,22,76,1707,291,702,0,11,291,691,89,121,129,262,391,129,62,34,97,259,671,PF
1992,26,81,2735,432,910,54,137,378,773,219,253,34,143,177,562,104,7,227,112,1137,PG
1992,22,48,708,100,246,2,21,98,225,45,56,30,51,81,99,44,1,63,98,247,SG
1992,34,45,800,50,92,0,1,50,91,4,11,107,149,256,33,21,7,44,121,104,PF
1992,28,55,877,116,318,8,21,108,297,70,91,40,76,116,57,36,13,62,85,310,SG
1992,22,61,1806,297,654,40,125,257,529,95,127,81,107,188,278,59,19,152,162,729,SG
1992,23,63,820,113,283,0,11,113,272,49,75,31,45,76,109,39,8,50,91,275,PG
1992,25,74,1772,436,855,0,2,436,853,152,193,124,293,417,116,29,100,130,231,1024,C
1992,33,46,489,58,151,3,15,55,136,8,13,3,25,28,83,12,5,33,57,127,PG
1992,33,4,18,1,8,1,2,0,6,0,0,0,1,1,4,0,0,2,2,3,PG
1992,33,42,471,57,143,2,13,55,130,8,13,3,24,27,79,12,5,31,55,124,PG
1992,24,61,1481,141,331,0,0,141,331,123,178,167,268,435,53,27,79,70,241,405,C
1992,26,82,2118,405,902,94,270,311,632,235,302,45,146,191,276,103,18,150,231,1139,SG
1992,23,76,2229,303,590,0,3,303,587,188,233,186,263,449,120,51,44,112,225,794,PF
1992,29,82,3002,453,939,83,204,370,735,308,366,68,202,270,1126,244,22,286,234,1297,PG
1992,25,57,2053,300,659,5,15,295,644,182,265,92,173,265,491,118,17,160,122,787,PG
1992,23,1,12,0,4,0,0,0,4,3,4,1,4,5,1,0,0,1,1,3,PF
1992,23,4,17,4,12,0,2,4,10,2,4,1,0,1,1,1,1,2,2,10,SG
1992,30,3,8,1,3,1,1,0,2,0,0,0,0,0,2,0,0,0,2,3,PG
1992,24,67,601,93,240,26,89,67,151,34,45,6,41,47,91,26,9,70,111,246,PG
1992,31,82,1602,364,805,1,4,363,801,151,197,91,92,183,113,66,9,114,148,880,SG
1992,22,1,31,5,12,1,2,4,10,1,2,0,0,0,1,1,0,1,3,12,SG
1992,22,36,156,18,51,2,17,16,34,10,15,6,16,22,22,4,1,17,20,48,SG
1992,30,78,2918,564,1264,25,86,539,1178,292,378,68,179,247,560,118,15,252,194,1445,PG
1992,30,80,1299,168,359,0,2,168,357,58,71,98,283,381,102,52,34,98,207,394,C
1992,23,19,91,14,37,0,1,14,36,3,8,11,8,19,8,6,3,5,9,31,SG
1992,23,1,15,1,3,0,0,1,3,0,0,0,1,1,1,0,0,2,2,2,SG
1992,23,18,76,13,34,0,1,13,33,3,8,11,7,18,7,6,3,3,7,29,SG
1992,29,2,6,1,7,0,0,1,7,2,2,2,0,2,0,0,0,0,1,4,PF
1992,29,82,3056,558,943,0,7,558,936,304,463,285,577,862,250,52,37,237,307,1420,PF
1992,30,82,3070,509,1041,20,62,489,979,202,243,43,210,253,593,168,16,182,231,1240,PG
1992,27,72,2521,522,1043,0,2,522,1041,151,198,135,334,469,106,55,79,124,248,1195,PF
1992,26,35,310,33,86,2,8,31,78,22,40,14,41,55,21,10,6,20,73,90,PF
1992,32,24,415,60,129,19,48,41,81,16,20,8,29,37,27,21,3,14,39,155,SG
1992,27,70,871,111,261,1,16,110,245,61,77,17,73,90,177,57,2,84,59,284,PG
1992,29,75,1591,225,499,1,8,224,491,79,114,62,184,246,92,24,16,106,229,530,SF
1992,24,42,345,43,98,0,0,43,98,31,59,38,40,78,12,6,4,32,40,117,SF
1992,33,67,956,188,383,26,66,162,317,65,81,31,57,88,57,15,8,27,87,467,SF
1992,23,79,1687,271,551,4,5,267,546,55,69,160,352,512,71,37,31,66,165,601,PF
1992,25,1,9,1,2,0,0,1,2,0,0,0,0,0,2,0,0,1,3,2,SF
1992,28,39,885,150,349,1,13,149,336,110,130,19,82,101,148,35,4,72,55,411,PG
1992,27,77,1516,251,569,35,110,216,459,125,198,103,162,265,250,66,30,102,178,662,C
1992,28,19,110,15,32,0,0,15,32,7,12,8,20,28,5,0,17,10,22,37,C
1992,30,74,1541,161,381,0,10,161,371,65,105,85,153,238,205,63,18,79,134,387,SG
1992,28,77,2724,448,1006,73,199,375,807,262,305,30,193,223,547,125,24,229,193,1231,PG
1992,24,80,2540,463,894,4,23,459,871,186,231,107,150,257,281,66,26,120,239,1116,SG
1992,31,82,1436,196,310,0,0,196,310,109,171,134,238,372,22,14,81,82,239,501,C
1992,29,23,209,21,51,0,4,21,47,27,31,6,15,21,34,14,3,14,12,69,PG
1992,24,65,1021,145,382,4,27,141,355,124,162,96,140,236,31,31,22,68,157,418,PF
1992,32,49,569,88,229,0,1,88,228,35,51,43,51,94,22,20,1,25,67,211,SG
1992,25,53,870,83,193,14,42,69,151,24,35,24,57,81,180,47,3,60,89,204,PG
1992,25,9,90,9,28,0,4,9,24,3,5,2,5,7,13,4,0,8,13,21,PG
1992,25,3,13,3,5,0,0,3,5,0,0,0,1,1,1,0,0,0,3,6,PG
1992,25,41,767,71,160,14,38,57,122,21,30,22,51,73,166,43,3,52,73,177,PG
1992,32,42,1601,424,914,37,128,387,786,294,352,103,192,295,158,52,24,122,77,1179,SF
1992,28,82,2344,431,964,38,108,393,856,116,159,74,132,206,219,76,17,113,195,1016,SG
1992,31,80,2519,340,563,0,1,340,562,221,293,260,444,704,108,62,41,130,244,901,PF
1992,33,75,2040,367,851,1,6,366,845,124,171,106,348,454,94,35,98,114,189,859,C
1992,29,80,2432,341,678,0,4,341,674,270,359,228,379,607,196,60,182,83,191,952,C
1992,23,50,646,75,206,0,0,75,206,56,88,62,83,145,12,20,20,44,110,206,PF
1992,22,60,565,113,218,0,4,113,214,26,43,64,65,129,40,20,41,22,99,252,SF
1992,25,79,2750,404,824,8,33,396,791,372,427,73,209,282,647,233,22,240,262,1188,PG
1992,27,81,2623,601,1277,56,156,545,1121,216,269,145,260,405,235,148,68,173,270,1474,SF
1992,23,63,690,83,172,0,3,83,169,48,74,90,157,247,50,13,36,35,122,214,PF
1992,29,81,2962,591,1224,6,37,585,1187,292,363,418,840,1258,173,72,54,197,223,1480,PF
1992,25,4,17,1,3,0,0,1,3,0,0,0,0,0,0,0,0,0,1,2,SG
1992,25,15,64,12,27,1,2,11,25,8,10,6,9,15,8,2,2,2,4,33,SF
1992,28,81,2127,266,572,1,18,265,554,105,146,80,189,269,247,123,21,124,162,638,SG
1992,32,24,115,8,19,0,0,8,19,1,2,1,8,9,11,2,0,3,4,17,SG
1992,27,67,1160,100,277,1,11,99,266,53,66,97,143,240,61,32,14,60,124,254,C
1992,32,82,2113,452,907,1,9,451,898,241,353,109,151,260,88,41,33,133,154,1146,SF
1992,30,54,2108,450,1007,9,43,441,964,166,204,98,207,305,252,76,23,127,89,1075,SF
1992,29,62,1023,100,255,23,70,77,185,57,67,16,59,75,172,46,4,47,53,280,PG
1992,29,18,134,16,40,3,10,13,30,10,14,0,9,9,20,6,0,5,6,45,PG
1992,29,44,889,84,215,20,60,64,155,47,53,16,50,66,152,40,4,42,47,235,PG
1993,24,75,1311,245,473,0,1,245,472,88,116,126,211,337,27,25,26,97,189,578,PF
1993,24,12,159,26,56,0,1,26,55,12,16,12,25,37,10,6,4,13,24,64,PF
1993,24,63,1152,219,417,0,0,219,417,76,100,114,186,300,17,19,22,84,165,514,PF
1993,23,81,2710,633,1407,70,197,563,1210,217,232,51,174,225,344,84,8,187,179,1553,PG
1993,30,18,269,26,49,1,2,25,47,11,16,26,41,67,5,3,6,13,34,64,C
1993,30,6,23,2,9,1,2,1,7,1,2,2,4,6,0,0,0,2,2,6,C
1993,30,12,246,24,40,0,0,24,40,10,14,24,37,61,5,3,6,11,32,58,C
1993,30,70,2499,365,831,68,212,297,619,237,277,52,188,240,526,100,4,175,146,1035,PG
1993,28,68,1164,182,411,7,34,175,377,57,70,45,87,132,53,23,11,64,125,428,SF
1993,33,51,1056,187,422,30,83,157,339,99,129,43,109,152,105,16,7,68,101,503,SF
1993,33,80,2163,337,730,150,372,187,358,123,145,49,165,214,260,69,8,113,175,947,SG
1993,23,72,1753,344,667,10,22,334,645,111,162,132,288,420,93,34,53,120,218,809,C
1993,22,16,44,5,18,0,0,5,18,11,13,6,8,14,3,3,1,5,14,21,PF
1993,22,55,2010,370,850,7,25,363,825,180,232,51,175,226,449,96,11,153,140,927,PG
1993,25,79,2920,594,1324,88,249,506,1075,298,402,122,355,477,265,128,56,164,200,1574,SG
1993,34,69,1263,225,544,39,120,186,424,72,89,62,122,184,93,31,5,63,75,561,SF
1993,26,38,560,80,186,1,8,79,178,22,28,7,50,57,79,14,6,44,52,183,SG
1993,25,70,1699,174,419,4,30,170,389,107,159,42,128,170,398,113,12,104,141,459,PG
1993,25,82,2492,408,818,63,139,345,679,130,151,27,122,149,330,66,6,83,169,1009,PG
1993,26,73,1129,152,309,2,6,150,303,105,149,62,99,161,122,40,19,69,135,411,SG
1993,26,9,76,8,17,0,0,8,17,11,15,7,4,11,5,2,1,8,11,27,SG
1993,26,64,1053,144,292,2,6,142,286,94,134,55,95,150,117,38,18,61,124,384,SG
1993,25,69,935,88,213,22,65,66,148,29,40,74,124,198,31,31,29,37,141,227,SF
1993,24,73,2112,397,792,0,4,397,788,227,307,141,146,287,170,91,18,157,141,1021,SG
1993,23,46,306,50,112,0,1,50,111,29,44,38,41,79,6,8,14,23,60,129,C
1993,23,82,2285,347,802,0,2,347,800,112,172,180,332,512,91,57,73,140,237,806,PF
1993,32,10,97,9,25,0,1,9,24,5,6,1,6,7,20,2,0,17,11,23,PG
1993,31,70,1276,203,446,0,0,203,446,119,142,53,162,215,61,20,47,60,88,525,PF
1993,24,23,175,19,62,1,6,18,56,12,17,10,27,37,29,8,3,17,28,51,SG
1993,29,76,2859,716,1376,67,220,649,1156,445,582,237,691,928,385,119,74,233,196,1944,PF
1993,25,69,1243,214,474,64,169,150,305,49,59,18,89,107,151,63,3,58,78,541,PG
1993,23,47,552,76,206,21,63,55,143,33,49,10,33,43,68,35,3,42,57,206,SG
1993,30,41,497,83,200,1,6,82,194,56,72,4,25,29,54,9,5,22,39,223,SG
1993,28,3,29,6,13,0,1,6,12,2,2,7,4,11,2,1,0,2,2,14,SG
1993,29,16,66,9,27,1,1,8,26,6,12,1,9,10,0,0,1,1,15,25,C
1993,28,59,754,133,271,0,0,133,271,69,104,51,158,209,22,31,48,78,134,335,C
1993,28,31,448,81,163,0,0,81,163,47,67,27,86,113,12,17,35,42,73,209,C
1993,28,28,306,52,108,0,0,52,108,22,37,24,72,96,10,14,13,36,61,126,C
1993,23,75,857,110,260,26,80,84,180,30,41,12,51,63,136,30,0,50,110,276,PG
1993,24,82,1712,258,592,34,98,224,494,114,152,116,276,392,43,45,43,90,201,664,SF
1993,33,60,1434,239,539,31,73,208,466,71,90,23,79,102,157,22,10,65,129,580,SG
1993,22,27,109,14,42,0,3,14,39,6,8,10,13,23,7,4,2,5,14,34,SF
1993,26,61,642,65,150,11,43,54,107,20,32,18,50,68,72,16,5,31,61,161,SG
1993,26,2,13,3,7,0,0,3,7,0,0,2,1,3,1,2,0,1,1,6,SF
1993,25,80,2820,414,964,118,315,296,649,123,169,89,191,280,671,203,23,187,156,1069,PG
1993,28,81,2833,331,730,6,26,325,704,140,168,51,247,298,711,161,5,154,179,808,PG
1993,30,58,855,52,127,10,32,42,95,12,19,44,149,193,18,14,119,50,87,126,C
1993,23,74,1578,227,565,7,42,220,523,129,167,52,144,196,122,75,18,112,223,590,SG
1993,24,70,1764,229,497,0,7,229,490,143,241,188,267,455,96,86,17,105,183,601,PF
1993,29,77,1761,268,569,15,48,253,521,67,84,36,158,194,175,54,14,84,131,618,SG
1993,31,79,2092,287,638,2,6,285,632,141,181,158,398,556,127,32,128,120,226,717,C
1993,22,82,1622,297,621,13,42,284,579,118,143,37,142,179,302,79,27,107,122,725,PG
1993,32,12,107,15,31,0,0,15,31,2,5,10,18,28,6,2,3,5,12,32,C
1993,33,66,2075,456,836,8,26,448,810,195,268,120,285,405,196,80,44,202,235,1115,C
1993,23,55,571,93,233,6,26,87,207,35,40,22,59,81,34,10,2,39,46,227,SF
1993,27,82,1516,183,385,41,99,142,286,112,135,22,77,99,243,79,3,72,136,519,PG
1993,24,77,1186,160,331,0,5,160,326,71,98,88,144,232,51,20,24,56,112,391,SF
1993,24,80,2254,328,701,26,82,302,619,192,242,45,201,246,461,138,32,136,203,874,PG
1993,29,82,1551,176,409,0,1,176,408,113,164,147,244,391,64,32,23,95,190,465,C
1993,24,75,1726,225,486,2,6,223,480,115,157,75,137,212,196,108,34,120,206,567,PG
1993,27,80,1396,186,370,0,1,186,369,104,148,132,192,324,41,37,23,65,226,476,C
1993,24,70,1287,176,403,20,59,156,344,65,87,81,114,195,94,47,19,55,98,437,SF
1993,25,79,1356,213,494,91,243,122,251,58,74,66,156,222,110,30,11,57,129,575,PF
1993,24,26,451,54,141,5,15,49,126,91,127,22,48,70,16,13,16,50,58,204,SF
1993,30,4,35,10,26,1,3,9,23,8,10,2,1,3,6,2,0,4,5,29,SG
1993,31,82,2156,219,416,0,1,219,415,61,130,268,391,659,69,76,46,59,183,499,C
1993,23,53,885,151,312,0,4,151,308,68,99,88,79,167,58,24,6,63,128,370,SF
1993,24,79,1551,238,520,0,3,238,517,130,204,127,205,332,48,59,100,69,165,606,PF
1993,30,58,1062,194,396,2,5,192,391,59,87,59,96,155,62,34,5,51,150,449,SF
1993,31,71,1947,379,705,0,5,379,700,174,224,107,281,388,97,35,87,96,264,932,PF
1993,35,63,1253,141,343,0,0,141,343,72,98,83,150,233,83,20,10,62,154,354,C
1993,29,21,262,36,73,0,0,36,73,27,34,18,28,46,5,4,1,25,31,99,PF
1993,24,55,1211,175,321,0,1,175,320,103,165,112,191,303,35,32,87,58,192,453,C
1993,23,74,1607,381,662,0,2,381,660,187,258,172,236,408,77,54,28,106,103,949,SF
1993,33,73,1723,320,716,11,28,309,688,241,288,96,249,345,101,43,23,92,212,892,PF
1993,25,60,1300,287,602,43,116,244,486,132,163,19,69,88,116,38,10,79,119,749,SG
1993,36,35,510,51,93,0,2,51,91,24,27,5,37,42,107,33,2,33,35,126,PG
1993,24,59,834,165,340,0,0,165,340,32,46,80,114,194,64,22,21,54,102,362,PF
1993,22,23,332,45,106,2,12,43,94,50,66,24,27,51,53,22,5,50,53,142,SG
1993,25,76,2759,564,1226,23,99,541,1127,421,521,247,605,852,276,92,126,243,210,1572,PF
1993,24,81,2232,318,686,42,137,276,549,177,220,58,108,166,373,80,11,108,199,855,PG
1993,25,46,467,81,171,0,4,81,167,57,81,48,75,123,37,13,5,28,43,219,C
1993,33,31,422,28,62,0,0,28,62,18,19,16,33,49,65,34,4,21,39,74,PG
1993,23,65,645,62,158,7,30,55,128,25,35,13,37,50,150,18,2,69,66,156,PG
1993,30,82,2555,385,766,0,5,385,761,180,218,194,325,519,173,108,32,108,252,950,SF
1993,24,10,105,14,24,0,3,14,21,16,21,1,6,7,16,6,0,8,18,44,PG
1993,24,9,102,13,23,0,3,13,20,16,21,1,6,7,16,6,0,8,17,42,PG
1993,24,1,3,1,1,0,0,1,1,0,0,0,0,0,0,0,0,0,1,2,PG
1993,23,12,104,13,32,0,0,13,32,7,9,4,15,19,3,5,5,6,17,33,PF
1993,23,5,34,4,9,0,0,4,9,3,4,2,0,2,1,2,1,3,9,11,PF
1993,23,7,70,9,23,0,0,9,23,4,5,2,15,17,2,3,4,3,8,22,PF
1993,23,40,243,37,72,2,14,35,58,26,38,4,13,17,55,11,0,30,29,102,PG
1993,31,8,76,11,29,0,0,11,29,5,10,6,13,19,4,1,1,2,17,27,PF
1993,27,20,166,16,41,0,0,16,41,26,36,17,32,49,12,7,2,8,30,58,C
1993,28,80,2094,498,1102,95,237,403,865,136,157,51,235,286,180,87,23,129,150,1227,SG
1993,25,77,1573,285,644,59,177,226,467,72,99,86,130,216,148,38,30,102,144,701,SG
1993,27,71,2691,520,911,1,2,519,909,391,492,164,562,726,312,53,56,150,174,1432,C
1993,23,82,2264,304,535,0,0,304,535,119,225,291,432,723,69,63,148,79,274,727,PF
1993,22,50,815,110,251,6,19,104,232,43,54,13,43,56,83,22,4,45,71,269,SG
1993,25,75,2462,393,863,2,8,391,855,167,281,259,442,701,68,36,28,160,199,955,PF
1993,29,74,1598,258,590,26,84,232,506,113,142,33,103,136,339,80,4,121,91,655,PG
1993,23,71,1931,358,828,54,184,304,644,213,297,144,147,291,117,75,48,118,222,983,SG
1993,26,73,1526,218,430,6,24,212,406,101,117,19,144,163,291,44,1,92,146,543,PG
1993,23,21,240,40,78,0,1,40,77,16,20,24,32,56,5,14,17,25,48,96,PF
1993,24,82,2525,397,819,21,75,376,744,235,341,220,509,729,232,128,140,214,311,1050,C
1993,35,6,94,8,14,0,0,8,14,5,9,6,23,29,1,1,7,4,13,21,C
1993,26,79,1932,264,530,6,29,258,501,84,150,65,97,162,508,49,10,161,166,618,PG
1993,30,43,239,19,58,0,4,19,54,8,15,26,40,66,8,5,8,9,60,46,C
1993,30,49,1671,350,816,31,133,319,683,245,292,126,183,309,278,95,37,115,159,976,SG
1993,28,74,1762,301,688,0,2,301,686,127,174,118,269,387,70,45,39,87,222,729,C
1993,27,71,1398,94,266,0,0,94,266,57,110,215,298,513,16,17,103,54,195,245,C
1993,29,77,3094,677,1454,112,299,565,1155,343,397,63,85,148,308,78,7,138,141,1809,SG
1993,23,48,1320,302,576,1,3,301,573,152,215,100,123,223,60,85,39,92,127,757,SF
1993,25,5,78,6,25,0,0,6,25,9,12,5,9,14,4,1,1,7,6,21,SF
1993,36,64,1104,71,130,0,0,71,130,35,50,73,191,264,17,18,79,43,143,177,C
1993,27,82,2729,554,1083,37,106,517,977,237,300,123,259,382,214,129,45,175,242,1382,SF
1993,37,52,617,122,270,0,0,122,270,84,118,30,70,100,41,10,7,51,122,328,C
1993,27,40,1134,216,462,5,17,211,445,119,141,48,73,121,120,68,12,75,69,556,SG
1993,31,82,2559,385,785,93,244,292,541,86,120,113,290,403,254,104,22,124,170,949,SG
1993,29,82,1757,240,524,45,129,195,395,183,214,59,157,216,177,74,20,89,145,708,SF
1993,24,70,2604,451,918,37,104,414,814,268,337,85,237,322,265,68,28,152,132,1207,SF
1993,32,82,2731,545,1092,119,297,426,795,157,197,81,231,312,107,78,18,111,179,1366,SG
1993,22,82,2749,483,958,2,13,481,945,237,317,274,470,744,151,72,111,153,293,1205,PF
1993,25,49,1701,341,655,0,4,341,651,170,242,138,295,433,117,45,108,110,154,852,C
1993,22,6,31,3,10,0,3,3,7,0,2,2,4,6,1,3,2,4,5,6,SG
1993,30,81,3003,779,1550,1,7,778,1543,400,556,191,789,980,151,74,161,265,286,1959,C
1993,27,82,1736,327,696,9,36,318,660,176,226,97,94,191,132,59,17,103,160,839,SF
1993,26,76,1461,220,459,34,82,186,377,99,113,81,198,279,137,29,49,83,171,573,PF
1993,30,75,1503,280,554,7,36,273,518,143,197,63,106,169,224,63,9,121,126,710,PG
1993,32,52,867,124,305,16,56,108,249,81,102,14,72,86,132,32,6,68,59,345,PG
1993,24,43,298,55,120,0,4,55,116,15,21,32,51,83,21,3,14,25,58,125,PF
1993,24,10,93,11,25,0,0,11,25,2,3,8,19,27,11,0,5,9,17,24,PF
1993,24,33,205,44,95,0,4,44,91,13,18,24,32,56,10,3,9,16,41,101,PF
1993,23,71,1082,184,380,4,23,180,357,81,101,55,104,159,113,61,21,77,133,453,SF
1993,27,82,2541,459,906,52,139,407,767,123,149,46,200,246,226,86,37,81,185,1093,SF
1993,28,66,1004,152,343,6,13,146,330,81,89,32,76,108,138,39,4,67,116,391,PG
1993,25,70,1248,249,462,0,6,249,456,150,207,129,191,320,40,44,53,102,197,648,PF
1993,28,75,1475,203,384,0,3,203,381,102,169,108,245,353,68,48,55,64,237,508,PF
1993,23,48,554,76,145,0,4,76,141,62,92,46,74,120,14,15,18,36,123,214,C
1993,24,48,380,51,135,0,5,51,130,20,24,9,18,27,59,10,3,31,25,122,PG
1993,24,69,2430,463,1032,17,62,446,970,224,290,120,220,340,268,98,36,174,191,1167,SG
1993,28,80,1742,359,774,0,1,359,773,274,325,136,336,472,116,37,54,157,123,992,PF
1993,25,60,848,142,339,7,33,135,306,25,39,61,81,142,77,33,18,35,104,316,SF
1993,25,4,71,8,27,0,2,8,25,4,6,1,2,3,9,3,0,5,6,20,SF
1993,25,56,777,134,312,7,31,127,281,21,33,60,79,139,68,30,18,30,98,296,SF
1993,33,34,251,42,83,0,0,42,83,9,10,34,51,85,7,1,9,11,28,93,C
1993,25,80,1508,256,560,42,141,214,419,96,131,61,129,190,164,86,6,120,185,650,SG
1993,27,74,1624,210,476,11,42,199,434,55,74,27,112,139,353,106,9,129,168,486,PG
1993,26,72,996,77,220,20,68,57,152,20,31,24,43,67,206,43,1,54,73,194,PG
1993,27,72,2667,560,1149,1,10,559,1139,218,300,133,279,412,205,72,44,90,168,1339,SF
1993,27,77,2745,421,829,1,5,420,824,174,281,341,388,729,201,89,96,110,218,1017,PF
1993,27,48,1025,165,353,2,14,163,339,91,136,71,86,157,70,31,8,54,120,423,SG
1993,29,82,2819,379,706,16,46,363,660,277,375,287,424,711,116,88,39,116,149,1051,PF
1993,22,52,626,87,198,1,10,86,188,60,96,11,23,34,116,23,4,42,70,235,PG
1993,22,13,81,28,55,3,10,25,45,3,4,4,5,9,7,2,1,9,11,62,SG
1993,32,39,329,34,89,0,2,34,87,25,31,32,86,118,24,6,5,20,37,93,PF
1993,32,15,202,20,49,0,0,20,49,13,15,18,53,71,19,5,3,12,21,53,PF
1993,32,24,127,14,40,0,2,14,38,12,16,14,33,47,5,1,2,8,16,40,PF
1993,23,81,2795,484,1135,38,135,446,1000,181,281,219,562,781,306,134,35,230,195,1187,PF
1993,23,32,215,19,55,0,0,19,55,13,25,26,38,64,17,9,10,10,48,51,C
1993,25,54,713,105,221,0,1,105,220,38,62,38,89,127,24,18,12,34,77,248,PF
1993,25,19,142,19,45,0,0,19,45,5,8,5,26,31,8,0,4,3,20,43,PF
1993,25,35,571,86,176,0,1,86,175,33,54,33,63,96,16,18,8,31,57,205,PF
1993,26,66,2609,522,1168,102,309,420,859,273,367,60,203,263,699,116,12,220,152,1419,PG
1993,31,62,2108,393,939,101,257,292,682,239,316,42,81,123,334,80,16,136,145,1126,SG
1993,29,80,2970,542,1203,52,186,490,1017,307,399,117,308,425,360,177,73,222,212,1443,SG
1993,32,76,670,57,112,2,8,55,104,40,55,44,93,137,34,12,8,29,115,156,C
1993,26,81,2977,551,1172,122,307,429,865,419,487,91,255,346,317,137,30,180,189,1643,SG
1993,24,53,719,71,182,37,80,34,102,34,40,12,43,55,155,30,1,52,85,213,PG
1993,26,81,1800,240,444,0,2,240,442,125,176,148,306,454,61,47,35,92,190,605,PF
1993,33,69,1425,199,483,43,133,156,350,130,151,66,127,193,119,51,29,63,141,571,SF
1993,24,29,591,96,215,13,37,83,178,35,47,23,45,68,66,13,5,64,54,240,SF
1993,24,74,2070,251,494,0,4,251,490,138,221,255,499,754,68,41,40,92,320,640,C
1993,23,79,1267,161,400,0,0,161,400,71,104,93,201,294,75,33,37,90,204,393,C
1993,28,2,10,1,1,0,0,1,1,0,2,1,3,4,0,0,0,0,2,2,C
1993,29,79,2860,582,1239,97,249,485,990,250,289,84,258,342,548,131,21,222,203,1511,PG
1993,22,79,2330,323,682,12,47,311,635,143,200,113,279,392,191,80,83,156,210,801,SF
1993,23,79,1274,145,325,2,7,143,318,129,194,119,196,315,69,44,43,87,253,421,PF
1993,25,68,1295,183,414,1,7,182,407,72,94,66,146,212,67,55,34,68,217,439,SF
1993,22,49,260,35,93,0,0,35,93,34,53,26,34,60,10,15,12,23,58,104,SF
1993,30,78,2034,287,659,15,75,272,584,101,130,40,103,143,317,101,11,132,236,690,SG
1993,26,4,45,9,18,1,1,8,17,3,6,2,2,4,2,1,0,4,5,22,SG
1993,25,70,1769,221,478,54,144,167,334,114,149,31,109,140,328,49,6,129,101,610,PG
1993,25,34,350,53,128,2,5,51,123,23,27,19,20,39,35,19,5,17,45,131,SG
1993,22,28,938,184,466,21,73,163,393,68,92,42,80,122,131,40,11,115,80,457,SF
1993,27,82,3117,459,945,22,82,437,863,241,300,129,259,388,724,136,12,220,158,1181,PG
1993,27,10,88,21,51,3,13,18,38,22,26,7,4,11,1,3,0,7,9,67,PF
1993,27,8,79,20,45,3,10,17,35,17,20,6,4,10,1,3,0,7,9,60,PF
1993,27,2,9,1,6,0,3,1,3,5,6,1,0,1,0,0,0,0,0,7,PF
1993,24,8,136,25,42,5,9,20,33,14,18,2,9,11,23,4,0,7,18,69,PG
1993,27,75,2030,256,510,0,8,256,502,144,182,20,126,146,561,85,16,145,141,656,PG
1993,29,73,1287,193,403,0,3,193,400,92,126,78,117,195,89,36,18,70,187,478,SF
1993,22,42,356,57,149,3,14,54,135,40,59,18,30,48,13,8,1,28,23,157,SG
1993,33,82,1869,463,991,17,56,446,935,234,257,124,148,272,135,36,4,134,173,1177,SF
1993,34,77,1122,136,312,1,12,135,300,59,76,41,72,113,186,60,8,80,112,332,PG
1993,26,49,1643,282,565,1,8,281,557,226,276,30,74,104,384,85,19,151,100,791,PG
1993,23,82,3323,728,1385,18,71,710,1314,336,438,281,583,864,353,53,27,227,187,1810,PF
1993,35,67,1206,33,63,0,1,33,62,22,38,87,190,277,42,38,77,38,144,88,C
1993,29,78,3067,992,2003,81,230,911,1773,476,569,135,387,522,428,221,61,207,188,2541,SG
1993,24,4,106,18,41,0,0,18,41,8,17,5,14,19,3,3,5,12,14,44,PF
1993,22,82,1549,188,376,0,1,188,375,166,237,171,261,432,80,57,16,100,195,542,PF
1993,23,78,2582,515,1047,0,4,515,1043,358,503,287,546,833,155,119,146,217,327,1388,PF
1993,29,30,167,19,48,0,0,19,48,18,31,12,27,39,19,4,4,16,30,56,PF
1993,27,5,41,5,10,0,2,5,8,2,2,0,7,7,11,2,0,2,2,12,PG
1993,27,47,440,48,112,6,24,42,88,20,22,5,33,38,59,8,1,25,34,122,SG
1993,30,65,1719,281,642,8,28,273,614,116,183,126,280,406,121,80,41,84,181,686,SF
1993,26,40,415,57,122,5,11,52,111,36,47,25,66,91,14,4,12,21,63,155,PF
1993,26,9,55,14,33,2,8,12,25,3,8,3,8,11,5,1,0,6,10,33,SG
1993,26,3,15,2,6,1,2,1,4,0,0,0,0,0,1,1,0,0,1,5,PG
1993,36,32,430,91,177,2,7,89,170,39,57,35,41,76,18,11,3,21,53,223,SF
1993,23,3,12,2,5,0,0,2,5,2,2,1,4,5,1,0,0,3,1,6,C
1993,26,76,1059,160,340,2,6,158,334,86,122,105,102,207,71,26,20,70,128,408,C
1993,31,64,640,38,84,0,1,38,83,13,24,66,127,193,10,13,12,35,133,89,C
1993,31,78,1129,108,267,0,6,108,261,41,58,113,233,346,39,17,17,37,123,257,C
1993,25,52,888,124,317,0,7,124,310,67,86,28,36,64,145,23,4,73,66,315,PG
1993,28,7,41,3,13,0,1,3,12,11,14,0,1,1,10,2,1,3,1,17,SG
1993,29,78,1975,124,267,3,8,121,259,24,50,100,327,427,140,75,100,52,264,275,C
1993,28,71,1362,198,425,0,1,198,424,117,147,74,205,279,68,42,13,62,181,513,PF
1993,23,81,2823,503,1061,4,40,499,1021,462,553,171,537,708,223,105,83,275,290,1472,PF
1993,35,79,1933,292,574,10,27,282,547,93,104,110,309,419,127,46,40,59,212,687,C
1993,26,21,149,27,54,0,0,27,54,5,20,24,29,53,17,12,3,7,32,59,PF
1993,26,73,1861,149,351,1,5,148,346,87,114,136,300,436,79,46,141,89,261,386,C
1993,28,5,33,2,7,1,3,1,4,0,0,0,2,2,5,0,1,3,7,5,SG
1993,26,33,635,105,241,22,65,83,176,57,71,25,34,59,46,24,6,28,63,289,SG
1993,26,3,5,1,3,0,0,1,3,0,0,0,1,1,0,0,0,0,0,2,SG
1993,26,30,630,104,238,22,65,82,173,57,71,25,33,58,46,24,6,28,63,287,SG
1993,29,73,881,110,259,66,154,44,105,42,50,20,69,89,169,40,7,48,81,328,PG
1993,27,80,3144,663,1410,14,60,649,1350,326,376,88,259,347,298,118,77,133,248,1666,SG
1993,24,78,1585,252,620,22,59,230,561,102,156,131,204,335,105,64,21,79,143,628,SF
1993,26,48,752,124,276,2,6,122,270,81,102,35,67,102,52,28,11,49,60,331,SG
1993,34,20,174,19,42,0,0,19,42,7,13,15,29,44,5,0,9,18,40,45,C
1993,28,80,1766,283,614,85,230,198,384,73,101,59,217,276,127,47,74,93,178,724,PF
1993,26,76,2728,397,847,6,26,391,821,261,341,197,371,568,182,104,31,133,264,1061,PF
1993,24,55,1045,133,292,0,0,133,292,53,74,71,169,240,51,47,77,88,169,319,C
1993,24,40,324,30,59,0,1,30,58,26,38,12,23,35,25,11,6,24,44,86,SG
1993,22,40,267,47,118,3,22,44,96,45,58,18,30,48,15,14,5,22,44,142,SF
1993,23,62,674,157,361,3,6,154,355,90,111,33,89,122,39,11,4,42,82,407,PF
1993,23,48,1141,158,381,0,6,158,375,42,60,33,70,103,126,69,3,72,135,358,PG
1993,34,74,1077,101,214,1,3,100,211,88,110,93,186,279,33,19,31,58,156,291,PF
1993,27,82,3199,509,1096,167,438,342,658,203,261,120,263,383,311,138,33,133,180,1388,SG
1993,31,79,2558,595,1205,3,9,592,1196,236,277,31,142,173,128,42,4,125,117,1429,SG
1993,29,82,3099,797,1443,4,20,793,1423,619,836,227,692,919,308,124,85,240,261,2217,PF
1993,37,11,104,13,42,0,0,13,42,24,31,22,24,46,7,1,8,10,6,50,C
1993,26,79,2761,702,1379,8,30,694,1349,388,484,198,322,520,207,108,101,230,323,1800,PF
1993,28,30,836,178,328,3,15,175,313,162,213,40,57,97,105,51,2,76,92,521,SF
1993,26,81,2482,316,629,0,0,316,629,199,292,231,409,640,170,43,19,137,240,831,PF
1993,23,43,520,93,169,0,1,93,168,45,70,66,98,164,12,11,18,38,75,231,PF
1993,27,71,2251,349,858,120,361,229,497,164,228,29,192,221,297,86,8,140,124,982,SG
1993,22,82,1503,171,375,43,110,128,265,39,68,26,92,118,273,59,7,85,148,424,PG
1993,24,49,787,129,309,29,84,100,225,54,82,20,33,53,72,21,3,51,59,341,PG
1993,28,79,1536,200,410,0,2,200,408,95,152,92,190,282,68,51,58,79,202,495,SF
1993,25,78,1500,216,525,58,181,158,344,75,102,60,145,205,192,53,11,107,165,565,SF
1993,31,64,1019,92,204,2,5,90,199,36,52,53,105,158,81,12,15,53,99,222,SF
1993,29,82,2215,457,924,6,22,451,902,191,241,168,321,489,163,72,51,171,249,1111,PF
1993,35,71,1656,298,649,2,18,296,631,164,195,95,263,358,73,16,59,92,126,762,PF
1993,26,77,2439,387,780,40,112,347,668,220,297,121,206,327,197,105,58,152,208,1034,SF
1993,28,73,1977,213,459,25,65,188,394,95,134,84,222,306,384,173,33,139,240,546,PG
1993,22,56,1069,121,255,0,3,121,252,71,100,70,205,275,118,38,100,108,145,313,C
1993,27,82,2954,571,1193,167,419,404,774,427,485,67,191,258,262,120,26,145,182,1736,SG
1993,25,81,2183,494,1072,10,36,484,1036,201,254,176,296,472,111,44,50,142,282,1199,PF
1993,21,73,1383,292,615,3,9,289,606,163,214,74,73,147,73,34,8,92,130,750,SG
1993,29,81,1402,215,483,4,23,211,460,150,185,93,155,248,76,23,10,51,207,584,SF
1993,27,39,510,103,249,23,67,80,182,53,61,23,29,52,47,21,4,32,54,282,SG
1993,27,77,2302,436,907,17,76,419,831,197,248,227,227,454,106,144,52,119,171,1086,SF
1993,23,25,102,26,57,0,0,26,57,3,4,6,6,12,4,3,1,8,14,55,SF
1993,22,78,2644,572,1119,0,3,572,1116,495,634,263,542,805,76,27,271,236,286,1639,C
1993,29,46,1902,474,930,60,133,414,797,183,226,42,190,232,166,68,41,139,76,1191,SF
1993,24,79,2437,438,936,31,119,407,817,231,296,95,189,284,603,174,7,207,177,1138,PG
1993,21,48,495,108,260,21,70,87,190,35,40,40,43,83,11,8,5,31,59,272,SF
1993,23,32,336,57,130,0,1,57,129,33,53,29,54,83,10,14,11,22,40,147,PF
1993,26,82,3029,398,781,0,0,398,781,335,492,344,726,1070,147,43,287,216,284,1131,C
1993,33,77,2753,533,971,0,4,533,967,202,247,184,484,668,223,54,198,107,223,1268,PF
1993,32,41,308,26,69,8,27,18,42,9,12,12,52,64,15,12,2,7,41,69,PF
1993,32,30,229,16,46,7,22,9,24,7,10,8,40,48,13,9,1,5,35,46,PF
1993,32,11,79,10,23,1,5,9,18,2,2,4,12,16,2,3,1,2,6,23,PF
1993,25,33,311,42,113,1,8,41,105,34,60,19,18,37,57,23,1,32,42,119,SG
1993,29,64,1471,279,534,12,45,267,489,194,240,72,71,143,117,45,19,90,154,764,SF
1993,28,76,2477,498,975,10,38,488,937,131,220,209,362,571,165,59,58,125,156,1137,SF
1993,20,81,3071,733,1304,0,2,733,1302,427,721,342,780,1122,152,60,286,307,321,1893,C
1993,24,6,17,3,5,0,0,3,5,3,4,2,4,6,1,1,0,0,4,9,C
1993,24,3,10,2,3,0,0,2,3,0,0,2,2,4,0,0,0,0,1,4,C
1993,24,3,7,1,2,0,0,1,2,3,4,0,2,2,1,1,0,0,3,5,C
1993,29,82,2230,219,431,0,1,219,430,127,176,288,420,708,126,85,15,124,289,565,PF
1993,25,6,29,5,13,0,0,5,13,3,4,3,7,10,4,1,3,3,6,13,C
1993,25,3,26,3,9,0,0,3,9,2,2,1,5,6,4,1,3,3,6,8,C
1993,25,3,3,2,4,0,0,2,4,1,2,2,2,4,0,0,0,0,0,5,C
1993,30,82,3242,848,1603,0,8,848,1595,444,570,283,785,1068,291,150,342,262,305,2140,C
1993,23,4,39,3,5,2,4,1,1,0,2,1,1,2,7,1,0,4,7,8,PG
1993,23,45,990,152,323,3,13,149,310,59,81,25,81,106,157,31,6,72,81,366,PG
1993,23,37,1201,247,493,1,11,246,482,117,183,108,156,264,144,35,28,106,105,612,PF
1993,23,77,1579,285,606,1,8,284,598,239,311,52,108,160,335,81,10,185,182,810,PG
1993,27,41,307,71,159,2,8,69,151,14,21,17,33,50,33,14,6,16,24,158,SF
1993,24,20,124,27,57,0,0,27,57,6,9,12,32,44,5,1,5,10,29,60,C
1993,39,79,2146,416,777,0,0,416,777,162,235,246,494,740,61,57,107,120,201,994,C
1993,32,59,1030,105,233,19,41,86,192,17,20,9,39,48,136,38,2,31,99,246,PG
1993,26,13,154,38,90,4,18,34,72,4,4,4,20,24,18,5,2,7,15,84,SF
1993,24,82,2548,476,963,7,34,469,929,151,196,95,186,281,399,177,21,148,250,1110,PG
1993,23,77,1656,297,634,46,118,251,516,162,206,64,115,179,166,60,14,123,193,802,SG
1993,27,72,998,137,246,0,1,137,245,67,111,103,184,287,74,22,47,74,139,341,C
1993,31,79,2351,381,799,24,71,357,728,250,305,163,361,524,156,60,82,108,225,1036,PF
1993,31,49,1589,242,527,5,29,237,498,184,222,111,268,379,128,40,51,76,139,673,PF
1993,31,30,762,139,272,19,42,120,230,66,83,52,93,145,28,20,31,32,86,363,PF
1993,27,81,2104,287,613,10,49,277,564,147,207,154,255,409,126,40,91,123,159,731,PF
1993,28,78,2985,541,1248,118,332,423,916,109,168,98,335,433,343,67,30,219,198,1309,SF
1993,28,70,2660,587,1134,75,167,512,967,315,362,42,148,190,247,94,13,204,237,1564,SG
1993,23,31,139,38,82,2,5,36,77,15,25,6,11,17,10,10,2,18,19,93,SG
1993,33,77,2218,524,1071,42,113,482,958,313,352,58,134,192,220,100,7,160,167,1403,SG
1993,29,7,151,10,24,0,0,10,24,12,13,14,29,43,1,4,7,8,13,32,PF
1993,27,81,3123,628,1327,22,93,606,1234,232,350,203,418,621,507,173,73,246,219,1510,SF
1993,30,60,737,106,228,0,3,106,225,69,95,53,120,173,40,14,11,78,141,281,PF
1993,28,67,1299,210,429,0,1,210,428,66,142,181,237,418,29,31,21,54,126,486,C
1993,29,81,2883,503,1108,143,345,360,763,327,388,58,258,316,419,101,10,199,122,1476,PG
1993,34,18,268,29,66,0,4,29,62,21,27,8,23,31,30,11,5,23,36,79,SG
1993,24,68,859,100,279,8,48,92,231,54,68,28,75,103,154,56,3,85,90,262,PG
1993,28,75,2380,477,986,122,293,355,693,289,305,37,164,201,602,89,11,196,105,1365,PG
1993,26,8,37,8,18,0,0,8,18,1,3,2,6,8,2,2,2,5,5,17,PF
1993,34,72,822,67,129,0,2,67,127,43,65,77,150,227,53,43,18,42,122,177,PF
1993,34,5,41,4,7,0,0,4,7,1,2,2,4,6,1,3,0,6,3,9,PF
1993,34,67,781,63,122,0,2,63,120,42,63,75,146,221,52,40,18,36,119,168,PF
1993,25,37,248,40,80,1,8,39,72,16,26,27,28,55,11,4,2,17,33,97,PF
1993,25,35,240,40,79,1,7,39,72,16,26,27,28,55,10,4,2,16,32,97,PF
1993,30,22,283,30,80,2,6,28,74,9,13,20,35,55,5,5,10,12,61,71,C
1993,24,83,1887,283,595,0,5,283,590,214,280,120,336,456,80,47,31,125,266,780,PF
1993,24,17,295,42,98,0,1,42,97,43,58,20,50,70,24,11,5,24,49,127,PF
1993,24,66,1592,241,497,0,4,241,493,171,222,100,286,386,56,36,26,101,217,653,PF
1993,25,82,3082,582,1324,148,386,434,938,242,295,92,332,424,180,92,25,157,201,1554,SF
1993,26,74,2396,337,703,3,29,334,674,92,124,63,204,267,573,94,12,167,132,769,PG
1993,27,45,1728,371,782,48,130,323,652,197,233,18,136,154,221,53,9,130,137,987,SG
1993,31,77,1886,216,494,39,123,177,371,133,162,26,166,192,405,123,9,114,215,604,PG
1993,32,79,1488,226,428,12,29,214,399,135,169,91,146,237,118,57,27,67,138,599,C
1993,22,77,1816,375,711,0,0,375,711,120,246,181,297,478,59,34,141,121,332,870,C
1993,30,69,2006,247,539,40,122,207,417,84,128,107,162,269,263,155,18,133,218,618,SG
1993,30,39,1065,139,290,17,55,122,235,44,70,47,90,137,156,90,9,77,120,339,SG
1993,30,30,941,108,249,23,67,85,182,40,58,60,72,132,107,65,9,56,98,279,SG
1993,26,82,2575,632,1336,19,77,613,1259,287,416,165,377,542,182,98,163,173,287,1570,PF
1993,27,82,3211,676,1348,3,17,673,1331,561,766,229,727,956,301,127,264,241,239,1916,C
1993,25,4,33,6,16,0,1,6,15,3,5,1,2,3,3,1,1,1,0,15,SG
1993,26,80,1585,270,638,20,56,250,582,112,195,49,110,159,323,96,12,140,169,672,PG
1993,31,62,2410,183,429,15,73,168,356,87,163,367,765,1132,102,48,45,103,201,468,PF
1993,37,42,247,11,41,0,2,11,39,9,12,12,48,60,10,6,15,9,43,31,C
1993,23,72,2087,368,747,0,2,368,745,234,389,196,340,536,95,38,81,160,204,970,C
1993,26,77,1636,194,391,0,3,194,388,318,390,116,179,295,80,36,25,113,179,706,SF
1993,30,15,95,7,36,1,11,6,25,11,14,4,5,9,17,1,0,11,7,26,PG
1993,34,11,55,5,11,0,0,5,11,2,4,9,9,18,2,2,0,6,16,12,C
1993,28,51,1422,154,307,0,0,154,307,115,144,113,200,313,83,32,70,101,192,423,PF
1993,27,9,120,10,25,0,0,10,25,4,8,12,17,29,6,8,1,11,16,24,PF
1993,32,53,1189,197,396,1,4,196,392,59,78,52,118,170,75,39,30,57,150,454,SF
1993,33,70,1124,105,263,0,3,105,260,112,137,72,177,249,78,36,36,65,148,322,C
1993,25,29,166,25,48,0,0,25,48,16,24,15,21,36,5,6,1,5,37,66,C
1993,24,5,35,2,7,0,0,2,7,3,3,2,6,8,2,2,2,0,4,7,C
1993,30,82,3098,517,1085,8,52,509,1033,525,653,210,570,780,493,79,27,243,305,1567,PF
1993,31,58,1677,296,659,44,135,252,524,156,184,27,107,134,157,55,13,70,98,792,SG
1993,24,54,1759,329,763,108,268,221,495,92,117,38,148,186,136,57,18,104,131,858,SF
1993,22,58,672,136,319,7,31,129,288,51,74,60,52,112,47,36,7,58,74,330,SF
1993,27,72,2456,417,868,1,8,416,860,397,540,259,587,846,100,38,83,203,260,1232,C
1993,30,54,533,49,130,0,1,49,129,37,39,27,56,83,46,6,11,27,40,135,PF
1993,26,48,568,80,164,0,2,80,162,31,49,65,140,205,26,13,25,36,92,191,C
1993,26,68,1603,197,501,43,130,154,371,61,78,70,187,257,235,48,19,96,163,498,PG
1993,24,69,2502,468,1055,1,11,467,1044,298,364,156,339,495,312,95,38,196,197,1235,SF
1993,28,78,3086,416,891,80,235,336,656,289,324,52,238,290,735,86,2,267,244,1201,PG
1993,27,81,2172,358,764,0,2,358,762,287,367,170,262,432,142,48,96,155,254,1003,SF
1993,22,80,1266,125,289,2,14,123,275,95,120,32,64,96,196,48,16,68,96,347,SG
1993,23,61,1524,289,666,0,4,289,662,56,74,96,232,328,104,48,52,115,280,634,PF
1993,27,82,2422,387,744,96,219,291,525,195,222,28,132,160,446,80,7,163,110,1065,PG
1993,23,69,1546,261,570,8,23,253,547,109,127,26,80,106,186,58,9,103,178,639,SG
1993,35,66,833,38,87,0,0,38,87,9,22,103,165,268,28,23,16,39,133,85,PF
1993,22,23,68,10,27,0,1,10,26,3,14,15,6,21,1,4,1,4,16,23,C
1993,23,48,1610,279,619,53,132,226,487,155,197,56,141,197,267,50,16,129,148,766,SG
1993,24,55,752,133,275,2,11,131,264,62,82,46,41,87,63,50,7,40,72,330,SG
1993,26,81,2072,494,1017,0,0,494,1017,167,228,126,306,432,121,27,75,147,285,1155,C
1993,28,20,422,73,163,0,2,73,161,41,54,38,43,81,24,17,7,26,64,187,SF
1993,28,3,15,0,3,0,0,0,3,0,0,0,1,1,0,2,0,2,3,0,SF
1993,28,17,407,73,160,0,2,73,158,41,54,38,42,80,24,15,7,24,61,187,SF
1993,23,44,280,44,82,0,0,44,82,16,32,17,45,62,8,8,18,26,54,104,C
1993,25,71,1296,105,226,0,0,105,226,83,127,134,190,324,17,23,66,70,243,293,C
1993,22,77,2741,449,968,73,198,376,770,211,283,79,192,271,295,126,52,203,166,1182,SG
1993,27,80,2477,513,1199,108,336,405,863,263,331,54,150,204,404,91,12,173,234,1397,SG
1993,30,2,6,1,2,0,0,1,2,0,0,2,0,2,0,0,0,0,1,2,SF
1993,24,81,1823,306,564,0,2,306,562,184,253,154,229,383,146,47,29,153,191,796,SF
1993,22,39,865,124,278,0,4,124,274,99,119,39,85,124,49,24,5,44,82,347,SG
1993,30,10,35,11,18,0,1,11,17,0,0,2,6,8,1,1,1,5,7,22,PF
1993,30,1,1,0,1,0,0,0,1,0,0,0,0,0,0,0,0,0,0,0,SF
1993,30,3,25,4,11,0,0,4,11,3,4,3,3,6,2,1,0,2,4,11,SF
1993,30,5,15,4,9,0,1,4,8,0,0,2,3,5,0,0,1,0,0,8,PF
1993,30,82,2863,437,899,72,187,365,712,293,367,64,173,237,987,199,21,266,224,1239,PG
1993,26,78,2474,396,816,4,30,392,786,273,381,120,217,337,559,131,24,199,153,1069,SG
1993,24,23,339,42,92,4,8,38,84,68,85,40,75,115,14,11,1,13,20,156,PF
1993,24,9,138,20,61,2,13,18,48,8,10,8,6,14,13,8,0,15,13,50,SG
1993,32,2,25,2,7,0,0,2,7,1,2,0,3,3,2,0,0,1,1,5,SG
1993,31,79,2922,526,1258,61,198,465,1060,278,377,71,161,232,671,123,18,284,222,1391,PG
1993,31,63,730,104,213,0,1,104,212,29,39,55,123,178,34,29,24,47,137,237,C
1993,30,72,2357,385,690,0,2,385,688,153,256,219,370,589,181,43,19,151,234,923,PF
1993,31,82,2893,522,1028,14,53,508,975,177,215,47,226,273,564,142,11,173,248,1235,PG
1993,28,76,2283,544,1068,0,2,544,1066,175,231,127,373,500,108,52,47,117,277,1263,PF
1993,27,72,1838,226,454,9,28,217,426,122,168,133,279,412,91,33,21,124,192,583,PF
1993,33,69,909,143,295,52,131,91,164,18,22,16,55,71,82,24,6,18,65,356,SG
1993,30,75,1479,231,437,10,17,221,420,56,70,74,178,252,107,19,9,66,192,528,PF
1993,34,41,494,92,203,12,37,80,166,58,66,12,36,48,25,13,7,20,45,254,SF
1993,24,79,1653,313,616,1,4,312,612,116,155,164,328,492,54,55,39,83,172,743,PF
1993,25,13,89,19,40,3,3,16,37,4,6,4,4,8,6,2,0,2,12,45,SF
1993,31,9,144,3,19,0,1,3,18,2,6,4,15,19,9,10,0,13,12,8,SG
1993,31,28,367,31,77,0,0,31,77,10,20,18,21,39,44,23,2,12,51,72,PG
1993,28,4,28,0,5,0,0,0,5,0,0,0,2,2,5,1,0,2,2,0,SG
1993,22,82,2654,494,1053,1,4,493,1049,291,408,179,410,589,147,85,67,176,188,1280,SF
1993,22,9,51,13,25,0,1,13,24,13,21,5,5,10,2,1,2,5,11,39,PF
1993,29,69,2335,342,789,37,135,305,654,279,328,44,149,193,481,104,6,194,177,1000,PG
1993,22,28,149,18,59,0,1,18,58,17,31,23,29,52,7,6,4,12,38,53,C
1993,25,80,3104,646,1249,2,23,644,1226,249,296,89,158,247,235,85,21,165,279,1543,SG
1993,32,82,1558,175,285,0,0,175,285,86,166,153,305,458,29,16,103,93,243,436,C
1993,25,64,1433,235,540,10,42,225,498,138,184,154,216,370,49,63,45,108,226,618,PF
1993,26,58,995,96,254,54,154,42,100,17,26,29,62,91,181,65,3,80,127,263,PG
1993,26,25,354,26,81,15,51,11,30,5,8,9,26,35,81,26,2,29,49,72,PG
1993,26,33,641,70,173,39,103,31,70,12,18,20,36,56,100,39,1,51,78,191,PG
1993,33,71,2647,741,1584,120,316,621,1268,519,627,187,295,482,227,70,27,184,116,2121,SF
1993,30,26,192,55,97,0,2,55,95,48,78,14,26,40,2,7,1,17,34,158,PF
1993,29,80,2079,361,797,16,58,345,739,152,181,74,140,214,183,78,18,94,154,890,SF
1993,32,82,2498,270,528,0,1,270,527,138,214,232,458,690,75,81,61,101,270,678,PF
1993,22,35,242,31,85,1,3,30,82,18,22,19,12,31,23,4,2,11,24,81,PG
1993,34,55,571,72,175,0,0,72,175,14,21,44,102,146,19,21,28,22,78,158,C
1993,30,67,2055,263,560,0,0,263,560,212,296,127,288,415,152,48,105,116,171,738,C
1993,24,12,139,21,46,0,0,21,46,7,18,22,19,41,0,4,4,8,24,49,PF
1993,26,74,1638,205,477,12,53,193,424,70,129,88,228,316,142,83,23,79,188,492,SF
1993,23,57,844,150,282,0,3,150,279,48,68,102,126,228,38,21,45,28,87,348,SF
1993,23,2,18,1,3,0,0,1,3,0,0,3,6,9,0,0,2,2,4,2,C
1993,23,3,10,0,2,0,0,0,2,0,0,1,1,2,0,1,1,0,2,0,PF
1993,23,22,151,16,31,0,0,16,31,2,7,13,31,44,5,4,14,6,23,34,PF
1993,26,76,2661,353,791,26,107,327,684,419,462,84,189,273,661,165,23,227,268,1151,PG
1993,28,79,2722,535,1167,33,122,502,1045,238,296,132,296,428,295,126,76,194,284,1341,SF
1993,24,71,1369,166,356,0,7,166,349,90,126,168,283,451,68,55,66,73,230,422,PF
1993,22,59,1673,358,823,61,191,297,632,224,302,115,150,265,178,66,29,179,209,1001,SF
1993,30,80,2878,616,1218,7,29,609,1189,196,300,335,693,1028,165,68,41,213,264,1435,PF
1993,26,39,340,61,139,4,19,57,120,17,22,17,32,49,13,10,10,15,40,143,SG
1993,29,72,1471,180,336,1,6,179,330,79,107,49,125,174,183,66,9,89,135,440,SF
1993,28,23,165,20,44,0,1,20,43,13,16,14,34,48,5,7,1,7,24,53,C
1993,28,2,9,0,1,0,0,0,1,1,2,1,2,3,0,0,1,2,2,1,C
1993,28,21,156,20,43,0,1,20,42,12,14,13,32,45,5,7,0,5,22,52,C
1993,28,64,598,52,117,5,21,47,96,46,55,38,59,97,34,13,12,29,93,155,PF
1993,22,41,174,23,66,3,14,20,52,19,26,6,8,14,40,14,1,16,26,68,PG
1993,33,58,1555,289,599,0,9,289,590,120,177,87,98,185,115,27,27,79,122,698,SF
1993,33,50,1477,271,566,0,9,271,557,113,168,84,92,176,112,26,25,73,114,655,SF
1993,33,8,78,18,33,0,0,18,33,7,9,3,6,9,3,1,2,6,8,43,SF
1993,31,82,2359,510,1142,30,111,480,1031,171,211,73,174,247,278,92,27,137,87,1221,SF
1993,25,4,10,4,5,0,0,4,5,0,2,1,1,2,0,0,0,0,0,8,PF
1993,30,65,836,69,167,22,68,47,99,28,32,13,34,47,119,31,5,30,36,188,PG
1994,25,13,159,24,55,0,0,24,55,16,25,12,34,46,3,2,3,17,20,64,PF
1994,24,80,2617,588,1279,42,133,546,1146,219,229,27,141,168,362,82,10,151,150,1437,PG
1994,31,70,2337,285,698,55,191,230,507,224,270,37,146,183,480,96,6,167,140,849,PG
1994,34,39,859,163,348,37,93,126,255,50,72,28,88,116,104,21,8,70,98,413,SF
1994,34,68,1555,224,537,80,244,144,293,78,94,28,103,131,180,57,8,81,140,606,SG
1994,24,11,55,8,14,0,0,8,14,3,9,7,8,15,2,3,0,8,10,19,PF
1994,24,4,12,1,2,0,0,1,2,0,2,1,2,3,1,0,0,1,3,2,PF
1994,24,7,43,7,12,0,0,7,12,3,7,6,6,12,1,3,0,7,7,17,PF
1994,24,69,1318,266,502,2,13,264,489,68,129,114,194,308,66,28,32,86,168,602,C
1994,23,11,39,7,17,2,2,5,15,5,14,6,11,17,2,0,1,2,9,21,PF
1994,29,77,1624,201,370,1,3,200,367,88,154,183,388,571,51,55,68,94,234,491,PF
1994,23,82,3135,576,1381,40,132,536,1249,346,423,89,233,322,784,158,15,266,201,1538,PG
1994,26,81,2811,504,1054,101,314,403,740,168,250,113,363,476,294,134,33,165,148,1277,SG
1994,35,21,356,35,86,7,26,28,60,19,23,16,37,53,17,8,3,10,16,96,SF
1994,35,11,176,15,43,4,12,11,31,10,12,8,18,26,6,5,2,1,9,44,SF
1994,35,10,180,20,43,3,14,17,29,9,11,8,19,27,11,3,1,9,7,52,SF
1994,27,80,2488,394,837,22,68,372,769,145,171,68,174,242,347,71,46,153,187,955,SG
1994,26,80,1994,225,571,48,160,177,411,130,168,43,146,189,365,114,13,127,163,628,PG
1994,26,82,2770,479,1007,60,135,419,872,194,227,28,142,170,323,80,9,131,147,1212,PG
1994,27,80,1690,273,567,6,31,267,536,175,211,60,124,184,194,73,19,70,145,727,SG
1994,26,37,319,36,88,4,21,32,67,9,10,33,49,82,13,11,1,21,57,85,SF
1994,25,82,2605,439,861,1,7,438,854,333,436,178,216,394,187,149,45,147,179,1212,SG
1994,24,14,201,29,66,0,1,29,65,14,23,25,44,69,17,5,10,17,29,72,C
1994,24,74,1371,150,398,0,0,150,398,89,123,144,194,338,65,33,31,85,147,389,PF
1994,24,33,695,92,228,0,0,92,228,61,79,60,94,154,33,16,20,43,60,245,PF
1994,24,41,676,58,170,0,0,58,170,28,44,84,100,184,32,17,11,42,87,144,PF
1994,33,3,13,0,2,0,0,0,2,2,2,0,1,1,3,0,0,0,2,2,PG
1994,32,79,1297,232,455,0,2,232,453,119,149,66,149,215,54,20,58,58,93,583,PF
1994,22,82,2560,435,869,1,5,434,864,234,411,277,344,621,163,60,114,162,231,1105,C
1994,30,65,2298,518,1046,48,178,470,868,318,452,198,529,727,296,101,37,206,160,1402,PF
1994,26,81,2519,412,878,135,354,277,524,116,145,28,168,196,424,107,5,167,96,1075,PG
1994,24,72,1242,158,382,32,115,126,267,97,122,36,110,146,168,102,17,83,110,445,SG
1994,31,51,814,130,273,5,19,125,254,73,97,7,32,39,83,22,1,41,66,338,SG
1994,29,77,1817,283,589,0,0,283,589,152,214,135,364,499,44,35,90,97,198,718,C
1994,24,74,983,105,263,27,75,78,188,11,15,16,74,90,163,39,1,40,84,248,PG
1994,25,55,1070,139,361,12,59,127,302,68,88,89,171,260,23,23,37,37,115,358,SF
1994,34,55,969,161,369,30,84,131,285,48,53,23,70,93,76,25,6,44,100,400,SG
1994,26,81,2915,444,1079,114,341,330,738,116,159,117,307,424,789,212,44,196,144,1118,PG
1994,25,67,690,76,174,0,0,76,174,46,75,76,118,194,56,19,33,52,93,198,PF
1994,29,77,2746,354,751,2,12,352,739,125,155,78,235,313,780,133,2,171,147,835,PG
1994,31,14,116,4,19,0,3,4,16,0,0,3,15,18,1,2,16,5,13,8,C
1994,31,8,61,1,12,0,3,1,9,0,0,1,10,11,0,0,6,5,4,2,C
1994,31,4,49,3,7,0,0,3,7,0,0,2,4,6,0,2,9,0,8,6,C
1994,24,56,559,63,156,19,54,44,102,31,40,20,41,61,31,16,12,17,90,176,SG
1994,25,73,1402,162,288,0,0,162,288,50,105,150,194,344,88,76,13,89,175,374,SF
1994,30,70,948,139,289,1,18,138,271,41,49,29,91,120,102,32,12,58,81,320,SG
1994,32,25,556,75,172,1,4,74,168,72,83,27,104,131,47,4,28,43,65,223,C
1994,21,49,1385,201,491,0,3,201,488,102,168,98,208,306,98,45,147,148,170,504,C
1994,23,73,1548,230,548,7,32,223,516,139,162,38,121,159,277,84,16,111,108,606,PG
1994,33,26,247,8,26,0,1,8,25,3,14,15,41,56,8,6,19,9,30,19,C
1994,34,71,2094,368,754,4,20,364,734,195,254,85,319,404,222,80,27,181,242,935,C
1994,34,43,1441,251,521,3,18,248,503,148,191,53,226,279,165,52,16,125,165,653,C
1994,34,28,653,117,233,1,2,116,231,47,63,32,93,125,57,28,11,56,77,282,C
1994,24,34,190,36,99,4,23,32,76,9,10,5,16,21,3,0,2,12,19,85,SF
1994,28,73,1225,142,289,23,61,119,228,74,85,10,92,102,149,51,2,55,98,381,PG
1994,25,1,10,1,1,0,0,1,1,1,1,0,1,1,0,0,0,0,2,3,SF
1994,25,77,2867,490,1021,30,96,460,925,182,219,63,237,300,347,156,47,126,207,1192,SG
1994,30,82,1921,111,260,0,2,111,258,77,118,119,328,447,72,51,29,75,218,299,C
1994,24,79,1950,167,402,1,6,166,396,115,152,188,305,493,93,71,93,72,177,450,C
1994,25,61,1041,110,251,0,4,110,247,53,87,40,72,112,133,63,14,75,132,273,PG
1994,28,79,1441,185,384,0,1,185,383,72,104,117,198,315,37,32,29,66,187,442,C
1994,25,36,218,42,84,12,29,30,55,10,20,13,19,32,16,8,1,12,24,106,SF
1994,26,65,725,78,226,50,154,28,72,20,26,23,61,84,64,14,6,28,67,226,PF
1994,22,23,143,22,55,0,0,22,55,12,23,13,17,30,9,6,3,7,33,56,PF
1994,23,51,767,98,234,2,6,96,228,46,70,46,86,132,62,37,16,45,88,244,SF
1994,25,53,697,124,283,3,15,121,268,120,158,50,86,136,39,18,20,54,96,371,SF
1994,23,75,1321,207,418,0,5,207,413,104,180,106,119,225,77,54,20,87,131,518,SG
1994,32,82,1708,171,314,0,1,171,313,36,74,164,280,444,45,77,38,51,179,378,C
1994,25,76,2253,373,808,0,2,373,806,188,273,167,352,519,86,64,146,98,241,934,PF
1994,31,63,1214,227,512,7,28,220,484,94,120,76,110,186,82,50,15,84,134,555,SF
1994,31,22,379,63,128,1,3,62,125,30,37,28,32,60,31,20,1,29,59,157,SF
1994,31,41,835,164,384,6,25,158,359,64,83,48,78,126,51,30,14,55,75,398,SF
1994,32,34,465,78,160,0,1,78,159,42,58,12,39,51,15,9,22,15,75,198,PF
1994,36,42,780,98,191,0,0,98,191,39,57,43,109,152,57,8,8,50,83,235,C
1994,24,66,1122,162,388,26,88,136,300,90,107,25,109,134,192,59,7,94,136,440,PG
1994,25,41,674,71,137,0,0,71,137,40,68,68,118,186,11,19,49,33,109,182,C
1994,24,53,1602,425,795,0,9,425,786,160,221,153,191,344,91,59,23,93,124,1010,SF
1994,34,80,1838,329,748,14,45,315,703,221,281,87,239,326,79,40,32,89,232,893,PF
1994,26,60,2025,431,865,64,165,367,700,168,206,57,89,146,185,59,8,117,83,1094,SG
1994,22,65,1604,327,696,1,23,326,673,124,161,88,102,190,126,63,10,108,148,779,SG
1994,25,76,1365,203,448,3,15,200,433,41,65,129,242,371,86,53,39,74,164,450,PF
1994,25,46,974,152,328,0,1,152,327,31,52,100,171,271,71,43,28,56,116,335,PF
1994,25,30,391,51,120,3,14,48,106,10,13,29,71,100,15,10,11,18,48,115,PF
1994,23,65,1515,244,562,39,119,205,443,145,208,93,142,235,136,89,28,140,186,672,SG
1994,32,9,77,12,25,0,0,12,25,4,8,10,16,26,0,2,2,7,9,28,PF
1994,26,77,2778,541,1209,38,121,503,1088,439,567,262,608,870,262,68,142,208,209,1559,PF
1994,25,76,1726,233,519,20,99,213,420,102,131,50,109,159,263,75,12,107,132,588,PG
1994,26,30,579,95,165,0,2,95,163,43,53,53,86,139,34,9,8,33,69,233,C
1994,26,16,378,66,109,0,1,66,108,31,38,34,55,89,28,5,7,23,36,163,C
1994,26,14,201,29,56,0,1,29,55,12,15,19,31,50,6,4,1,10,33,70,C
1994,34,11,169,14,38,0,3,14,35,3,6,10,14,24,31,14,1,9,12,31,PG
1994,26,25,203,26,54,0,1,26,53,10,25,20,36,56,4,3,14,12,22,62,PF
1994,26,2,2,0,1,0,0,0,1,0,0,0,0,0,0,0,2,1,0,0,PF
1994,26,23,201,26,53,0,1,26,52,10,25,20,36,56,4,3,12,11,22,62,PF
1994,24,23,136,18,41,1,7,17,34,11,15,2,7,9,28,3,0,20,12,48,PG
1994,31,82,2149,268,588,6,29,262,559,117,144,150,239,389,122,99,24,92,212,659,SF
1994,25,51,467,40,94,11,38,29,56,26,38,8,36,44,86,22,2,38,47,117,PG
1994,24,52,345,67,148,2,3,65,145,32,47,28,28,56,15,10,12,21,44,168,PF
1994,24,33,168,40,78,0,0,40,78,23,32,14,13,27,9,3,6,10,23,103,PF
1994,24,19,177,27,70,2,3,25,67,9,15,14,15,29,6,7,6,11,21,65,PF
1994,24,45,313,45,99,11,24,34,75,31,36,11,20,31,77,15,1,27,36,132,PG
1994,32,59,1133,183,428,0,2,183,426,63,107,132,165,297,50,31,13,59,137,429,PF
1994,36,2,30,2,8,0,0,2,8,0,2,4,8,12,0,0,0,1,4,4,PF
1994,29,82,2173,533,1171,152,378,381,793,117,134,71,191,262,221,98,27,120,161,1335,SG
1994,25,10,43,3,14,0,2,3,12,3,4,0,1,1,1,1,0,3,6,9,SG
1994,26,65,980,140,372,44,125,96,247,46,64,45,66,111,94,29,16,60,69,370,SG
1994,28,50,1838,296,606,0,0,296,606,256,326,128,380,508,149,41,36,110,145,848,C
1994,25,81,1732,216,425,0,1,216,424,194,302,190,315,505,55,45,84,107,189,626,PF
1994,23,68,374,40,126,1,3,39,123,50,68,21,34,55,22,16,4,19,34,131,SF
1994,24,66,2292,308,582,0,1,308,581,155,294,280,438,718,100,48,106,102,214,771,PF
1994,23,56,1333,238,505,53,132,185,373,85,103,23,44,67,165,40,4,76,118,614,SG
1994,26,15,286,24,59,0,0,24,59,8,12,30,44,74,6,9,1,5,27,56,PF
1994,30,72,1343,177,423,37,105,140,318,84,100,28,95,123,263,63,5,111,74,475,PG
1994,24,76,2127,351,845,33,148,318,697,231,331,115,195,310,138,103,52,129,221,966,SG
1994,22,64,759,129,342,23,57,106,285,61,81,25,43,68,78,28,3,61,69,342,PG
1994,27,77,1949,309,634,15,43,294,591,140,170,27,134,161,320,64,1,102,168,773,SG
1994,24,80,1507,251,464,0,3,251,461,137,211,138,308,446,50,49,87,104,221,639,C
1994,23,2,11,2,6,0,0,2,6,0,2,0,0,0,1,2,0,1,1,4,PG
1994,25,79,2685,453,895,9,47,444,848,208,303,282,569,851,307,92,112,191,288,1123,C
1994,27,78,2789,425,919,13,56,412,863,177,276,70,123,193,683,89,11,233,171,1040,PG
1994,31,54,685,52,104,1,1,51,103,27,38,47,123,170,31,16,24,43,159,132,C
1994,31,68,2334,473,1105,71,219,402,886,286,368,154,291,445,333,98,34,167,202,1303,SG
1994,29,69,1485,184,441,0,0,184,441,88,132,103,222,325,56,37,35,101,223,456,C
1994,28,6,86,6,25,0,0,6,25,2,4,16,8,24,5,4,3,2,18,14,C
1994,30,69,2591,505,1118,124,320,381,798,276,330,35,116,151,261,63,4,159,118,1410,SG
1994,23,74,1149,151,372,0,1,151,371,108,160,85,162,247,12,24,53,72,178,410,C
1994,22,3,44,2,18,0,5,2,13,2,5,5,9,14,4,3,1,4,6,6,PF
1994,28,82,2322,382,800,38,106,344,694,151,189,104,225,329,171,83,27,146,235,953,SF
1994,23,16,107,17,49,0,1,17,48,9,16,7,11,18,8,2,5,6,9,43,PF
1994,38,45,469,78,168,0,0,78,168,54,79,11,54,65,22,4,3,30,90,210,C
1994,28,82,2727,471,1028,35,99,436,929,167,217,94,187,281,232,120,34,135,150,1144,SG
1994,32,82,2147,316,708,77,221,239,487,112,154,71,208,279,273,136,26,130,161,821,SG
1994,30,67,1606,208,466,56,167,152,299,154,179,28,153,181,208,50,8,109,124,626,SF
1994,25,73,2409,360,791,26,87,334,704,139,173,68,195,263,197,54,27,129,174,885,SF
1994,33,77,2590,478,967,131,332,347,635,83,107,70,185,255,80,66,11,75,141,1170,SF
1994,23,49,923,159,292,0,4,159,288,106,149,94,59,153,31,73,2,43,97,424,SF
1994,23,79,2699,483,963,7,23,476,940,242,359,220,462,682,167,63,80,172,304,1215,PF
1994,24,50,680,88,182,0,0,88,182,45,68,70,118,188,24,17,25,21,83,221,C
1994,26,47,1178,137,292,0,3,137,289,70,97,77,165,242,70,25,50,73,140,344,C
1994,23,36,419,56,129,8,17,48,112,10,21,9,36,45,38,8,10,36,61,130,SG
1994,31,79,2972,745,1503,4,14,741,1489,445,582,219,666,885,179,90,217,260,275,1939,C
1994,29,4,29,2,6,0,2,2,4,0,0,0,2,2,4,0,0,5,3,4,SG
1994,28,72,1155,184,379,1,9,183,370,144,184,62,67,129,65,44,16,64,85,513,SF
1994,27,70,965,149,334,14,51,135,283,38,43,47,94,141,74,28,22,41,113,350,PF
1994,31,55,1053,147,318,0,4,147,314,64,87,27,96,123,173,40,6,87,98,358,PG
1994,33,53,737,70,209,8,36,62,173,52,78,10,60,70,101,12,8,61,71,200,PG
1994,22,6,16,7,13,1,1,6,12,1,2,0,0,0,1,2,0,1,2,16,PG
1994,25,3,19,4,7,0,0,4,7,2,2,0,3,3,0,0,1,1,3,10,PF
1994,24,82,2096,340,728,33,100,307,628,174,230,105,250,355,217,81,52,158,244,887,SF
1994,28,67,959,67,160,0,2,67,158,54,76,83,137,220,57,35,35,49,163,188,PF
1994,28,18,78,9,20,2,5,7,15,13,15,3,10,13,30,2,0,5,12,33,SG
1994,24,2,3,3,3,0,0,3,3,0,0,0,0,0,0,0,0,0,2,6,C
1994,28,75,1880,368,804,25,103,343,701,103,126,41,118,159,149,57,22,77,134,864,SF
1994,26,82,1296,271,461,0,1,271,460,129,208,143,254,397,41,40,63,84,223,671,C
1994,29,77,1644,233,445,0,0,233,445,126,195,105,253,358,95,59,46,79,229,592,PF
1994,28,7,70,8,17,4,8,4,9,2,2,1,6,7,5,2,1,3,9,22,SG
1994,24,72,1199,202,352,1,5,201,347,116,149,119,184,303,32,36,29,61,201,521,C
1994,25,79,2435,429,969,38,120,391,849,215,275,91,177,268,275,151,32,143,194,1111,SG
1994,29,82,1969,348,682,0,1,348,681,274,361,197,303,500,69,38,61,106,129,970,PF
1994,34,29,309,36,103,0,0,36,103,14,18,22,52,74,11,13,16,13,23,86,C
1994,34,21,255,31,79,0,0,31,79,11,14,19,40,59,11,13,13,11,20,73,C
1994,34,8,54,5,24,0,0,5,24,3,4,3,12,15,0,0,3,2,3,13,C
1994,26,3,8,2,3,0,0,2,3,0,2,0,1,1,1,0,0,0,3,4,PG
1994,23,70,889,122,305,2,25,120,280,92,110,21,65,86,66,61,4,65,54,338,SG
1994,26,21,128,21,57,3,13,18,44,13,17,4,8,12,13,4,5,5,11,58,SG
1994,28,78,1533,253,563,17,62,236,501,65,76,42,100,142,291,119,12,136,139,588,PG
1994,28,77,2112,356,774,2,7,354,767,84,131,109,242,351,107,70,49,56,179,798,SF
1994,28,70,2570,460,878,0,6,460,872,137,230,306,463,769,236,74,84,109,164,1057,PF
1994,26,53,382,59,146,17,61,42,85,22,29,27,62,89,24,18,8,30,62,157,PF
1994,28,67,1096,191,363,2,12,189,351,71,118,76,115,191,62,33,13,63,103,455,SG
1994,30,82,2825,465,926,8,35,457,891,266,362,275,478,753,137,70,38,100,142,1204,PF
1994,23,29,126,22,57,1,4,21,53,28,37,6,6,12,9,6,1,13,16,73,PG
1994,23,36,334,63,183,10,41,53,142,13,18,10,24,34,16,18,6,27,21,149,SG
1994,23,35,332,63,182,10,41,53,141,13,18,10,24,34,16,18,6,27,21,149,SG
1994,23,1,2,0,1,0,0,0,1,0,0,0,0,0,0,0,0,0,0,0,SG
1994,24,78,2795,540,1159,40,148,500,1011,213,311,189,539,728,276,172,51,247,174,1333,PF
1994,25,5,33,6,20,0,0,6,20,3,6,10,6,16,2,0,1,6,6,15,C
1994,24,32,131,16,32,0,0,16,32,15,21,15,18,33,3,4,5,16,23,47,C
1994,30,28,94,21,48,0,0,21,48,17,21,6,18,24,1,0,0,10,18,59,PF
1994,24,1,3,1,3,0,0,1,3,0,0,1,0,1,1,0,0,0,1,2,C
1994,26,74,877,115,230,0,0,115,230,71,104,62,137,199,34,20,12,41,91,301,PF
1994,22,82,3015,509,1092,50,187,459,905,245,330,192,247,439,544,190,51,292,205,1313,PG
1994,32,82,2204,303,744,73,203,230,541,112,163,20,121,141,334,125,8,135,163,791,PG
1994,32,28,893,130,342,37,105,93,237,28,50,10,45,55,98,45,4,54,46,325,PG
1994,32,54,1311,173,402,36,98,137,304,84,113,10,76,86,236,80,4,81,117,466,PG
1994,30,75,2856,569,1335,71,236,498,1099,299,418,129,331,460,344,144,54,242,167,1508,SG
1994,23,77,1165,162,385,7,33,155,352,87,119,45,112,157,106,49,10,78,117,418,SG
1994,26,5,88,9,31,3,9,6,22,23,25,3,7,10,8,4,0,6,8,44,SG
1994,23,27,247,29,79,0,0,29,79,12,26,26,33,59,5,8,19,17,39,70,PF
1994,23,27,186,21,45,0,0,21,45,13,19,17,38,55,6,2,15,13,33,55,C
1994,27,82,2648,395,859,78,235,317,624,312,362,89,288,377,216,135,22,158,167,1180,SG
1994,26,4,15,1,5,0,2,1,3,2,4,0,2,2,4,0,0,1,1,4,SG
1994,25,3,17,1,2,1,1,0,1,0,0,0,1,1,5,0,0,1,3,3,PG
1994,27,75,1292,142,310,0,0,142,310,69,97,101,184,285,37,32,26,69,159,353,PF
1994,34,36,547,71,163,22,50,49,113,31,42,25,57,82,36,25,14,21,53,195,SF
1994,25,57,1447,216,398,0,2,216,396,171,256,184,315,499,46,53,35,78,193,603,PF
1994,24,50,428,46,101,0,0,46,101,44,52,46,49,95,32,15,13,30,66,136,C
1994,28,3,28,0,2,0,0,0,2,0,0,1,2,3,0,1,3,1,3,0,C
1994,30,80,2820,472,1004,70,208,402,796,260,296,60,219,279,419,127,13,171,186,1274,SG
1994,30,53,1994,325,715,52,166,273,549,178,204,41,171,212,315,95,10,138,115,880,SG
1994,30,27,826,147,289,18,42,129,247,82,92,19,48,67,104,32,3,33,71,394,SG
1994,23,81,2370,322,702,44,136,278,566,115,157,128,312,440,231,119,75,137,186,803,SF
1994,22,79,1519,272,671,35,117,237,554,89,108,19,101,120,100,34,13,99,165,668,SG
1994,24,71,866,81,177,1,7,80,170,33,54,67,127,194,32,33,31,49,181,196,PF
1994,23,9,53,10,17,0,0,10,17,11,16,10,6,16,1,1,3,6,13,31,SF
1994,31,75,1619,233,535,38,96,195,439,57,76,35,92,127,219,65,11,95,168,561,SG
1994,23,82,2172,335,893,69,207,266,686,104,142,47,142,189,390,121,10,184,174,843,PG
1994,22,19,499,54,146,2,16,52,130,24,30,6,28,34,115,13,1,48,28,134,PG
1994,26,29,187,34,87,0,6,34,81,12,14,6,11,17,27,4,2,14,20,80,SG
1994,23,82,3066,637,1432,17,60,620,1372,285,347,169,219,388,374,87,25,334,161,1576,SG
1994,28,79,2711,331,732,36,127,295,605,167,211,107,241,348,678,120,6,232,115,865,PG
1994,23,17,92,17,33,1,5,16,28,3,3,12,15,27,16,5,0,10,13,38,SG
1994,26,5,14,0,7,0,0,0,7,2,3,0,4,4,1,0,0,1,0,2,SG
1994,26,1,4,0,2,0,0,0,2,1,1,0,1,1,0,0,0,0,0,1,SG
1994,26,4,10,0,5,0,0,0,5,1,2,0,3,3,1,0,0,1,0,1,SG
1994,28,12,75,16,42,4,18,12,24,5,5,6,8,14,1,2,0,2,9,41,PF
1994,25,76,1097,138,342,56,151,82,191,100,120,16,73,89,218,65,0,74,62,432,PG
1994,24,3,78,13,26,4,11,9,15,1,2,4,11,15,7,0,0,5,13,31,SF
1994,28,82,2332,356,724,0,12,356,712,178,253,41,135,176,433,113,8,172,160,890,PG
1994,23,17,119,17,54,0,1,17,53,13,21,9,7,16,4,4,0,9,7,47,SG
1994,34,73,1460,339,738,59,150,280,588,99,127,80,144,224,125,36,8,84,143,836,SF
1994,26,45,280,44,106,0,0,44,106,29,46,48,70,118,7,10,22,24,45,117,C
1994,35,70,875,134,299,2,12,132,287,54,69,29,53,82,148,41,1,65,120,324,PG
1994,27,67,2449,477,980,6,27,471,953,380,464,55,112,167,637,125,10,235,127,1340,PG
1994,24,51,1757,346,672,5,21,341,651,137,197,143,305,448,184,29,14,116,131,834,PF
1994,36,42,877,36,78,0,1,36,77,19,34,89,146,235,29,14,43,12,136,91,C
1994,23,81,1773,195,407,0,1,195,406,78,107,299,306,605,99,61,31,94,246,468,PF
1994,23,6,79,6,23,3,10,3,13,0,0,3,3,6,19,0,1,6,6,15,PG
1994,26,23,259,44,103,2,4,42,99,35,51,46,21,67,26,14,5,14,26,125,SG
1994,23,63,763,96,213,0,0,96,213,81,111,77,124,201,34,20,9,60,80,273,PF
1994,24,79,2597,533,990,1,4,532,986,364,491,312,539,851,207,142,166,259,312,1431,PF
1994,30,13,136,15,38,0,0,15,38,9,16,10,14,24,9,6,2,11,33,39,PF
1994,30,9,103,9,26,0,0,9,26,7,10,6,8,14,6,4,1,4,25,25,PF
1994,30,4,33,6,12,0,0,6,12,2,6,4,6,10,3,2,1,7,8,14,PF
1994,28,82,2036,287,577,52,124,235,453,83,97,26,105,131,210,75,3,57,97,709,PG
1994,31,78,1276,203,469,1,8,202,461,101,135,130,201,331,75,71,49,63,213,508,SF
1994,27,15,66,11,25,5,9,6,16,6,8,4,6,10,2,1,1,5,14,33,PF
1994,23,68,884,100,169,0,0,100,169,47,86,76,157,233,19,19,23,44,129,247,PF
1994,24,15,86,19,48,2,7,17,41,15,26,5,10,15,11,4,0,12,12,55,SF
1994,24,27,78,15,34,0,1,15,33,11,22,9,11,20,8,1,2,7,18,41,C
1994,27,49,1053,146,341,0,2,146,339,93,136,90,151,241,58,31,42,83,121,385,C
1994,27,31,537,68,171,0,2,68,169,36,53,50,82,132,39,18,12,43,64,172,C
1994,27,18,516,78,170,0,0,78,170,57,83,40,69,109,19,13,30,40,57,213,C
1994,32,29,309,13,35,0,0,13,35,8,22,22,48,70,4,2,12,17,61,34,C
1994,32,74,848,125,256,5,11,120,245,30,39,50,143,193,45,14,19,35,118,285,C
1994,26,65,1438,225,475,4,21,221,454,141,174,28,75,103,197,34,11,94,121,595,PG
1994,26,1,8,1,4,0,0,1,4,0,0,0,0,0,0,0,1,0,1,2,PG
1994,26,64,1430,224,471,4,21,220,450,141,174,28,75,103,197,34,10,94,120,593,PG
1994,30,82,1823,159,369,0,3,159,366,24,36,83,282,365,102,63,125,44,236,342,C
1994,29,34,682,71,148,0,1,71,147,31,39,38,85,123,35,14,4,29,74,173,PF
1994,25,75,1808,313,726,32,118,281,608,156,210,98,199,297,252,81,33,167,122,814,SF
1994,24,70,2428,396,883,6,25,390,858,375,479,160,442,602,307,87,86,259,264,1173,PF
1994,36,11,248,47,90,3,9,44,81,11,13,9,47,56,14,6,4,10,30,108,C
1994,27,82,1608,215,458,1,4,214,454,73,106,126,187,313,51,38,87,81,192,504,C
1994,27,71,1163,139,286,0,2,139,284,84,130,75,207,282,86,18,34,86,190,362,C
1994,27,79,1322,231,528,52,139,179,389,142,169,36,92,128,120,52,13,60,133,656,PG
1994,30,18,169,13,34,8,18,5,16,11,13,5,8,13,39,7,1,11,16,45,PG
1994,33,81,1947,227,557,26,74,201,483,75,98,83,200,283,213,159,15,88,155,555,PG
1994,25,38,285,40,123,10,28,30,95,19,39,26,35,61,17,11,4,24,34,109,SF
1994,25,3,11,4,7,0,1,4,6,1,2,0,5,5,2,0,0,2,5,9,SF
1994,25,35,274,36,116,10,27,26,89,18,37,26,30,56,15,11,4,22,29,100,SF
1994,27,13,126,20,51,2,2,18,49,16,25,8,14,22,11,7,1,5,16,58,SG
1994,27,4,20,4,9,0,0,4,9,0,0,3,1,4,2,2,0,2,3,8,SG
1994,27,5,58,10,28,2,2,8,26,9,11,3,7,10,3,0,0,0,9,31,SG
1994,27,4,48,6,14,0,0,6,14,7,14,2,6,8,6,5,1,3,4,19,SG
1994,29,67,962,102,281,46,134,56,147,20,29,33,117,150,62,30,55,58,142,270,PF
1994,27,69,2201,300,672,1,6,299,666,187,238,190,305,495,170,89,26,125,244,788,PF
1994,25,76,1502,219,465,0,1,219,464,90,125,129,304,433,109,45,79,119,216,528,C
1994,25,49,989,134,289,0,1,134,288,56,80,87,208,295,46,35,58,79,131,324,C
1994,25,27,513,85,176,0,0,85,176,34,45,42,96,138,63,10,21,40,85,204,C
1994,23,71,1762,291,573,0,5,291,568,99,166,220,190,410,96,102,27,87,177,681,SF
1994,23,22,69,14,37,0,2,14,35,4,8,12,12,24,1,0,3,2,9,32,C
1994,24,75,2487,517,1030,3,21,514,1009,328,398,140,327,467,160,47,22,152,169,1365,SF
1994,24,42,496,69,184,2,10,67,174,23,34,18,23,41,51,39,1,40,73,163,SG
1994,24,7,126,14,45,0,3,14,42,8,10,3,4,7,11,6,1,14,17,36,SG
1994,24,35,370,55,139,2,7,53,132,15,24,15,19,34,40,33,0,26,56,127,SG
1994,24,22,149,11,31,5,15,6,16,8,10,1,10,11,19,9,0,13,16,35,SG
1994,35,28,226,23,47,0,1,23,46,13,20,16,38,54,5,3,5,7,38,59,PF
1994,28,80,3207,476,1138,192,503,284,635,176,238,120,229,349,275,129,43,137,153,1320,SG
1994,32,77,2560,525,1081,7,12,518,1069,205,247,51,148,199,125,40,5,85,123,1262,SG
1994,32,50,1657,338,692,3,6,335,686,129,153,28,87,115,66,26,5,57,77,808,SG
1994,32,27,903,187,389,4,6,183,383,76,94,23,61,84,59,14,0,28,46,454,SG
1994,30,82,3329,772,1552,8,32,764,1520,511,736,235,705,940,328,125,126,234,268,2063,PF
1994,38,55,618,102,232,0,1,102,231,90,117,106,120,226,34,11,17,59,52,294,C
1994,27,68,2520,586,1201,3,17,583,1184,228,341,131,334,465,261,99,82,233,260,1403,PF
1994,27,42,1595,409,829,2,14,407,815,174,258,82,214,296,176,53,57,147,167,994,PF
1994,27,26,925,177,372,1,3,176,369,54,83,49,120,169,85,46,25,86,93,409,PF
1994,27,5,32,2,12,0,0,2,12,0,3,3,5,8,1,0,2,3,1,4,SF
1994,24,53,535,40,88,0,0,40,88,31,51,36,81,117,17,8,33,29,106,111,C
1994,21,79,2896,561,1382,85,299,476,1083,306,438,107,246,353,266,89,14,245,205,1513,SF
1994,27,73,1903,206,433,0,1,206,432,116,161,158,269,427,151,31,9,107,190,528,PF
1994,24,55,626,89,167,0,2,89,165,70,98,75,124,199,10,16,33,40,113,248,PF
1994,28,75,2571,380,976,120,403,260,573,143,191,42,187,229,380,125,20,185,143,1023,SG
1994,23,82,1472,167,402,41,119,126,283,58,84,26,75,101,215,46,4,97,114,433,PG
1994,30,82,1971,387,839,10,41,377,798,144,213,142,258,400,126,48,39,116,193,928,SF
1994,27,76,2613,355,710,9,31,346,679,192,254,129,273,402,327,111,49,228,248,911,SF
1994,29,73,1887,177,396,52,133,125,263,31,55,50,233,283,387,216,22,126,201,437,PG
1994,22,38,285,28,88,5,24,23,64,12,27,17,18,35,16,15,13,18,34,73,SG
1994,23,69,1786,277,455,2,9,275,446,80,137,140,336,476,244,83,156,164,230,636,C
1994,28,79,2638,524,1042,123,292,401,750,403,444,30,182,212,248,119,24,175,193,1574,SG
1994,24,79,2022,284,677,38,122,246,555,137,176,134,267,401,128,54,50,89,232,743,SF
1994,26,80,2773,588,1151,24,73,564,1078,181,227,193,479,672,177,64,62,153,309,1381,PF
1994,22,63,1358,254,532,4,6,250,526,149,180,75,81,156,95,31,13,95,132,661,SG
1994,30,75,1084,140,306,0,5,140,301,82,110,71,119,190,65,33,9,50,152,362,PF
1994,28,3,10,2,3,0,0,2,3,2,2,0,1,1,0,2,0,0,0,6,SG
1994,24,23,367,39,82,0,0,39,82,18,30,31,50,81,15,14,2,19,70,96,C
1994,24,22,363,38,81,0,0,38,81,18,30,31,49,80,15,14,2,19,69,94,C
1994,24,1,4,1,1,0,0,1,1,0,0,0,1,1,0,0,0,0,1,2,C
1994,28,50,1349,203,454,53,147,150,307,85,118,91,137,228,83,55,49,52,120,544,SF
1994,23,60,2018,427,845,0,2,427,843,433,568,177,433,610,86,27,188,199,207,1287,C
1994,30,62,2324,410,869,55,151,355,718,165,219,64,281,345,315,107,53,178,114,1040,SF
1994,25,82,2533,477,1019,69,168,408,851,234,288,91,170,261,546,197,12,206,189,1257,PG
1994,22,54,650,128,235,0,0,128,235,48,71,66,126,192,18,28,48,54,120,304,C
1994,30,9,67,6,12,0,0,6,12,3,6,4,6,10,4,2,0,1,10,15,PF
1994,30,7,57,6,12,0,0,6,12,3,6,4,5,9,3,2,0,1,8,15,PF
1994,22,66,820,167,355,50,109,117,246,50,72,43,68,111,31,21,20,37,76,434,SF
1994,24,33,196,30,84,0,0,30,84,13,22,20,35,55,8,4,5,10,29,73,PF
1994,27,82,2853,365,642,0,1,365,641,256,439,286,685,971,127,59,336,206,262,986,C
1994,30,82,2030,253,556,8,29,245,527,136,194,54,127,181,245,78,20,136,195,650,SG
1994,34,33,909,153,314,0,0,153,314,64,85,77,150,227,49,27,55,38,96,370,PF
1994,30,81,1697,313,664,24,90,289,574,182,225,86,94,180,72,69,27,90,196,832,SF
1994,30,18,429,91,174,4,16,87,158,48,59,21,37,58,29,18,5,28,44,234,SF
1994,30,63,1268,222,490,20,74,202,416,134,166,65,57,122,43,51,22,62,152,598,SF
1994,29,82,2539,412,919,63,189,349,730,92,183,169,331,500,222,58,46,150,209,979,SF
1994,21,81,3224,953,1591,0,2,953,1589,471,850,384,688,1072,195,76,231,222,281,2377,C
1994,25,13,56,4,12,0,0,4,12,9,12,2,8,10,3,0,0,3,10,17,C
1994,30,82,2932,363,760,0,3,363,757,243,313,349,616,965,218,110,18,193,293,969,PF
1994,31,80,3277,894,1694,8,19,886,1675,388,542,229,726,955,287,128,297,271,289,2184,C
1994,24,44,540,89,214,13,32,76,182,25,33,8,38,46,33,16,1,21,39,216,SG
1994,22,37,871,98,167,0,2,98,165,61,103,81,131,212,36,36,37,31,94,257,SF
1994,24,61,749,87,216,1,11,86,205,43,52,19,50,69,92,21,1,54,48,218,PG
1994,24,79,2738,492,971,3,15,489,956,199,326,230,410,640,326,83,60,214,269,1186,PF
1994,24,66,1382,223,503,6,29,217,474,179,236,25,98,123,356,81,9,204,147,631,PG
1994,28,18,137,22,60,0,1,22,59,9,16,5,11,16,11,4,0,6,9,53,SF
1994,28,7,55,9,23,0,0,9,23,1,2,0,5,5,4,1,0,4,2,19,SF
1994,28,3,8,2,5,0,0,2,5,0,0,0,0,0,0,0,0,0,3,4,SF
1994,28,8,74,11,32,0,1,11,31,8,14,5,6,11,7,3,0,2,4,30,SF
1994,40,74,1987,356,725,0,0,356,725,154,208,141,401,542,82,42,96,108,190,866,C
1994,33,27,343,30,68,9,22,21,46,1,2,3,17,20,33,7,2,6,18,70,PG
1994,25,82,2881,584,1159,15,54,569,1105,166,279,105,164,269,494,188,19,173,227,1349,PG
1994,24,30,923,176,409,14,63,162,346,57,71,48,61,109,94,43,8,59,93,423,SG
1994,23,55,667,76,141,0,1,76,140,24,44,49,120,169,24,17,25,34,131,176,C
1994,28,43,397,47,112,0,1,47,111,23,32,40,86,126,34,8,11,42,61,117,C
1994,32,81,2170,341,779,99,270,242,509,218,272,120,246,366,111,67,31,103,197,999,PF
1994,24,27,432,42,113,0,3,42,110,21,28,12,27,39,125,25,1,43,36,105,PG
1994,28,80,2336,272,625,73,200,199,425,102,176,117,287,404,94,60,82,80,154,719,PF
1994,29,77,2029,356,843,100,272,256,571,82,108,55,198,253,185,45,12,121,164,894,SF
1994,25,22,92,20,46,7,15,13,31,6,8,9,22,31,1,2,3,15,15,53,C
1994,24,72,1531,242,514,1,12,241,502,113,157,71,141,212,133,67,12,63,135,598,SG
1994,34,51,1022,272,577,6,32,266,545,189,211,29,54,83,91,42,5,64,84,739,SG
1994,30,76,1524,151,289,0,0,151,289,92,125,160,318,478,62,58,44,62,131,394,PF
1994,28,72,2759,627,1278,63,197,564,1081,270,409,173,456,629,403,211,58,232,227,1587,SF
1994,29,68,2402,346,662,0,2,346,660,97,191,299,510,809,41,42,67,78,189,789,C
1994,29,37,1350,222,406,0,1,222,405,42,92,148,308,456,22,24,36,49,108,486,C
1994,29,31,1052,124,256,0,1,124,255,55,99,151,202,353,19,18,31,29,81,303,C
1994,30,77,2074,348,836,110,282,238,554,204,234,45,170,215,401,79,18,166,132,1010,PG
1994,25,65,1035,141,326,50,150,91,176,68,87,31,59,90,213,55,2,119,114,400,PG
1994,29,76,2386,480,1005,118,297,362,708,238,268,39,189,228,589,103,11,189,93,1316,PG
1994,26,80,2303,491,942,0,1,491,941,226,301,191,386,577,114,70,67,149,276,1208,PF
1994,35,50,635,59,114,0,1,59,113,46,71,84,105,189,32,22,23,26,89,164,PF
1994,26,28,155,17,50,2,14,15,36,22,28,9,13,22,11,8,3,10,18,58,PF
1994,25,70,1344,260,530,0,3,260,527,107,153,91,129,220,73,43,25,84,165,627,PF
1994,26,81,2999,663,1421,132,346,531,1075,250,284,76,358,434,184,110,32,130,186,1708,SF
1994,27,37,1022,160,354,3,12,157,342,47,77,28,82,110,237,32,3,88,78,370,PG
1994,28,78,2897,635,1428,127,312,508,1116,426,511,70,216,286,313,103,17,216,211,1823,SG
1994,22,79,2415,522,1115,54,150,468,965,215,265,118,197,315,202,54,28,218,194,1313,SG
1994,23,47,219,34,70,0,1,34,69,20,37,24,35,59,9,5,9,15,30,88,C
1994,32,19,499,55,127,19,52,36,75,14,22,4,35,39,100,25,5,29,44,143,PG
1994,23,14,350,43,100,0,0,43,100,18,44,27,66,93,11,6,25,24,54,104,C
1994,27,82,2853,641,1404,13,53,628,1351,352,460,164,386,550,159,118,111,169,263,1647,C
1994,28,80,3241,840,1658,10,29,830,1629,693,925,241,614,855,381,139,265,253,228,2383,C
1994,23,58,673,104,285,23,73,81,212,45,67,34,44,78,68,30,15,52,69,276,PG
1994,26,6,55,10,20,2,8,8,12,3,8,4,6,10,6,7,0,10,8,25,SG
1994,27,31,396,55,152,8,20,47,132,13,29,6,26,32,63,18,3,43,48,131,PG
1994,27,17,301,42,119,7,15,35,104,10,20,4,20,24,45,15,3,25,33,101,PG
1994,27,14,95,13,33,1,5,12,28,3,9,2,6,8,18,3,0,18,15,30,PG
1994,32,79,2989,156,292,5,24,151,268,53,102,453,914,1367,184,52,32,138,229,370,PF
1994,22,79,1406,239,545,35,92,204,453,127,189,90,136,226,101,63,48,131,195,640,SF
1994,38,45,384,29,53,0,0,29,53,18,30,33,63,96,9,7,35,13,55,76,C
1994,24,47,1255,193,393,0,1,193,392,150,210,84,175,259,49,21,44,80,109,536,C
1994,27,74,1357,174,347,0,2,174,345,199,269,94,154,248,61,50,16,76,121,547,SF
1994,23,67,1121,135,279,2,22,133,257,62,101,61,120,181,54,68,19,55,138,334,SF
1994,29,76,1910,208,436,2,3,206,433,164,225,132,275,407,135,56,78,94,260,582,PF
1994,34,36,363,28,84,0,0,28,84,29,32,31,48,79,13,10,10,23,45,85,C
1994,34,23,230,14,46,0,0,14,46,21,22,16,29,45,5,5,8,14,27,49,C
1994,34,13,133,14,38,0,0,14,38,8,10,15,19,34,8,5,2,9,18,36,C
1994,26,35,152,28,46,0,0,28,46,19,20,11,15,26,6,7,0,8,25,75,C
1994,25,30,319,29,84,0,0,29,84,10,17,26,63,89,13,7,17,13,49,68,C
1994,31,81,2728,445,903,22,68,423,835,300,390,144,310,454,275,73,9,173,273,1212,SF
1994,32,67,1197,256,548,27,74,229,474,157,195,19,91,110,133,62,9,103,80,696,SG
1994,25,82,2283,384,949,155,388,229,561,123,159,54,164,218,216,81,32,93,161,1046,SF
1994,23,43,623,111,274,4,16,107,258,59,87,43,75,118,48,31,8,51,84,285,SF
1994,28,72,2410,392,803,0,2,392,801,304,422,244,496,740,136,59,100,195,279,1088,C
1994,27,77,2037,278,667,73,216,205,451,64,89,104,246,350,385,71,21,173,195,693,SG
1994,25,75,2702,436,996,6,17,430,979,251,323,168,394,562,305,104,50,183,189,1129,SF
1994,29,82,2303,276,644,68,165,208,479,195,222,42,147,189,503,47,2,193,171,815,PG
1994,28,43,1105,176,397,8,16,168,381,87,121,66,99,165,50,26,45,64,144,447,SF
1994,23,80,1617,184,423,10,39,174,384,95,141,15,107,122,285,38,18,101,131,473,PG
1994,24,79,1684,295,678,2,9,293,669,106,127,114,235,349,119,82,38,93,287,698,PF
1994,28,78,2209,341,711,89,220,252,491,135,155,24,114,138,327,59,4,126,121,906,PG
1994,24,66,877,124,306,21,60,103,246,63,84,34,50,84,109,40,5,50,96,332,SG
1994,24,7,48,8,18,0,0,8,18,15,20,5,3,8,5,3,1,1,8,31,SG
1994,24,59,829,116,288,21,60,95,228,48,64,29,47,76,104,37,4,49,88,301,SG
1994,23,43,316,29,72,0,0,29,72,18,38,40,59,99,4,12,6,12,47,76,PF
1994,24,78,2776,491,1076,91,262,400,814,273,327,156,196,352,394,84,35,202,217,1346,SG
1994,25,73,1617,272,617,16,50,256,567,85,119,106,89,195,148,59,14,76,128,645,SG
1994,27,78,2113,493,923,0,1,493,922,238,300,135,348,483,156,49,82,151,281,1224,C
1994,29,28,349,52,118,0,0,52,118,55,77,30,43,73,22,19,7,21,43,159,SF
1994,29,5,63,9,18,0,0,9,18,3,4,4,8,12,3,1,2,2,6,21,SF
1994,29,23,286,43,100,0,0,43,100,52,73,26,35,61,19,18,5,19,37,138,SF
1994,24,76,1930,288,540,0,2,288,538,97,162,96,319,415,75,30,127,168,208,673,C
1994,26,79,2210,256,507,0,0,256,507,165,272,235,423,658,43,41,67,127,304,677,C
1994,23,82,3533,613,1417,141,391,472,1026,353,456,80,321,401,385,180,76,226,158,1720,SG
1994,28,59,2057,410,977,113,337,297,640,187,248,37,148,185,348,95,6,184,191,1120,SG
1994,25,3,35,3,8,0,0,3,8,7,10,1,6,7,2,2,1,2,4,13,SF
1994,23,82,2853,365,811,2,9,363,802,291,351,119,230,349,199,116,16,131,165,1023,SG
1994,31,82,2969,458,868,48,149,410,719,272,338,72,186,258,1031,199,22,266,236,1236,PG
1994,27,82,2889,528,1093,2,10,526,1083,353,471,122,248,370,740,147,24,257,171,1411,PG
1994,25,67,1131,141,341,3,13,138,328,159,206,109,172,281,48,38,14,61,69,444,PF
1994,32,58,1750,318,763,39,126,279,637,181,258,46,113,159,399,68,6,202,126,856,PG
1994,22,14,58,6,14,0,1,6,13,1,2,7,6,13,3,0,2,5,11,13,C
1994,32,30,282,27,77,0,0,27,77,16,30,26,49,75,16,10,8,23,59,70,C
1994,31,82,2909,449,801,0,2,449,799,251,382,271,599,870,189,66,28,185,253,1149,PF
1994,32,81,2278,411,852,5,33,406,819,138,155,28,125,153,344,110,19,106,186,965,PG
1994,29,79,2557,552,1102,0,0,552,1102,215,266,159,401,560,139,37,52,124,290,1319,PF
1994,28,49,640,74,177,6,16,68,161,33,45,36,72,108,30,13,15,39,61,187,SF
1994,31,12,64,2,12,0,1,2,11,2,2,1,2,3,11,0,0,5,8,6,PG
1994,23,11,32,4,9,0,0,4,9,0,0,0,6,6,1,0,0,0,6,8,C
1994,31,68,1536,199,426,18,55,181,371,35,45,79,192,271,60,23,11,75,239,451,PF
1994,22,81,2700,413,1049,123,364,290,685,150,192,47,191,238,466,85,8,145,154,1099,PG
1994,25,75,2118,373,695,0,5,373,690,131,182,218,438,656,74,76,22,96,221,877,PF
1994,29,73,1397,132,274,0,3,132,271,87,125,118,171,289,33,26,59,44,156,351,SF
1994,23,48,386,60,115,14,28,46,87,28,34,6,32,38,71,15,3,30,41,162,SG
1994,23,82,3147,602,1246,4,17,598,1229,298,430,254,578,832,192,100,116,195,152,1506,SF
1994,30,79,2567,373,810,55,164,318,646,204,251,44,178,222,528,93,23,168,182,1005,PG
1994,20,76,2438,572,1037,0,14,572,1023,189,355,305,389,694,272,93,164,206,247,1333,C
1994,30,76,1371,235,482,0,2,235,480,72,88,117,236,353,70,43,29,75,214,542,C
1994,23,11,37,6,10,0,0,6,10,6,10,6,6,12,0,0,2,4,7,18,C
1994,23,60,542,64,174,11,47,53,127,44,53,10,34,44,123,38,4,52,47,183,PG
1994,26,72,2182,434,891,1,8,433,883,187,231,61,170,231,172,65,24,137,236,1056,SG
1994,33,82,1236,162,286,0,0,162,286,58,116,112,183,295,33,31,109,74,214,382,C
1994,31,82,1004,120,236,0,6,120,230,52,66,22,77,99,181,59,2,78,93,292,PG
1994,26,18,320,45,112,6,20,39,92,19,33,30,53,83,11,10,10,18,46,115,PF
1994,22,40,339,25,82,10,30,15,52,12,15,5,24,29,53,11,1,37,53,72,PG
1994,27,16,158,9,29,3,10,6,19,0,0,0,10,10,23,15,0,17,21,21,PG
1994,27,4,34,3,8,1,4,2,4,0,0,0,4,4,7,2,0,6,4,7,PG
1994,27,12,124,6,21,2,6,4,15,0,0,0,6,6,16,13,0,11,17,14,PG
1994,34,74,2635,698,1588,85,295,613,1293,442,522,182,299,481,169,92,30,172,126,1923,SF
1994,34,49,1687,430,996,61,198,369,798,275,322,119,186,305,114,63,22,120,87,1196,SF
1994,34,25,948,268,592,24,97,244,495,167,200,63,113,176,55,29,8,52,39,727,SF
1994,30,82,2768,446,975,84,212,362,763,194,250,106,197,303,255,105,38,131,186,1170,SG
1994,22,6,12,2,8,0,0,2,8,0,1,1,2,3,1,0,0,1,4,4,PF
1994,33,81,2636,291,524,0,1,291,523,201,296,315,528,843,80,58,47,111,239,783,PF
1994,23,4,46,5,13,0,1,5,12,1,1,1,5,6,6,2,0,2,6,11,PG
1994,35,70,774,103,233,0,1,103,232,27,42,56,126,182,28,18,43,39,108,233,C
1994,31,76,2660,394,825,0,0,394,825,252,346,207,368,575,193,78,130,139,219,1040,PF
1994,25,70,877,125,293,0,0,125,293,72,119,109,154,263,26,17,36,35,140,322,PF
1994,27,34,725,81,188,5,20,76,168,24,36,37,90,127,97,25,10,35,85,191,SF
1994,24,68,982,191,391,0,4,191,387,45,64,93,112,205,52,24,49,45,99,427,SF
1994,24,38,716,49,110,0,1,49,109,12,28,95,122,217,25,18,46,22,92,110,PF
1994,24,3,19,1,6,0,1,1,5,0,0,3,1,4,2,2,3,0,3,2,PF
1994,24,1,19,0,1,0,0,0,1,0,0,0,4,4,0,1,2,1,2,0,PF
1994,24,34,678,48,103,0,0,48,103,12,28,92,117,209,23,15,41,21,87,108,PF
1994,27,71,2206,314,687,10,45,304,642,333,397,67,154,221,512,118,24,203,193,971,PG
1994,29,82,2654,418,1014,64,230,354,784,165,225,98,294,392,300,117,66,163,288,1065,SF
1994,25,38,638,114,236,1,5,113,231,60,98,69,112,181,39,16,21,44,112,289,C
1994,23,57,1356,226,580,38,132,188,448,148,233,71,164,235,132,52,23,145,200,638,SF
1994,31,80,2867,627,1257,9,24,618,1233,268,376,335,628,963,150,79,38,188,250,1531,PF
1994,25,57,1221,187,388,0,2,187,386,92,166,120,153,273,72,38,11,93,123,466,PF
1994,25,5,126,19,39,0,0,19,39,13,25,12,16,28,12,5,1,6,17,51,PF
1994,25,52,1095,168,349,0,2,168,347,79,141,108,137,245,60,33,10,87,106,415,PF
1994,30,50,1005,136,283,4,12,132,271,34,51,30,104,134,104,42,6,53,85,310,SG
1994,29,78,1182,119,259,22,49,97,210,62,82,104,135,239,51,39,19,35,201,322,PF
1994,23,40,352,49,133,27,78,22,55,20,35,13,16,29,71,24,2,34,40,145,PG
1994,34,74,1955,364,773,1,14,363,759,208,302,103,195,298,139,41,56,142,186,937,SF
1994,28,65,1714,195,460,18,56,177,404,93,116,32,172,204,404,85,4,151,152,501,PG
1994,32,80,1597,340,838,32,111,308,727,100,135,48,133,181,154,45,18,97,80,812,SF
1994,22,15,92,8,23,0,1,8,22,3,4,6,4,10,0,1,2,6,21,19,C
1995,26,54,506,118,231,0,2,118,229,20,35,37,77,114,13,15,12,45,104,256,PF
1995,26,51,476,117,220,0,2,117,218,20,35,34,72,106,13,15,12,40,102,254,PF
1995,26,3,30,1,11,0,0,1,11,0,0,3,5,8,0,0,0,5,2,2,PF
1995,25,73,2082,472,1005,83,215,389,790,138,156,32,105,137,263,77,9,119,126,1165,PG
1995,32,29,443,67,148,29,81,38,67,25,30,6,23,29,95,23,1,26,41,188,PG
1995,30,79,1776,279,586,24,83,255,503,74,99,67,175,242,109,53,25,76,236,656,SF
1995,35,74,1374,194,422,78,214,116,208,105,130,25,84,109,210,46,7,79,155,571,SG
1995,25,50,1237,230,447,6,25,224,422,36,60,87,204,291,60,28,29,76,145,502,C
1995,22,64,1032,120,258,0,4,120,254,59,120,98,121,219,33,39,35,53,107,299,C
1995,30,51,622,57,104,0,0,57,104,34,71,62,126,188,17,23,32,32,103,148,PF
1995,24,72,2689,411,1031,97,294,314,737,348,414,73,177,250,680,103,14,225,184,1267,PG
1995,27,76,2588,439,923,179,431,260,492,143,203,85,250,335,314,125,22,141,124,1200,SG
1995,28,38,556,76,162,3,19,73,143,30,41,15,40,55,52,26,10,38,71,185,SG
1995,27,61,943,128,293,56,155,72,138,60,76,7,57,64,160,50,7,57,99,372,PG
1995,27,82,2577,418,894,108,253,310,641,206,233,25,161,186,244,84,8,103,159,1150,PG
1995,26,3,8,3,8,2,6,1,2,2,2,1,0,1,3,1,0,1,3,10,PG
1995,28,71,1721,248,504,31,94,217,410,176,238,65,116,181,176,49,13,85,191,703,SG
1995,27,50,854,81,207,21,78,60,129,46,57,86,112,198,39,35,17,25,109,229,SF
1995,26,76,2362,397,876,7,26,390,850,252,346,157,211,368,197,100,47,152,163,1053,SG
1995,25,71,1066,105,244,0,0,105,244,48,75,97,196,293,41,28,50,53,170,258,PF
1995,23,82,3361,594,1229,7,24,587,1205,256,432,289,557,846,296,86,116,221,277,1451,PF
1995,31,68,2382,554,1141,74,219,480,922,379,507,203,553,756,276,110,45,150,201,1561,PF
1995,27,82,3318,571,1165,197,425,374,740,347,386,27,247,274,619,149,4,242,159,1686,PG
1995,25,52,602,57,134,16,48,41,86,61,80,15,34,49,85,30,4,41,54,191,SG
1995,32,28,280,43,114,11,31,32,83,19,26,3,8,11,37,8,1,17,28,116,SG
1995,29,10,74,11,22,1,6,10,16,7,9,1,6,7,14,1,1,7,10,30,PG
1995,30,61,1598,271,531,0,0,271,531,133,175,94,346,440,38,23,64,125,151,675,C
1995,24,4,18,6,11,0,2,6,9,3,4,0,1,1,3,4,0,3,3,15,PG
1995,25,3,46,6,13,2,9,4,4,0,0,0,2,2,4,0,0,3,6,14,PG
1995,26,71,1841,285,587,38,115,247,472,132,157,96,272,368,58,45,47,75,183,740,SF
1995,26,13,80,8,13,0,0,8,13,2,3,2,9,11,11,4,0,5,8,18,PG
1995,26,4,19,2,3,0,0,2,3,0,0,0,3,3,5,1,0,2,1,4,PG
1995,26,9,61,6,10,0,0,6,10,2,3,2,6,8,6,3,0,3,7,14,PG
1995,27,80,3069,509,1198,199,555,310,643,156,214,117,276,393,616,200,26,242,164,1373,PG
1995,26,68,889,100,210,0,2,100,208,38,67,107,133,240,60,26,33,59,146,238,PF
1995,30,78,2629,348,730,6,30,342,700,160,180,51,206,257,675,103,0,132,151,862,PG
1995,32,5,81,6,10,3,5,3,5,0,0,1,11,12,0,0,9,1,10,15,C
1995,25,23,290,39,84,15,41,24,43,14,20,8,24,32,24,6,4,17,47,107,SG
1995,25,5,51,3,12,1,4,2,8,3,4,1,4,5,7,1,0,3,10,10,SG
1995,25,18,239,36,72,14,37,22,35,11,16,7,20,27,17,5,4,14,37,97,SG
1995,26,58,1126,88,193,1,5,87,188,44,67,113,149,262,80,48,23,79,159,221,PF
1995,31,77,1261,177,369,12,40,165,329,61,73,54,85,139,159,47,21,86,138,427,SG
1995,33,67,1225,118,267,2,11,116,256,68,89,72,216,288,118,21,80,91,182,306,C
1995,22,82,2365,315,693,0,3,315,690,148,232,243,416,659,53,54,274,142,338,778,C
1995,24,67,1961,341,762,48,121,293,641,159,186,35,151,186,363,107,14,144,118,889,PG
1995,24,42,340,45,121,6,25,39,96,32,49,16,18,34,15,11,4,16,25,128,SF
1995,29,59,808,126,275,25,69,101,206,64,79,14,52,66,116,34,4,47,56,341,PG
1995,29,28,186,35,65,8,17,27,48,18,21,1,12,13,22,8,1,14,14,96,PG
1995,29,31,622,91,210,17,52,74,158,46,58,13,40,53,94,26,3,33,42,245,PG
1995,26,41,814,105,174,1,3,104,171,38,62,64,125,189,30,11,14,29,105,249,SF
1995,26,79,2792,437,977,126,327,311,650,236,277,63,186,249,301,110,49,146,181,1236,SG
1995,31,27,213,10,40,0,1,10,39,15,27,9,36,45,10,7,0,16,35,35,C
1995,25,80,2466,254,570,4,24,250,546,139,207,178,309,487,135,69,135,80,262,651,C
1995,26,67,1086,124,287,14,47,110,240,55,82,24,84,108,133,99,19,78,153,317,PG
1995,29,49,658,101,192,1,2,100,190,41,63,55,106,161,28,19,16,39,109,244,PF
1995,26,57,605,90,183,15,48,75,135,22,39,36,62,98,50,24,12,30,64,217,SF
1995,24,65,2014,277,593,96,235,181,358,100,144,96,272,368,161,75,40,85,187,750,SF
1995,26,53,1564,243,606,106,275,137,331,220,267,49,115,164,96,32,19,122,167,812,SF
1995,24,76,1554,214,508,46,141,168,367,123,185,43,127,170,91,61,10,106,155,597,SG
1995,33,82,2040,177,340,0,2,177,338,53,88,203,361,564,56,61,67,56,149,407,C
1995,28,7,30,1,4,0,0,1,4,3,6,1,9,10,0,1,0,1,6,5,PF
1995,26,73,2076,360,785,0,1,360,784,193,290,168,277,445,92,69,132,98,246,913,PF
1995,32,78,1128,161,392,15,42,146,350,132,159,60,93,153,69,32,8,65,122,469,SF
1995,33,78,1677,290,546,1,4,289,542,165,201,81,184,265,67,24,68,87,253,746,C
1995,37,29,430,27,69,0,0,27,69,15,24,25,62,87,10,6,3,18,70,69,C
1995,25,82,1882,253,593,63,191,190,402,214,254,38,173,211,405,94,14,167,209,783,PG
1995,26,58,820,76,147,0,1,76,146,57,98,57,117,174,15,14,80,33,146,209,C
1995,25,58,2029,497,977,58,146,439,831,209,292,169,295,464,105,60,19,143,131,1261,SF
1995,35,81,1240,195,427,4,24,191,403,109,135,66,147,213,73,25,30,52,173,503,PF
1995,27,45,1468,254,639,86,274,168,365,137,159,23,90,113,128,67,15,62,85,731,SG
1995,23,78,2651,512,1129,96,283,416,846,173,213,105,216,321,177,80,21,151,215,1293,SG
1995,26,68,1347,146,328,35,86,111,242,31,42,106,211,317,66,25,43,61,117,358,PF
1995,27,53,1021,106,279,41,125,65,154,55,73,14,55,69,219,42,3,76,116,308,PG
1995,24,12,79,5,22,1,7,4,15,4,5,3,10,13,8,2,1,13,18,15,SG
1995,27,56,2103,371,875,28,120,343,755,376,490,167,424,591,187,35,94,172,162,1146,PF
1995,26,68,2207,261,607,16,76,245,531,141,174,46,145,191,416,99,13,156,185,679,PG
1995,32,57,752,67,169,8,35,59,134,54,71,13,46,59,101,30,6,36,53,196,PG
1995,27,82,2064,344,647,8,29,336,618,119,194,160,266,426,110,42,18,123,218,815,C
1995,32,81,1389,205,464,14,56,191,408,78,114,98,164,262,67,55,16,74,161,502,SF
1995,25,80,1019,93,231,11,36,82,195,98,121,27,70,97,205,39,6,70,105,295,PG
1995,25,7,29,2,10,0,4,2,6,2,6,1,2,3,1,1,0,2,1,6,SF
1995,33,76,1273,224,464,0,0,224,464,72,123,138,240,378,59,36,19,95,188,520,PF
1995,22,53,595,58,134,0,0,58,134,27,36,54,70,124,25,21,21,25,128,143,PF
1995,30,69,1718,343,778,154,361,189,417,95,111,41,127,168,113,55,18,98,144,935,SG
1995,27,30,604,80,209,26,100,54,109,22,27,29,34,63,40,22,10,31,48,208,SG
1995,27,5,63,9,27,3,14,6,13,2,2,2,5,7,4,2,0,8,8,23,SG
1995,27,25,541,71,182,23,86,48,96,20,25,27,29,56,36,20,10,23,40,185,SG
1995,22,1,3,0,1,0,0,0,1,0,0,0,1,1,0,0,0,1,2,0,C
1995,26,44,1030,109,245,0,0,109,245,117,174,105,175,280,25,19,29,64,134,335,PF
1995,25,74,2346,324,576,0,1,324,575,138,259,259,437,696,58,72,116,124,222,786,PF
1995,24,82,1697,296,617,131,288,165,329,97,120,30,80,110,150,35,11,87,146,820,SG
1995,27,46,580,49,113,0,2,49,111,42,66,63,93,156,10,6,3,30,76,140,PF
1995,31,50,1170,125,270,25,73,100,197,50,55,28,85,113,205,52,1,86,74,325,PG
1995,27,2,13,3,8,1,3,2,5,1,1,0,3,3,1,0,0,2,4,8,SF
1995,25,82,2717,445,1049,163,418,282,631,257,341,95,227,322,134,104,63,157,283,1310,SG
1995,23,80,1774,279,685,48,163,231,522,229,292,35,117,152,225,45,7,157,200,835,PG
1995,28,75,2360,372,766,66,162,306,604,128,162,28,164,192,226,61,14,56,179,938,SG
1995,25,63,1261,196,333,0,0,196,333,106,162,98,200,298,53,38,43,114,210,498,C
1995,26,80,2807,485,957,10,53,475,904,297,382,261,568,829,329,109,174,205,305,1277,C
1995,37,43,613,44,74,0,0,44,74,22,31,19,88,107,14,6,28,22,66,110,C
1995,28,65,2048,365,769,20,82,345,687,204,296,48,122,170,446,80,2,162,152,954,PG
1995,32,58,483,42,102,0,0,42,102,26,41,32,84,116,22,6,22,25,108,110,C
1995,32,76,2728,571,1238,147,408,424,830,364,442,152,328,480,362,136,45,186,206,1653,SG
1995,32,41,1428,305,712,87,240,218,472,207,248,84,150,234,208,74,22,97,117,904,SG
1995,32,35,1300,266,526,60,168,206,358,157,194,68,178,246,154,62,23,89,89,749,SG
1995,30,40,818,118,267,2,10,116,257,45,70,65,130,195,20,21,24,59,110,283,C
1995,29,82,2245,181,446,0,1,181,445,85,183,325,439,764,34,43,126,81,286,447,C
1995,31,67,2544,417,970,103,338,314,632,277,344,47,111,158,368,72,7,219,153,1214,SG
1995,25,15,167,37,73,0,1,37,72,8,16,18,11,29,7,10,2,9,22,82,SF
1995,22,58,613,96,250,22,73,74,177,50,77,32,30,62,57,13,4,50,78,264,SG
1995,27,59,852,117,237,5,26,112,211,63,96,37,57,94,53,36,32,45,114,302,SF
1995,28,54,898,143,326,18,41,125,285,91,126,33,62,95,72,19,2,53,88,395,SG
1995,24,30,208,26,68,0,0,26,68,14,29,19,26,45,2,6,8,14,39,66,C
1995,29,67,1112,181,393,22,75,159,318,75,90,50,80,130,77,43,16,81,143,459,SF
1995,29,31,507,83,195,11,43,72,152,43,48,25,40,65,47,19,10,39,64,220,SF
1995,29,36,605,98,198,11,32,87,166,32,42,25,40,65,30,24,6,42,79,239,SF
1995,24,38,212,22,48,0,1,22,47,23,32,19,29,48,13,5,4,22,30,67,PF
1995,39,28,266,32,83,0,0,32,83,11,17,10,33,43,8,5,8,14,44,75,C
1995,29,14,466,69,154,18,45,51,109,40,42,10,27,37,27,19,5,35,42,196,SG
1995,33,49,1166,191,422,51,134,140,288,44,71,55,92,147,113,46,6,73,86,477,SG
1995,22,49,552,40,122,9,37,31,85,31,40,12,36,48,95,18,6,50,81,120,PG
1995,22,34,496,37,105,8,32,29,73,31,40,10,32,42,77,18,5,42,78,113,PG
1995,22,15,56,3,17,1,5,2,12,0,0,2,4,6,18,0,1,8,3,7,PG
1995,31,81,1896,243,487,80,201,163,286,144,171,50,146,196,189,65,12,104,158,710,SF
1995,26,81,2858,502,1072,136,333,366,739,326,404,63,224,287,206,78,38,151,216,1466,SF
1995,34,81,1996,351,774,106,263,245,511,110,127,56,166,222,57,37,9,81,142,918,SF
1995,24,69,656,91,189,1,13,90,176,69,117,56,32,88,40,67,12,49,102,252,SF
1995,24,6,58,9,25,0,0,9,25,6,6,7,10,17,4,1,5,5,12,24,PF
1995,27,55,1083,152,300,0,2,152,298,71,99,124,185,309,34,22,54,76,179,375,C
1995,24,8,127,15,39,3,12,12,27,10,13,1,2,3,7,7,1,6,19,43,SG
1995,32,79,2920,730,1452,6,21,724,1431,420,560,157,710,867,212,68,159,256,272,1886,C
1995,29,56,607,83,173,1,6,82,167,64,85,50,38,88,31,26,6,43,79,231,SF
1995,28,82,1290,223,500,94,233,129,267,74,84,30,113,143,96,27,22,59,131,614,PF
1995,25,26,370,49,103,0,1,49,102,25,37,32,52,84,17,16,7,28,70,123,C
1995,32,55,686,93,188,0,7,93,181,65,90,20,68,88,109,27,1,43,80,251,PG
1995,34,48,831,71,212,25,88,46,124,30,43,8,46,54,126,13,6,51,73,197,SG
1995,23,5,98,9,39,0,9,9,30,1,2,8,12,20,9,1,0,8,5,19,SG
1995,26,78,1144,150,318,7,23,143,295,78,111,85,174,259,39,15,28,71,183,385,PF
1995,26,17,299,41,86,0,0,41,86,22,31,18,36,54,16,2,8,17,54,104,PF
1995,26,61,845,109,232,7,23,102,209,56,80,67,138,205,23,13,20,54,129,281,PF
1995,25,53,1039,169,351,31,75,138,276,95,123,61,94,155,139,52,19,78,154,464,SF
1995,29,11,280,24,51,2,15,22,36,5,11,1,17,18,33,8,1,14,23,55,SG
1995,29,77,1223,220,450,39,98,181,352,87,111,29,93,122,119,52,10,49,130,566,SF
1995,30,73,1931,170,410,19,75,151,335,89,112,48,120,168,318,71,13,105,184,448,PG
1995,27,58,1470,324,512,0,1,324,511,148,250,144,299,443,51,39,52,117,184,796,PF
1995,30,21,409,47,100,0,1,47,99,31,51,21,54,75,17,7,15,22,64,125,PF
1995,25,74,1712,260,485,4,10,256,475,93,143,146,267,413,55,41,51,113,245,617,C
1995,26,3,8,1,3,0,1,1,2,2,2,1,0,1,0,0,0,2,1,4,SG
1995,26,73,2125,392,858,63,171,329,687,155,209,99,191,290,192,117,28,138,186,1002,SG
1995,30,82,2472,455,905,0,2,455,903,302,392,192,421,613,99,67,89,152,171,1212,PF
1995,24,50,775,95,223,6,28,89,195,55,73,19,43,62,66,29,6,48,76,251,SG
1995,30,2,8,1,4,0,0,1,4,0,0,3,2,5,2,0,0,0,2,2,PF
1995,22,80,2289,413,809,1,4,412,805,231,363,207,391,598,99,49,116,163,276,1058,PF
1995,29,33,470,78,166,4,16,74,150,45,55,8,27,35,93,29,3,44,66,205,PG
1995,28,14,151,10,33,2,7,8,26,9,12,2,7,9,43,6,2,14,20,31,PG
1995,29,75,1771,286,621,8,26,278,595,103,146,103,181,284,82,56,53,62,163,683,PF
1995,29,74,2693,401,707,0,8,401,699,146,211,223,492,715,173,76,88,85,203,948,PF
1995,29,47,1098,163,381,5,15,158,366,58,83,58,91,149,74,27,4,56,80,389,SG
1995,31,82,2687,311,617,43,127,268,490,251,343,194,475,669,127,55,31,114,146,916,SF
1995,25,6,226,33,83,4,8,29,75,26,33,16,37,53,18,21,11,15,19,96,PF
1995,25,40,1324,176,397,28,90,148,307,55,97,100,197,297,122,50,23,93,98,435,PF
1995,25,31,1018,162,357,28,88,134,269,93,122,49,173,222,139,61,28,81,86,445,SF
1995,26,17,167,16,47,0,4,16,43,13,19,16,29,45,10,8,1,12,29,45,PF
1995,31,31,117,26,61,0,1,26,60,21,32,8,19,27,2,3,5,13,31,73,PF
1995,25,1,7,1,3,0,0,1,3,2,2,0,2,2,1,0,0,0,1,4,C
1995,27,70,956,139,260,0,1,139,259,132,177,55,167,222,36,11,14,56,132,410,PF
1995,23,46,424,68,121,1,3,67,118,16,39,14,39,53,30,19,4,30,48,153,SF
1995,23,77,2901,585,1142,87,249,498,893,356,463,139,197,336,551,130,26,258,158,1613,PG
1995,28,62,2321,430,1007,168,444,262,563,219,288,46,144,190,578,88,12,214,155,1247,PG
1995,25,10,158,21,53,1,1,20,52,3,6,9,14,23,12,9,0,7,12,46,SG
1995,33,80,2716,337,756,106,292,231,464,139,192,31,163,194,458,79,10,151,219,919,PG
1995,31,77,1536,209,491,31,110,178,381,81,131,51,129,180,157,97,27,100,132,530,SG
1995,24,79,1695,280,610,55,142,225,468,136,170,85,135,220,132,58,14,77,105,751,SG
1995,27,3,18,3,8,0,1,3,7,8,9,0,0,0,0,0,0,1,2,14,SG
1995,24,59,572,77,176,1,1,76,175,24,45,39,63,102,23,15,41,25,87,179,PF
1995,28,82,2731,390,809,131,298,259,511,261,301,60,254,314,262,122,18,150,178,1172,SG
1995,26,37,380,37,86,23,52,14,34,22,25,3,23,26,85,9,0,30,52,119,PG
1995,28,61,1331,171,327,0,2,171,325,73,117,98,180,278,44,40,38,71,136,415,PF
1995,35,5,46,3,12,1,6,2,6,3,4,4,3,7,3,1,1,1,7,10,SF
1995,26,57,735,105,273,23,78,82,195,35,40,25,52,77,29,10,9,35,93,268,SF
1995,22,70,2678,508,1064,4,27,504,1037,374,511,125,320,445,353,124,62,202,203,1394,SF
1995,26,70,2397,350,694,0,1,350,693,263,397,269,496,765,55,55,41,151,245,963,C
1995,25,54,633,83,204,4,14,79,190,39,51,40,82,122,41,10,14,39,107,209,C
1995,31,81,2696,482,937,89,219,393,718,284,322,53,157,210,347,129,17,145,181,1337,SG
1995,24,64,2074,240,537,86,227,154,310,86,113,81,243,324,216,94,76,122,161,652,PF
1995,23,76,1996,398,859,158,373,240,486,147,171,29,138,167,164,61,14,113,182,1101,SG
1995,25,39,258,49,107,6,22,43,85,28,38,20,35,55,6,13,5,20,50,132,PF
1995,21,65,2348,455,931,0,7,455,924,194,292,184,361,545,165,52,15,166,236,1104,PF
1995,32,12,149,4,25,2,3,2,22,0,0,2,8,10,9,7,0,12,25,10,SG
1995,32,6,52,4,9,0,1,4,8,2,4,2,1,3,10,2,0,5,10,10,PG
1995,24,42,944,119,318,36,108,83,210,40,55,24,51,75,159,51,7,79,94,314,PG
1995,23,68,1105,103,284,21,76,82,208,58,76,14,56,70,226,29,0,110,79,285,PG
1995,27,21,257,25,68,4,15,21,53,16,24,18,24,42,19,9,5,17,33,70,SG
1995,24,51,1982,484,1026,35,110,449,916,306,380,120,140,260,191,28,12,160,92,1309,SG
1995,29,82,2402,239,566,27,87,212,479,119,153,73,233,306,616,105,16,210,148,624,PG
1995,26,80,1722,190,425,75,204,115,221,134,153,26,122,148,373,95,2,120,133,589,PG
1995,29,82,3011,448,863,3,22,445,841,202,295,49,159,208,670,114,13,207,154,1101,PG
1995,27,64,907,85,192,0,1,85,191,29,46,101,188,289,16,17,67,54,163,199,C
1995,28,47,1352,246,523,4,26,242,497,234,289,32,83,115,360,47,18,105,88,730,PG
1995,25,81,3234,585,1219,81,210,504,1009,274,354,190,395,585,369,78,28,207,174,1525,PF
1995,23,11,139,15,44,2,12,13,32,13,16,6,5,11,16,6,0,9,19,45,SG
1995,37,3,36,1,3,0,0,1,3,1,2,2,5,7,0,0,1,0,8,3,PF
1995,23,64,1981,342,744,91,246,251,498,122,169,79,170,249,128,131,41,75,175,897,SG
1995,24,80,2385,372,839,1,12,371,827,80,124,329,515,844,163,35,27,124,267,825,PF
1995,31,17,668,166,404,16,32,150,372,109,136,25,92,117,90,30,13,35,47,457,SG
1995,24,75,1270,172,298,0,0,172,298,117,173,135,192,327,30,36,25,62,141,461,SF
1995,25,82,2679,545,997,2,7,543,990,438,585,318,575,893,149,102,122,259,337,1530,PF
1995,29,82,1839,261,495,89,170,172,325,63,81,20,99,119,151,44,3,48,114,674,PG
1995,32,63,1143,203,489,7,27,196,462,95,124,93,163,256,82,52,35,64,173,508,SF
1995,28,6,83,9,26,0,9,9,17,2,2,6,11,17,2,1,2,2,16,20,SF
1995,21,79,2668,330,857,70,257,260,600,192,275,152,278,430,607,151,24,250,146,922,PG
1995,25,2,6,0,2,0,0,0,2,0,2,0,0,0,0,0,0,0,1,0,C
1995,28,50,792,99,212,0,1,99,211,68,102,54,111,165,26,24,20,64,126,266,PF
1995,33,11,77,3,17,0,0,3,17,2,10,12,10,22,1,0,0,6,15,8,C
1995,33,2,16,0,3,0,0,0,3,0,0,2,2,4,0,0,0,1,2,0,C
1995,33,9,61,3,14,0,0,3,14,2,10,10,8,18,1,0,0,5,13,8,C
1995,33,75,968,119,265,0,2,119,263,42,49,82,177,259,39,14,18,35,174,280,C
1995,27,47,708,85,214,11,28,74,186,18,25,21,40,61,127,21,5,49,70,199,PG
1995,27,3,43,7,15,0,0,7,15,4,4,1,2,3,11,1,0,4,5,18,PG
1995,27,44,665,78,199,11,28,67,171,14,21,20,38,58,116,20,5,45,65,181,PG
1995,31,62,943,77,187,12,36,65,151,13,24,23,161,184,52,36,46,20,137,179,C
1995,30,19,287,28,72,0,0,28,72,27,30,19,40,59,26,9,2,25,34,83,PF
1995,26,81,2584,487,967,62,198,425,769,235,314,155,285,440,372,102,16,165,163,1271,SF
1995,25,81,2770,450,920,13,40,437,880,409,500,164,449,613,234,101,87,225,302,1322,C
1995,28,82,2340,320,677,2,3,318,674,152,188,154,302,456,72,45,144,108,271,794,C
1995,22,12,53,4,10,0,0,4,10,3,4,3,1,4,1,0,2,5,11,11,SF
1995,28,57,623,87,165,0,2,87,163,51,72,47,127,174,14,15,15,39,122,225,C
1995,30,22,75,9,25,7,18,2,7,18,21,0,5,5,5,6,3,5,18,43,SG
1995,28,24,371,60,115,26,50,34,65,30,34,12,28,40,27,12,1,20,33,176,SG
1995,31,24,188,11,38,5,23,6,15,23,27,6,20,26,44,4,0,21,28,50,PG
1995,34,57,469,55,130,0,1,55,129,19,45,49,75,124,27,13,20,21,91,129,PF
1995,36,60,776,66,134,0,1,66,133,35,70,67,169,236,12,16,57,38,146,167,C
1995,30,61,730,97,231,63,155,34,76,10,15,28,74,102,43,20,25,29,85,267,PF
1995,28,81,2641,342,716,11,31,331,685,244,325,191,415,606,131,109,34,155,243,939,PF
1995,28,2,62,5,12,0,0,5,12,6,10,1,10,11,4,2,0,4,11,16,PF
1995,28,79,2579,337,704,11,31,326,673,238,315,190,405,595,127,107,34,151,232,923,PF
1995,26,55,1001,135,302,0,2,135,300,88,107,82,181,263,73,24,45,86,177,358,C
1995,22,37,672,106,223,3,14,103,209,57,88,24,47,71,101,28,1,57,42,272,SG
1995,24,56,953,138,295,3,21,135,274,62,86,75,109,184,62,51,10,73,86,341,SF
1995,25,39,1052,158,361,10,40,148,321,104,136,46,119,165,51,15,3,44,97,430,PF
1995,25,55,721,101,265,20,62,81,203,54,68,29,47,76,63,67,1,41,97,276,SG
1995,25,7,28,2,6,1,2,1,4,3,4,0,0,0,1,2,0,3,2,8,SG
1995,36,58,630,79,151,1,3,78,148,39,49,45,117,162,26,11,12,34,93,198,PF
1995,29,82,3091,438,1031,199,548,239,483,206,282,104,271,375,340,96,38,105,155,1281,SF
1995,33,19,660,144,284,11,28,133,256,51,59,11,44,55,29,15,0,29,35,350,SG
1995,31,82,3126,830,1548,11,41,819,1507,516,695,156,715,871,285,129,85,236,269,2187,PF
1995,39,17,149,13,35,1,2,12,33,22,32,20,26,46,6,2,3,11,15,49,C
1995,28,46,1510,340,622,6,21,334,601,136,202,97,179,276,154,41,57,121,176,822,PF
1995,30,66,1194,216,457,35,87,181,370,145,198,17,51,68,110,72,3,98,126,612,SG
1995,21,72,2086,345,876,69,243,276,633,147,222,137,268,405,105,45,88,115,157,906,SF
1995,21,40,1036,158,423,32,106,126,317,83,122,64,132,196,57,25,50,58,63,431,SF
1995,21,32,1050,187,453,37,137,150,316,64,100,73,136,209,48,20,38,57,94,475,SF
1995,25,1,14,1,5,0,0,1,5,0,0,2,0,2,1,0,1,0,2,2,C
1995,23,34,803,95,233,7,38,88,195,57,65,14,50,64,133,34,0,62,88,254,PG
1995,22,80,2980,683,1566,113,344,570,1222,447,605,116,215,331,298,82,8,235,190,1926,SF
1995,28,77,2496,287,507,0,1,287,506,191,298,182,468,650,240,69,21,123,253,765,PF
1995,27,80,2127,282,601,0,3,282,598,177,235,160,295,455,67,48,58,118,253,741,C
1995,29,64,2038,306,777,143,441,163,336,99,144,18,146,164,274,75,13,137,157,854,SG
1995,24,82,1744,172,408,72,177,100,231,58,83,21,61,82,276,51,4,106,123,474,PG
1995,27,42,802,144,328,34,89,110,239,80,96,82,65,147,53,23,9,40,71,402,SF
1995,31,68,1430,246,546,6,21,240,525,89,125,94,206,300,108,30,20,89,146,587,SF
1995,22,55,534,34,71,0,0,34,71,28,41,40,65,105,10,10,60,19,95,96,C
1995,28,81,2805,411,833,32,89,379,744,221,297,125,269,394,276,125,49,168,260,1075,SF
1995,22,45,827,116,261,11,28,105,233,50,73,35,94,129,89,36,16,39,97,293,SG
1995,30,80,2070,166,397,53,155,113,242,34,58,65,237,302,421,165,53,126,275,419,PG
1995,23,2,8,1,5,1,3,0,2,0,0,0,1,1,2,1,0,0,0,3,SG
1995,23,46,527,70,132,2,5,68,127,47,76,67,85,152,35,20,7,38,77,189,PF
1995,24,64,1558,232,418,3,13,229,405,78,124,162,313,475,93,60,116,115,217,545,PF
1995,29,81,2665,505,1092,195,470,310,622,383,427,30,180,210,242,98,16,151,157,1588,SG
1995,25,80,2814,359,855,94,240,265,615,174,213,99,267,366,154,59,35,120,242,986,SF
1995,27,72,2514,417,933,109,285,308,648,175,219,124,434,558,160,68,33,144,253,1118,PF
1995,23,45,871,123,305,14,49,109,256,69,95,38,79,117,69,15,6,77,85,329,PG
1995,23,63,945,155,301,2,12,153,289,65,78,49,88,137,66,32,16,44,89,377,SG
1995,31,81,1377,201,413,1,10,200,403,126,174,95,148,243,61,43,20,54,206,529,SF
1995,24,46,587,78,132,2,2,76,130,22,45,55,98,153,21,8,27,24,63,180,C
1995,23,78,2315,307,575,0,1,307,574,167,263,196,370,566,36,29,61,112,299,781,C
1995,29,71,2131,351,856,106,317,245,539,142,195,181,221,402,147,86,51,117,155,950,SF
1995,23,41,395,50,129,9,25,41,104,58,85,21,37,58,18,11,15,27,45,167,PG
1995,24,77,2941,571,1101,11,34,560,1067,490,644,200,561,761,111,49,225,241,275,1643,C
1995,31,25,890,170,348,42,93,128,255,94,107,25,90,115,125,38,19,93,53,476,SF
1995,26,75,2158,338,814,90,240,248,574,211,267,48,166,214,482,113,12,194,139,977,PG
1995,23,73,1720,303,541,0,0,303,541,124,175,179,309,488,38,48,127,115,259,730,C
1995,21,81,2556,439,1093,65,218,374,875,199,264,132,222,354,133,72,55,163,180,1142,SF
1995,23,54,516,95,233,35,86,60,147,33,42,20,39,59,19,14,4,35,73,258,SF
1995,23,29,313,63,153,16,41,47,112,28,34,18,19,37,14,7,1,20,42,170,SF
1995,23,25,203,32,80,19,45,13,35,5,8,2,20,22,5,7,3,15,31,88,SF
1995,28,82,3100,349,628,0,0,349,628,248,379,319,710,1029,113,40,321,192,284,946,C
1995,31,71,1270,119,287,10,39,109,248,70,114,57,82,139,148,58,15,88,125,318,SG
1995,24,34,331,16,45,0,0,16,45,8,22,40,41,81,17,12,11,12,60,40,SF
1995,31,82,1896,226,488,45,128,181,360,137,171,72,101,173,91,69,13,86,234,634,SF
1995,30,74,1879,388,856,98,285,290,571,64,140,103,259,362,94,34,20,96,154,938,SF
1995,23,23,84,9,28,0,0,9,28,13,17,11,13,24,3,0,3,9,20,31,C
1995,22,79,2923,930,1594,0,5,930,1589,455,854,328,573,901,214,73,192,204,258,2315,C
1995,31,50,1567,192,393,3,12,189,381,119,150,155,290,445,126,60,7,103,179,506,PF
1995,32,72,2853,798,1545,3,16,795,1529,406,537,172,603,775,255,133,242,237,250,2005,C
1995,26,6,42,4,9,0,0,4,9,6,8,0,4,4,4,0,0,3,8,14,SG
1995,23,81,1655,170,325,0,5,170,320,82,186,121,192,313,84,90,151,78,227,422,PF
1995,25,82,1704,207,498,53,125,154,373,109,125,26,117,143,246,53,2,104,126,576,PG
1995,25,70,2296,403,820,2,22,401,798,194,313,203,299,502,246,80,30,204,205,1002,SG
1995,25,42,1144,170,395,30,72,140,323,137,175,19,94,113,290,61,6,134,101,507,PG
1995,41,81,1352,159,372,0,0,159,372,71,101,93,257,350,44,27,36,66,132,389,C
1995,26,82,3015,685,1345,70,232,615,1113,249,348,108,173,281,583,204,13,201,206,1689,PG
1995,25,73,1559,285,659,84,216,201,443,102,128,62,106,168,122,52,13,82,143,756,SG
1995,24,6,21,5,5,0,0,5,5,1,2,1,2,3,1,1,0,2,10,11,C
1995,29,78,1592,254,459,0,1,254,458,113,194,211,311,522,90,26,56,116,220,621,C
1995,33,82,2356,346,742,136,343,210,399,215,269,96,302,398,135,72,45,77,186,1043,C
1995,25,82,1977,306,588,25,60,281,528,158,195,51,100,151,394,156,4,163,142,795,PG
1995,29,42,446,27,78,0,14,27,64,22,40,38,51,89,12,10,15,21,51,76,PF
1995,30,81,2033,317,750,172,445,145,305,66,102,49,209,258,106,45,12,102,198,872,SF
1995,23,78,1800,309,638,116,266,193,372,80,101,67,134,201,105,48,24,79,149,814,SG
1995,22,3,5,0,1,0,0,0,1,0,2,0,0,0,1,0,0,0,3,0,PG
1995,25,80,2500,338,816,19,55,319,761,183,235,90,175,265,180,115,25,113,206,878,SG
1995,24,81,1208,201,456,74,198,127,258,90,115,63,70,133,77,37,15,63,150,566,SG
1995,35,27,673,111,254,23,70,88,184,93,106,12,52,64,40,22,2,24,38,338,PG
1995,31,62,835,48,97,0,0,48,97,44,62,65,146,211,21,34,17,26,64,140,PF
1995,29,79,3014,634,1320,109,316,525,1004,315,440,175,464,639,409,232,89,271,238,1692,SF
1995,30,81,2534,376,691,1,1,375,690,124,194,277,448,725,62,48,52,113,238,877,C
1995,31,35,770,105,267,44,114,61,153,58,82,18,63,81,133,30,2,58,60,312,PG
1995,30,48,1375,253,612,103,253,150,359,148,162,25,87,112,335,35,4,142,50,757,PG
1995,27,19,194,13,32,2,8,11,24,16,21,0,12,12,34,2,1,12,22,44,PG
1995,27,14,158,13,29,2,5,11,24,15,17,0,11,11,23,2,1,7,19,43,PG
1995,27,66,2147,450,919,0,1,450,918,233,307,149,424,573,111,60,86,159,232,1133,PF
1995,36,26,195,18,35,0,0,18,35,8,12,10,24,34,16,3,9,8,35,44,PF
1995,27,8,39,3,10,0,1,3,9,0,0,4,8,12,1,0,0,1,5,6,PF
1995,27,3,13,1,6,0,1,1,5,4,4,0,2,2,1,3,0,2,0,6,SG
1995,22,67,1462,206,465,67,171,139,294,140,196,52,134,186,288,77,10,132,139,619,PG
1995,26,81,1566,201,396,1,2,200,394,160,233,120,273,393,55,60,32,113,230,563,PF
1995,27,82,3014,667,1403,185,451,482,952,312,365,99,279,378,192,112,14,153,203,1831,SF
1995,28,80,2864,353,897,87,244,266,653,81,125,38,223,261,632,129,12,171,218,874,PG
1995,29,82,3172,668,1497,156,424,512,1073,375,445,69,288,357,311,91,29,234,227,1867,SG
1995,23,75,2645,558,1249,139,396,419,853,277,339,90,159,249,245,69,23,232,194,1532,SG
1995,24,40,434,65,145,0,1,65,144,47,64,45,67,112,11,17,35,31,78,177,C
1995,33,63,989,108,302,45,127,63,175,60,82,15,94,109,162,65,21,60,150,321,PG
1995,33,3,47,4,13,3,5,1,8,8,11,2,7,9,8,4,0,4,8,19,PG
1995,33,60,942,104,289,42,122,62,167,52,71,13,87,100,154,61,21,56,142,302,PG
1995,34,21,223,28,72,4,11,24,61,20,26,13,21,34,8,6,3,7,26,80,SF
1995,28,75,2725,597,1320,142,383,455,937,265,382,152,271,423,198,79,82,158,240,1601,SF
1995,29,81,3074,788,1487,6,20,782,1467,656,847,234,643,877,236,134,262,233,230,2238,C
1995,22,80,2958,636,1410,86,268,550,1142,397,499,169,344,513,197,115,22,313,234,1755,SF
1995,24,71,1539,255,624,76,223,179,401,65,110,42,90,132,180,48,13,127,142,651,PG
1995,33,49,1568,137,240,0,2,137,238,75,111,274,549,823,97,31,23,98,159,349,PF
1995,23,49,1017,180,340,2,14,178,326,76,146,108,170,278,37,22,52,84,124,438,C
1995,23,80,2142,375,769,50,148,325,621,179,275,132,253,385,161,95,46,173,281,979,PF
1995,39,51,478,20,42,0,0,20,42,21,31,31,64,95,9,7,36,23,63,61,C
1995,25,80,2405,289,615,0,5,289,610,290,381,165,321,486,97,29,71,142,208,868,C
1995,22,81,1798,227,500,36,114,191,386,173,234,57,160,217,389,65,22,160,206,663,SF
1995,28,70,1841,206,434,0,4,206,430,223,299,83,196,279,198,45,16,125,156,635,SF
1995,22,66,1494,189,390,2,7,187,383,68,152,200,286,486,45,35,39,89,196,448,C
1995,24,49,319,84,197,38,99,46,98,27,38,8,15,23,48,14,2,47,52,233,PG
1995,24,63,860,104,238,13,44,91,194,62,93,44,97,141,34,48,11,42,101,283,SF
1995,30,75,1955,197,395,0,0,197,395,153,207,110,226,336,123,47,85,97,279,547,C
1995,35,69,823,126,248,1,1,125,247,50,69,57,151,208,89,20,37,64,170,303,C
1995,27,18,102,12,23,0,0,12,23,15,18,8,15,23,4,2,2,3,9,39,C
1995,26,43,318,41,108,0,0,41,108,6,11,29,52,81,15,3,17,17,45,88,C
1995,32,82,2886,521,997,93,181,428,816,437,521,135,373,508,310,93,35,176,252,1572,SF
1995,33,80,1528,265,583,79,203,186,380,193,227,18,133,151,108,61,13,119,123,802,PG
1995,26,62,1499,283,645,150,352,133,293,86,114,25,121,146,131,45,14,57,119,802,SF
1995,24,60,1604,291,669,22,73,269,596,174,223,77,137,214,107,72,25,83,173,778,SG
1995,29,36,1035,162,314,0,0,162,314,111,160,77,189,266,45,20,37,104,122,435,C
1995,28,21,239,39,65,0,0,39,65,16,20,16,51,67,8,8,6,8,47,94,PF
1995,28,78,1836,192,494,48,184,144,310,70,95,52,189,241,406,73,18,184,184,502,PG
1995,26,58,1064,131,312,6,16,125,296,59,84,61,135,196,89,28,23,70,118,327,SF
1995,22,59,586,78,184,0,0,78,184,50,72,60,91,151,37,10,7,45,72,206,PF
1995,30,62,2077,265,583,96,228,169,355,179,202,26,133,159,452,70,6,172,135,805,PG
1995,24,25,236,40,81,0,0,40,81,40,55,21,36,57,12,7,3,26,47,120,PF
1995,29,76,2150,352,747,7,31,345,716,255,322,144,180,324,120,49,95,147,286,966,SF
1995,24,64,1073,116,264,47,108,69,156,41,63,14,59,73,146,32,22,50,119,320,SG
1995,25,63,826,131,314,1,12,130,302,57,75,43,101,144,44,29,26,37,132,320,PF
1995,29,81,2030,287,593,142,331,145,262,126,148,27,128,155,323,71,10,123,109,842,PG
1995,29,29,319,63,134,1,8,62,126,26,30,13,43,56,20,6,2,18,41,153,PF
1995,22,82,1736,220,406,0,2,220,404,127,262,174,312,486,67,61,49,106,235,567,PF
1995,25,80,2665,428,1005,137,416,291,589,312,371,104,172,276,274,62,33,155,225,1305,SG
1995,25,2,62,11,29,2,12,9,17,17,22,4,2,6,7,2,1,4,9,41,SG
1995,25,78,2603,417,976,135,404,282,572,295,349,100,170,270,267,60,32,151,216,1264,SG
1995,26,61,1024,132,309,32,91,100,218,44,63,43,64,107,102,46,7,50,111,340,SG
1995,28,78,2381,558,1060,0,2,558,1058,284,377,192,409,601,111,40,79,189,278,1400,C
1995,25,19,368,52,118,0,1,52,117,28,50,11,54,65,25,14,23,48,62,132,C
1995,27,34,905,105,215,0,0,105,215,107,135,90,170,260,17,12,32,68,131,317,C
1995,24,69,2771,490,1171,90,326,400,845,350,448,58,198,256,279,112,46,230,108,1420,SG
1995,29,80,2725,419,1062,217,611,202,451,168,228,34,185,219,411,92,4,160,257,1223,SG
1995,26,40,346,41,89,0,2,41,87,20,30,28,39,67,18,16,9,16,52,102,SF
1995,24,81,2329,312,661,20,68,292,593,267,324,95,173,268,153,91,18,110,142,911,SG
1995,32,82,2867,429,791,102,227,327,564,246,306,57,194,251,1011,194,22,267,215,1206,PG
1995,24,4,9,1,3,0,0,1,3,1,2,2,2,4,0,0,1,1,0,3,PF
1995,28,64,2267,441,946,46,123,395,823,283,380,73,244,317,562,123,9,209,118,1211,PG
1995,26,70,1344,149,329,2,7,147,322,141,172,136,239,375,44,24,13,79,143,441,PF
1995,27,53,690,94,230,43,115,51,115,32,45,8,48,56,91,33,2,51,114,263,PG
1995,24,9,51,10,18,0,0,10,18,4,5,3,5,8,3,1,0,5,8,24,SF
1995,24,37,182,24,53,0,1,24,52,27,44,23,34,57,4,2,7,18,37,75,C
1995,30,55,1354,292,610,5,18,287,592,102,122,142,307,449,58,45,55,109,155,691,C
1995,24,38,246,45,114,18,58,27,56,8,12,7,16,23,43,10,2,27,46,116,PG
1995,33,38,453,49,118,0,0,49,118,14,16,28,61,89,18,18,10,33,76,112,C
1995,32,70,2096,385,681,0,7,385,674,167,281,202,356,558,112,41,28,132,224,937,PF
1995,32,36,1188,206,366,0,3,206,363,67,127,113,209,322,58,22,13,76,102,479,PF
1995,32,34,908,179,315,0,4,179,311,100,154,89,147,236,54,19,15,56,122,458,PF
1995,33,59,1384,217,437,36,95,181,342,88,111,21,103,124,248,54,12,70,139,558,PG
1995,30,65,1276,278,574,0,0,278,574,94,122,83,164,247,45,29,27,64,190,650,PF
1995,29,10,57,6,18,0,4,6,14,2,2,7,10,17,2,0,0,3,9,14,PF
1995,24,3,7,0,2,0,0,0,2,1,2,1,2,3,0,0,0,1,1,1,C
1995,25,62,982,96,210,0,1,96,209,51,83,44,126,170,68,46,11,56,129,243,SF
1995,28,30,149,23,57,2,5,21,52,20,35,17,11,28,7,8,1,12,20,68,PF
1995,32,49,576,73,178,27,75,46,103,26,29,23,74,97,38,12,3,22,102,199,PF
1995,23,55,809,72,189,16,51,56,138,35,50,13,49,62,174,36,2,97,58,195,PG
1995,23,80,2944,465,1107,183,511,282,596,235,300,27,196,223,660,97,6,220,157,1348,PG
1995,26,80,2966,609,1185,7,33,602,1152,176,248,261,511,772,139,104,29,166,243,1401,PF
1995,24,5,27,1,7,1,6,0,1,1,1,0,0,0,1,0,0,2,4,4,SG
1995,30,24,266,18,42,0,0,18,42,21,28,19,28,47,7,5,5,15,42,57,SF
1995,24,80,1435,206,469,71,196,135,273,40,52,18,75,93,121,37,16,71,135,523,SG
1995,24,10,44,4,19,1,10,3,9,7,10,1,5,6,4,2,0,8,7,16,PG
1995,22,60,673,76,152,5,19,71,133,38,56,16,58,74,59,35,11,51,86,195,SF
1995,24,76,2991,543,1238,4,21,539,1217,283,377,144,382,526,215,115,67,191,195,1373,SF
1995,31,76,2458,302,689,48,145,254,544,226,242,29,145,174,468,75,8,185,148,878,PG
1995,21,54,2067,464,938,40,145,424,793,117,233,200,318,518,256,83,85,167,186,1085,PF
1995,31,73,956,156,317,0,4,156,313,51,63,64,126,190,40,22,17,39,198,363,C
1995,24,51,1380,128,313,51,119,77,194,71,94,31,86,117,266,82,9,87,144,378,PG
1995,27,71,2328,351,762,11,61,340,701,206,246,60,167,227,185,65,24,126,250,919,SG
1995,34,67,1543,217,390,0,0,217,390,66,138,160,248,408,18,27,102,85,247,500,C
1995,32,27,292,24,53,2,8,22,45,20,32,9,21,30,54,19,0,19,37,70,PG
1995,23,25,179,14,47,3,19,11,28,11,11,4,9,13,28,4,0,18,34,42,PG
1995,28,43,424,50,117,30,79,20,38,7,10,6,37,43,75,22,2,23,44,137,PG
1995,28,38,407,47,111,29,75,18,36,7,10,6,33,39,69,21,1,19,44,130,PG
1995,28,5,17,3,6,1,4,2,2,0,0,0,4,4,6,1,1,4,0,7,PG
1995,35,77,2423,496,1169,112,289,384,880,266,340,157,244,401,166,61,14,173,130,1370,SF
1995,23,15,72,8,24,0,1,8,23,8,12,5,14,19,0,2,6,7,14,24,PF
1995,34,82,2422,309,604,1,2,308,602,138,205,251,418,669,78,67,69,119,254,757,PF
1995,36,56,743,82,180,0,0,82,180,23,37,23,109,132,27,13,45,40,108,187,C
1995,32,74,2641,366,810,1,5,365,805,196,286,173,334,507,192,83,101,149,211,929,PF
1995,26,75,982,149,323,0,5,149,318,65,122,179,246,425,35,26,33,59,160,363,PF
1995,28,34,402,41,115,4,12,37,103,14,25,23,39,62,27,10,2,35,48,100,SF
1995,25,82,2383,145,304,0,0,145,304,38,101,291,399,690,124,52,148,105,306,328,C
1995,28,1,28,1,4,0,0,1,4,4,5,0,1,1,3,2,0,3,3,6,PG
1995,23,41,503,60,133,0,8,60,125,17,38,42,56,98,49,20,4,41,87,137,SF
1995,30,74,2198,388,846,85,266,303,580,132,174,94,235,329,231,114,67,124,264,993,SF
1995,26,77,1781,206,434,0,7,206,427,79,107,173,312,485,59,71,40,84,237,491,PF
1995,24,77,2739,445,998,103,296,342,702,266,364,100,245,345,316,123,63,243,265,1259,SF
1995,32,67,2390,473,1015,3,15,470,1000,205,297,227,505,732,86,60,36,162,215,1154,PF
1995,32,2,89,16,41,0,1,16,40,10,15,10,26,36,3,1,3,7,7,42,PF
1995,32,65,2301,457,974,3,14,454,960,195,282,217,479,696,83,59,33,155,208,1112,PF
1995,26,15,147,18,40,0,0,18,40,11,14,10,16,26,12,4,2,6,12,47,PF
1995,31,52,515,50,122,4,22,46,100,18,24,11,49,60,56,19,6,27,60,122,SG
1995,20,20,81,18,51,2,12,16,39,8,10,11,19,30,3,5,3,8,15,46,SF
1995,30,63,583,38,81,2,6,36,75,12,16,34,95,129,37,9,6,22,101,90,PF
1995,30,78,1336,153,326,31,91,122,235,91,117,83,158,241,65,28,13,53,217,428,PF
1995,24,62,495,37,117,22,74,15,43,28,38,10,34,44,134,41,0,55,87,124,PG
1995,29,69,1028,101,269,35,98,66,171,55,74,21,90,111,194,59,5,73,115,292,PG
1995,22,79,2044,361,776,0,8,361,768,182,282,191,281,472,48,37,104,151,246,904,C
1995,32,7,77,9,17,5,12,4,5,1,1,1,4,5,12,4,0,4,8,24,PG
1996,26,57,2029,414,955,121,309,293,646,146,157,26,112,138,389,64,3,115,117,1095,PG
1996,33,21,329,37,83,14,41,23,42,26,35,5,17,22,67,21,4,25,25,114,PG
1996,31,53,516,77,165,0,9,77,156,17,22,25,65,90,30,9,9,27,74,171,SF
1996,22,60,560,63,155,26,66,37,89,16,25,9,33,42,121,27,2,68,94,168,PG
1996,23,41,362,36,105,10,33,26,72,26,36,5,20,25,49,21,5,34,42,108,SG
1996,23,73,1614,198,387,1,3,197,384,55,112,127,175,302,61,56,52,59,191,452,C
1996,25,28,357,29,70,0,0,29,70,19,33,13,39,52,9,6,11,34,49,77,PF
1996,24,54,1104,121,252,0,1,121,251,97,149,114,189,303,33,22,10,57,151,339,PF
1996,31,46,344,24,47,0,1,24,46,6,25,29,71,100,10,9,24,22,66,54,PF
1996,25,69,2344,349,834,92,256,257,578,260,338,63,140,203,575,111,14,146,178,1050,PG
1996,25,31,1042,143,380,36,99,107,281,151,188,37,64,101,247,52,8,58,73,473,PG
1996,25,38,1302,206,454,56,157,150,297,109,150,26,76,102,328,59,6,88,105,577,PG
1996,28,77,2717,400,904,168,430,232,474,166,240,92,323,415,279,121,46,141,135,1134,SG
1996,29,76,2060,288,660,34,120,254,540,132,163,48,198,246,197,75,59,143,230,742,SG
1996,29,49,1564,232,527,29,95,203,432,113,132,35,151,186,149,58,51,119,171,606,SG
1996,29,27,496,56,133,5,25,51,108,19,31,13,47,60,48,17,8,24,59,136,SG
1996,28,69,2096,324,781,90,271,234,510,229,297,29,145,174,476,116,11,160,137,967,PG
1996,28,82,2262,340,727,98,207,242,520,234,279,22,162,184,401,68,6,128,147,1012,PG
1996,27,13,41,16,32,6,12,10,20,4,4,0,2,2,5,6,0,6,4,42,PG
1996,29,69,1725,215,436,29,86,186,350,123,161,65,153,218,163,47,15,96,178,582,SG
1996,28,75,1897,157,391,99,237,58,154,45,57,113,211,324,121,48,61,82,271,458,SF
1996,27,77,2294,362,738,1,4,361,734,251,317,137,167,304,137,106,31,138,188,976,SF
1996,26,71,1586,179,466,0,0,179,466,57,77,108,247,355,69,30,42,107,202,415,PF
1996,24,82,3319,699,1429,10,48,689,1381,321,479,263,545,808,212,68,91,216,272,1729,PF
1996,27,9,123,9,23,0,4,9,19,4,6,2,20,22,15,4,1,5,17,22,SG
1996,32,71,2632,580,1160,49,175,531,985,440,566,243,578,821,262,114,56,218,208,1649,PF
1996,28,80,2328,379,806,150,368,229,438,130,147,21,171,192,306,58,3,120,116,1038,PG
1996,24,79,1898,283,597,123,296,160,301,111,137,38,130,168,230,95,22,120,196,800,SG
1996,26,68,712,91,185,44,93,47,92,31,37,17,46,63,85,33,11,42,51,257,SG
1996,24,5,33,2,8,0,0,2,8,1,2,3,4,7,5,1,0,4,8,5,PG
1996,31,83,1896,294,590,0,3,294,587,140,194,141,398,539,64,45,85,144,224,728,C
1996,31,13,404,71,161,0,0,71,161,39,56,31,72,103,16,10,15,34,40,181,C
1996,31,70,1492,223,429,0,3,223,426,101,138,110,326,436,48,35,70,110,184,547,C
1996,25,8,66,4,17,0,0,4,17,3,4,1,4,5,8,1,1,7,6,11,PG
1996,22,19,230,29,64,0,1,29,63,27,42,21,28,49,6,11,11,11,46,85,SF
1996,27,81,1961,255,581,64,192,191,389,87,112,90,293,383,82,43,49,71,166,661,SF
1996,23,59,571,69,163,8,25,61,138,75,90,11,33,44,97,20,3,63,80,221,PG
1996,28,81,2893,455,1123,231,623,224,500,127,170,110,222,332,478,212,17,188,151,1268,PG
1996,27,57,715,79,167,0,2,79,165,25,44,69,101,170,42,25,35,47,109,183,PF
1996,31,6,77,6,16,0,1,6,15,2,2,6,1,7,19,2,0,6,4,14,PG
1996,27,4,43,5,15,0,0,5,15,3,7,6,13,19,4,3,0,3,11,13,PF
1996,23,11,131,16,50,3,19,13,31,9,11,1,8,9,21,5,1,12,18,44,PG
1996,32,74,1078,128,272,12,31,116,241,40,46,40,83,123,105,34,10,55,112,308,SG
1996,22,8,41,9,23,4,8,5,15,2,4,5,5,10,3,3,1,6,2,24,SG
1996,23,79,2329,387,873,1,4,386,869,169,246,221,417,638,63,49,288,179,286,944,C
1996,23,12,334,43,97,0,0,43,97,19,25,34,72,106,8,8,38,31,42,105,C
1996,23,67,1995,344,776,1,4,343,772,150,221,187,345,532,55,41,250,148,244,839,C
1996,25,53,369,54,120,0,0,54,120,23,41,38,41,79,8,17,8,26,71,131,PF
1996,25,75,2570,510,1096,91,235,419,861,338,381,47,201,248,487,132,33,142,146,1449,PG
1996,25,54,570,59,161,15,46,44,115,28,45,22,38,60,24,11,8,30,42,161,SF
1996,36,63,986,123,252,32,79,91,173,61,86,26,125,151,58,26,8,78,185,339,C
1996,30,69,716,134,293,25,62,109,231,59,69,11,30,41,100,42,3,43,53,352,PG
1996,27,82,2019,300,555,1,8,299,547,104,150,134,307,441,89,47,38,94,163,705,PF
1996,27,65,1591,246,616,68,220,178,396,135,158,36,100,136,146,80,12,74,119,695,PG
1996,32,9,162,9,16,0,0,9,16,8,17,14,23,37,3,3,2,6,24,26,C
1996,26,81,2942,354,798,3,15,351,783,204,265,215,345,560,165,79,100,133,249,915,C
1996,27,68,671,78,192,1,11,77,181,28,46,17,49,66,73,57,12,31,88,185,PG
1996,30,71,1587,242,446,0,2,242,444,127,177,131,220,351,52,31,19,85,234,611,PF
1996,27,74,740,112,242,40,90,72,152,14,22,45,66,111,56,34,7,39,70,278,SF
1996,28,46,460,66,162,26,72,40,90,16,20,18,42,60,18,17,11,24,50,174,PF
1996,25,20,693,92,206,37,98,55,108,42,56,26,72,98,47,27,13,43,76,263,SF
1996,23,61,495,64,170,0,0,64,170,61,93,45,64,109,15,15,10,40,74,189,PF
1996,25,61,858,88,229,13,60,75,169,48,83,29,89,118,67,41,12,67,104,237,SG
1996,22,57,545,71,162,0,1,71,161,40,68,51,60,111,24,12,7,48,91,182,PF
1996,34,82,2631,220,396,0,1,220,395,50,92,288,441,729,53,87,79,54,215,490,C
1996,29,51,327,46,83,0,0,46,83,18,36,42,68,110,6,9,5,35,73,110,PF
1996,27,82,2699,447,888,0,5,447,883,249,349,162,461,623,181,88,212,137,300,1143,PF
1996,34,80,1532,233,510,0,3,233,507,114,144,71,129,200,74,28,65,78,254,580,SF
1996,21,60,590,90,217,11,42,79,175,49,60,27,75,102,43,10,5,40,77,240,SG
1996,26,61,1682,289,658,73,210,216,448,235,285,51,137,188,278,53,4,157,166,886,PG
1996,27,73,1044,90,216,0,1,90,215,70,96,86,162,248,20,27,78,53,173,250,C
1996,26,78,2628,638,1203,51,184,587,1019,329,409,215,321,536,119,94,22,167,144,1656,SF
1996,28,56,1865,289,679,125,337,164,342,83,113,22,123,145,166,45,10,79,117,786,SG
1996,24,70,2324,426,905,52,154,374,751,151,214,67,172,239,154,67,18,129,205,1055,SF
1996,27,74,651,73,179,37,98,36,81,17,26,51,105,156,26,19,14,22,65,200,PF
1996,23,28,250,25,79,13,47,12,32,22,27,1,18,19,32,8,1,28,22,85,PG
1996,28,78,2408,324,778,95,259,229,519,259,304,51,194,245,548,111,8,230,246,1002,PG
1996,25,55,1036,150,337,46,106,104,231,69,93,34,120,154,117,70,19,95,141,415,SF
1996,25,23,218,35,73,10,19,25,54,13,22,8,26,34,25,12,3,19,41,93,SF
1996,25,32,818,115,264,36,87,79,177,56,71,26,94,120,92,58,16,76,100,322,SF
1996,23,4,20,3,8,0,0,3,8,0,0,0,3,3,1,0,0,2,1,6,SG
1996,25,3,7,1,2,0,0,1,2,0,2,2,0,2,0,0,1,1,4,2,C
1996,24,5,11,4,5,0,0,4,5,0,0,2,0,2,1,0,1,0,1,8,C
1996,28,11,294,48,118,7,21,41,97,20,32,13,59,72,31,4,10,28,30,123,PF
1996,27,81,2615,318,777,88,254,230,523,168,211,49,211,260,422,94,17,171,253,892,PG
1996,27,52,1882,231,559,63,172,168,387,139,173,38,163,201,296,63,12,123,175,664,PG
1996,27,29,733,87,218,25,82,62,136,29,38,11,48,59,126,31,5,48,78,228,PG
1996,28,74,958,153,327,5,30,148,297,84,110,58,119,177,68,20,11,79,126,395,C
1996,28,11,60,7,16,0,2,7,14,1,4,5,7,12,2,0,1,1,8,15,PF
1996,33,71,1284,155,351,3,18,152,333,100,120,81,163,244,84,63,20,67,147,413,SF
1996,33,49,930,117,259,1,12,116,247,77,92,55,124,179,61,47,17,50,96,312,SF
1996,33,22,354,38,92,2,6,36,86,23,28,26,39,65,23,16,3,17,51,101,SF
1996,26,23,200,15,35,0,0,15,35,8,18,24,25,49,9,5,6,17,35,38,PF
1996,26,58,617,51,114,8,27,43,87,62,72,20,34,54,102,22,6,51,60,172,PG
1996,34,81,1777,270,584,1,7,269,577,104,160,162,283,445,89,56,30,69,263,645,PF
1996,31,82,2371,441,974,164,406,277,568,146,171,68,196,264,176,108,25,130,173,1192,SG
1996,27,5,34,3,10,0,3,3,7,4,4,2,3,5,1,1,0,1,3,10,SF
1996,27,41,749,70,151,20,50,50,101,41,58,25,55,80,26,23,2,23,89,201,SG
1996,25,14,48,5,16,0,1,5,15,0,4,4,7,11,3,2,1,3,11,10,C
1996,25,19,542,83,184,34,78,49,106,55,72,12,34,46,47,15,3,37,49,255,SG
1996,23,58,626,63,144,0,0,63,144,38,62,56,125,181,0,8,40,72,117,164,C
1996,27,82,2092,236,482,1,2,235,480,246,345,188,313,501,43,33,66,87,248,719,PF
1996,26,78,2617,334,599,0,0,334,599,135,289,252,457,709,76,56,112,119,238,803,PF
1996,25,74,1773,275,566,127,267,148,299,112,129,35,88,123,103,31,8,63,120,789,SG
1996,22,57,571,55,149,4,13,51,136,74,116,56,69,125,47,40,22,68,92,188,SF
1996,28,28,501,55,108,0,0,55,108,27,47,43,74,117,21,10,4,25,66,137,PF
1996,26,79,1807,299,817,100,302,199,515,224,287,70,154,224,107,81,51,109,225,922,SG
1996,26,8,171,22,71,5,25,17,46,24,26,8,14,22,5,4,3,11,27,73,SG
1996,26,71,1636,277,746,95,277,182,469,200,261,62,140,202,102,77,48,98,198,849,SG
1996,22,22,203,24,50,0,1,24,49,11,19,18,21,39,9,7,5,4,30,59,C
1996,24,82,2018,315,686,139,316,176,370,247,327,41,102,143,350,54,16,191,239,1016,PG
1996,29,82,2766,478,962,57,150,421,812,178,214,36,236,272,315,85,6,100,166,1191,SG
1996,26,65,2157,416,766,1,6,415,760,196,267,149,343,492,122,70,55,190,226,1029,C
1996,25,16,87,19,33,1,2,18,31,14,17,2,7,9,8,3,1,12,10,53,SG
1996,27,79,2470,414,807,3,18,411,789,189,295,198,481,679,261,76,131,199,274,1020,C
1996,29,79,2335,345,685,40,110,305,575,160,219,55,125,180,436,63,5,194,163,890,PG
1996,29,10,234,36,84,1,7,35,77,25,40,6,17,23,39,2,0,29,16,98,PG
1996,29,69,2101,309,601,39,103,270,498,135,179,49,108,157,397,61,5,165,147,792,PG
1996,33,52,1997,331,764,78,235,253,529,265,338,97,276,373,302,105,24,134,153,1005,SG
1996,31,8,58,3,14,0,0,3,14,3,6,2,5,7,2,2,0,2,19,9,C
1996,30,80,1924,162,358,0,1,162,357,80,157,239,481,720,37,41,100,79,251,404,C
1996,32,67,2193,255,598,121,298,134,300,162,197,28,110,138,265,43,3,97,106,793,PG
1996,26,39,739,95,203,2,9,93,194,49,70,42,57,99,44,42,6,49,79,241,PF
1996,23,67,1284,274,655,74,207,200,448,154,257,58,57,115,99,42,13,77,128,776,SG
1996,29,55,1238,161,377,54,128,107,249,98,118,44,104,148,86,28,3,57,84,474,SG
1996,25,42,655,117,276,0,3,117,273,82,114,51,78,129,27,18,37,49,73,316,C
1996,22,80,2481,305,740,53,144,252,596,197,252,63,138,201,491,89,3,192,203,860,PG
1996,30,82,2773,401,956,84,245,317,711,157,208,98,248,346,212,118,46,170,243,1043,SF
1996,25,31,519,32,91,0,4,32,87,29,38,35,52,87,39,10,18,29,51,93,PF
1996,40,28,274,41,110,0,0,41,110,16,26,15,25,40,11,1,8,21,61,98,C
1996,30,34,1007,142,390,42,104,100,286,68,84,14,61,75,71,54,7,68,67,394,SG
1996,34,79,1758,253,591,82,221,171,370,81,103,65,191,256,138,85,9,104,138,669,SG
1996,23,65,961,104,242,14,62,90,180,65,77,22,56,78,146,29,3,77,130,287,PG
1996,32,45,1385,180,357,41,127,139,230,98,115,47,108,155,138,45,11,59,93,499,SF
1996,27,77,2901,525,1127,161,392,364,735,326,423,69,327,396,211,69,33,198,178,1537,SF
1996,35,81,2626,459,959,150,364,309,595,136,179,88,227,315,139,57,7,98,191,1204,SF
1996,25,45,1269,189,432,4,22,185,410,89,148,93,229,322,74,36,33,83,163,471,SF
1996,26,12,74,5,22,0,0,5,22,3,6,5,3,8,4,2,3,3,11,13,C
1996,28,69,1431,145,295,0,0,145,295,75,117,151,300,451,62,39,99,84,207,365,C
1996,27,30,282,36,100,13,56,23,44,31,39,4,12,16,23,7,0,39,27,116,PG
1996,33,76,2783,678,1456,4,28,674,1428,351,461,157,649,806,160,68,184,221,247,1711,C
1996,30,54,591,80,166,0,8,80,158,42,57,32,61,93,30,23,3,34,83,202,SF
1996,29,82,2680,422,919,143,363,279,556,103,134,71,238,309,191,57,37,122,233,1090,PF
1996,22,82,3212,465,976,61,186,404,790,242,323,139,235,374,289,85,31,133,199,1233,SF
1996,26,18,134,21,36,0,0,21,36,10,19,10,11,21,8,3,7,3,19,52,C
1996,26,2,17,6,10,0,0,6,10,0,1,3,0,3,1,0,1,0,3,12,C
1996,26,16,117,15,26,0,0,15,26,10,18,7,11,18,7,3,6,3,16,40,C
1996,33,77,1747,227,524,3,28,224,496,133,177,49,121,170,255,41,5,122,115,590,PG
1996,23,28,139,30,80,4,25,26,55,26,34,12,12,24,5,8,1,6,27,90,SF
1996,27,73,803,107,244,1,8,106,236,61,72,53,125,178,25,7,22,58,120,276,C
1996,26,81,2588,421,928,99,272,322,656,196,254,158,292,450,369,113,41,216,290,1137,SF
1996,30,65,1325,152,379,44,114,108,265,38,48,21,92,113,100,35,8,43,147,386,SF
1996,30,44,1033,117,297,38,91,79,206,33,38,14,72,86,82,31,5,32,119,305,SF
1996,30,21,292,35,82,6,23,29,59,5,10,7,20,27,18,4,3,11,28,81,SF
1996,19,80,2293,361,735,8,28,353,707,105,149,175,326,501,145,86,131,110,189,835,SF
1996,28,71,1427,326,567,0,1,326,566,139,207,129,288,417,43,36,40,95,217,791,PF
1996,28,47,862,171,308,0,1,171,307,84,132,78,164,242,26,19,29,60,135,426,PF
1996,28,24,565,155,259,0,0,155,259,55,75,51,124,175,17,17,11,35,82,365,PF
1996,31,25,570,91,190,0,0,91,190,47,78,35,79,114,14,10,11,40,75,229,PF
1996,26,77,2349,357,666,3,8,354,658,149,205,201,448,649,60,46,63,137,290,866,C
1996,27,47,1683,246,524,26,79,220,445,138,176,72,160,232,260,64,24,131,131,656,SG
1996,27,36,1265,179,372,17,54,162,318,89,117,56,133,189,225,42,22,110,101,464,SG
1996,27,11,418,67,152,9,25,58,127,49,59,16,27,43,35,22,2,21,30,192,SG
1996,31,78,2856,576,1216,0,1,576,1215,277,350,241,472,713,140,73,53,177,180,1429,SF
1996,28,15,71,12,33,1,6,11,27,1,1,6,2,8,4,3,1,0,10,26,SF
1996,28,10,56,10,28,1,5,9,23,0,0,5,1,6,4,2,1,0,5,21,SF
1996,28,5,15,2,5,0,1,2,4,1,1,1,1,2,0,1,0,0,5,5,SF
1996,24,42,621,76,189,33,83,43,106,46,60,8,35,43,112,16,0,63,79,231,PG
1996,25,53,613,78,193,32,82,46,111,52,68,17,40,57,52,25,1,46,64,240,SG
1996,25,8,128,17,32,7,14,10,18,15,17,5,10,15,11,5,0,17,16,56,SG
1996,25,45,485,61,161,25,68,36,93,37,51,12,30,42,41,20,1,29,48,184,SG
1996,31,28,311,22,58,4,14,18,44,17,25,20,35,55,13,12,2,12,31,65,PF
1996,31,18,235,13,39,4,13,9,26,13,19,14,22,36,10,8,1,11,27,43,PF
1996,31,4,19,2,4,0,1,2,3,0,0,1,5,6,1,0,0,0,0,4,PF
1996,31,6,57,7,15,0,0,7,15,4,6,5,8,13,2,4,1,1,4,18,PF
1996,23,78,2398,427,842,4,17,423,825,262,358,175,370,545,127,40,103,185,269,1120,PF
1996,30,47,596,88,181,8,24,80,157,48,58,12,40,52,69,39,3,45,91,232,PG
1996,29,31,527,35,99,8,34,27,65,5,6,7,27,34,97,22,2,30,43,83,PG
1996,29,11,280,18,48,4,18,14,30,5,6,3,18,21,60,12,2,15,28,45,PG
1996,29,10,138,11,28,2,10,9,18,0,0,1,5,6,23,8,0,10,8,24,PG
1996,29,10,109,6,23,2,6,4,17,0,0,3,4,7,14,2,0,5,7,14,PG
1996,30,76,2394,314,679,21,67,293,612,60,110,117,244,361,111,60,43,82,173,709,PF
1996,30,63,2286,347,677,1,6,346,671,152,207,178,402,580,170,62,74,64,144,847,PF
1996,32,82,2113,215,444,14,52,201,392,168,237,166,388,554,72,45,23,79,141,612,SF
1996,26,78,2835,473,1004,26,86,447,918,289,374,176,514,690,238,139,96,234,265,1261,PF
1996,32,1,7,2,6,0,0,2,6,1,2,1,1,2,0,0,0,1,2,5,C
1996,20,11,70,9,31,0,0,9,31,7,18,10,12,22,1,0,9,9,12,25,C
1996,26,6,17,2,4,0,0,2,4,4,7,2,2,4,0,0,0,2,2,8,C
1996,26,3,7,1,2,0,0,1,2,2,4,2,1,3,0,0,0,2,1,4,C
1996,26,3,10,1,2,0,0,1,2,2,3,0,1,1,0,0,0,0,1,4,C
1996,28,71,1045,127,268,0,0,127,268,88,115,85,138,223,23,23,13,48,137,342,PF
1996,24,63,838,112,214,1,3,111,211,47,73,40,58,98,47,28,5,56,94,272,SF
1996,24,82,3015,623,1215,89,283,534,932,445,580,129,225,354,582,166,41,229,160,1780,PG
1996,29,80,2534,419,992,138,379,281,613,241,305,35,194,229,640,132,17,235,201,1217,PG
1996,29,52,1487,255,606,85,232,170,374,140,182,22,109,131,360,74,11,125,131,735,PG
1996,29,28,1047,164,386,53,147,111,239,101,123,13,85,98,280,58,6,110,70,482,PG
1996,34,82,2893,436,939,121,325,315,614,156,206,32,170,202,352,131,5,178,201,1149,PG
1996,32,80,1886,234,501,28,104,206,397,98,139,74,139,213,208,105,32,73,137,594,PG
1996,25,61,1016,183,397,47,125,136,272,68,87,41,81,122,79,35,3,46,56,481,SG
1996,25,55,821,83,224,0,2,83,222,38,83,69,131,200,15,27,47,44,76,204,PF
1996,25,18,410,39,95,0,2,39,93,20,43,27,67,94,9,14,21,18,38,98,PF
1996,25,37,411,44,129,0,0,44,129,18,40,42,64,106,6,13,26,26,38,106,PF
1996,29,82,2823,443,936,146,380,297,556,249,285,86,211,297,218,149,14,164,172,1281,SG
1996,28,4,14,3,5,0,0,3,5,2,3,1,1,2,0,0,0,0,0,8,SF
1996,23,79,1416,192,434,0,3,192,431,119,200,164,192,356,51,44,43,87,217,503,PF
1996,29,44,393,40,97,0,1,40,96,5,17,30,51,81,16,9,8,29,61,85,PF
1996,27,44,916,134,323,48,129,86,194,35,37,20,72,92,55,24,11,49,90,351,SF
1996,23,80,3260,564,1221,5,26,559,1195,485,646,127,656,783,548,100,48,263,242,1618,SF
1996,27,44,929,130,254,0,0,130,254,81,135,94,150,244,33,31,20,64,144,341,PF
1996,26,15,115,9,24,0,0,9,24,0,0,9,14,23,4,1,8,2,26,18,C
1996,26,13,113,9,24,0,0,9,24,0,0,9,13,22,4,1,8,2,26,18,C
1996,23,15,85,8,19,1,3,7,16,15,18,4,5,9,8,6,1,7,12,32,SG
1996,32,82,2588,442,880,104,223,338,657,259,290,62,147,209,340,106,20,127,171,1247,SG
1996,25,71,2634,300,732,142,388,158,344,111,143,97,315,412,281,116,109,160,197,853,SF
1996,24,82,3072,564,1244,191,447,373,797,298,362,54,246,300,250,61,16,233,233,1617,SG
1996,26,25,276,32,64,1,3,31,61,21,26,31,53,84,7,13,7,17,59,86,PF
1996,22,81,3294,733,1500,4,13,729,1487,319,426,188,472,660,360,67,39,303,269,1789,PF
1996,25,80,2138,239,628,117,289,122,339,84,120,44,150,194,188,84,18,80,185,679,PG
1996,24,72,1059,65,230,22,76,43,154,68,85,12,63,75,216,28,3,86,121,220,PG
1996,28,4,33,0,8,0,5,0,3,8,10,0,3,3,0,1,0,0,5,8,SG
1996,25,82,2820,569,1308,121,333,448,975,345,418,173,237,410,235,47,22,191,165,1604,SG
1996,30,81,2643,296,626,64,149,232,477,150,191,66,241,307,635,100,5,201,153,806,PG
1996,30,7,58,10,24,5,15,5,9,5,5,3,3,6,2,0,0,4,13,30,PF
1996,30,82,3084,438,887,6,31,432,856,189,262,37,169,206,789,119,21,195,179,1071,PG
1996,30,11,28,5,12,0,1,5,11,2,2,2,0,2,1,0,0,1,3,12,PG
1996,36,62,1002,180,436,45,128,135,308,70,79,45,108,153,69,20,4,56,104,475,SF
1996,28,81,1519,180,352,1,3,179,349,85,127,129,304,433,48,40,129,98,245,446,C
1996,29,56,2007,342,674,21,57,321,617,342,398,42,179,221,517,82,13,170,144,1047,PG
1996,26,81,3274,583,1225,67,183,516,1042,427,564,249,434,683,355,55,43,182,173,1660,PF
1996,36,32,958,137,294,22,58,115,236,172,201,40,143,183,220,26,13,103,48,468,PF
1996,38,46,297,6,19,0,0,6,19,4,13,28,46,74,12,5,24,3,44,16,PF
1996,24,70,2184,337,685,83,227,254,458,136,184,45,188,233,246,129,45,99,162,893,SG
1996,25,68,2322,327,733,14,39,313,694,102,133,260,477,737,132,54,27,109,262,770,PF
1996,32,82,3090,916,1850,111,260,805,1590,548,657,148,395,543,352,180,42,197,195,2491,SG
1996,28,24,247,36,71,0,0,36,71,22,38,23,29,52,29,12,7,19,30,94,PG
1996,25,82,1708,180,346,0,4,180,342,139,201,176,279,455,64,51,41,88,174,499,PF
1996,26,79,2631,526,937,5,12,521,925,493,664,276,628,904,173,93,127,315,299,1550,PF
1996,30,82,1919,244,482,122,237,122,245,78,84,25,85,110,192,63,2,42,109,688,PG
1996,33,76,1620,205,500,3,17,202,483,97,147,154,209,363,114,91,45,75,205,510,SF
1996,29,69,816,87,208,22,71,65,137,36,43,41,84,125,65,32,14,33,139,232,SF
1996,22,81,3034,493,1293,133,396,360,897,229,331,203,350,553,783,175,26,328,155,1348,PG
1996,26,80,1930,250,585,44,113,206,472,90,136,102,183,285,104,68,33,103,163,634,SF
1996,23,6,20,3,11,0,1,3,10,1,3,1,1,2,2,2,0,2,4,7,PG
1996,22,62,868,110,255,5,34,105,221,54,77,43,67,110,88,21,13,60,76,279,SG
1996,29,15,156,17,36,0,0,17,36,4,8,9,14,23,2,7,2,18,39,38,PF
1996,34,56,663,71,169,2,7,69,162,20,25,36,96,132,44,13,6,37,113,164,C
1996,32,67,1288,84,175,3,9,81,166,32,57,63,209,272,51,27,44,41,226,203,C
1996,27,81,2103,386,787,87,216,299,571,206,267,115,208,323,287,64,28,114,150,1065,SF
1996,26,74,2495,442,907,9,39,433,868,324,396,184,354,538,197,71,71,187,276,1217,C
1996,26,44,1518,283,582,9,31,274,551,217,266,98,204,302,129,40,43,112,157,792,C
1996,26,30,977,159,325,0,8,159,317,107,130,86,150,236,68,31,28,75,119,425,C
1996,29,71,2365,353,790,1,5,352,785,125,156,153,302,455,65,42,126,124,241,832,C
1996,29,51,1815,281,619,0,3,281,616,95,118,111,223,334,62,35,85,94,178,657,C
1996,29,20,550,72,171,1,2,71,169,30,38,42,79,121,3,7,41,30,63,175,C
1996,23,41,367,41,77,0,2,41,75,34,47,17,36,53,12,14,12,24,61,116,SF
1996,29,18,155,18,29,0,0,18,29,8,13,8,26,34,1,2,4,11,30,44,C
1996,29,77,1775,233,460,128,245,105,215,132,153,29,111,140,136,45,12,45,141,726,SG
1996,22,30,323,53,141,36,101,17,40,34,43,12,40,52,31,6,1,23,31,176,SG
1996,26,3,4,2,3,0,0,2,3,0,0,2,0,2,0,1,0,0,0,4,C
1996,20,16,189,29,60,2,7,27,53,15,25,15,14,29,3,8,3,14,21,75,SF
1996,37,64,735,51,105,0,0,51,105,41,64,67,213,280,19,6,42,48,136,143,C
1996,37,7,88,4,9,0,0,4,9,2,2,7,22,29,4,0,3,4,15,10,C
1996,37,57,647,47,96,0,0,47,96,39,62,60,191,251,15,6,39,44,121,133,C
1996,31,55,598,71,175,51,122,20,53,4,5,7,57,64,44,10,17,20,70,197,PF
1996,31,32,273,39,96,27,65,12,31,2,3,5,28,33,17,2,7,9,34,107,PF
1996,31,23,325,32,79,24,57,8,22,2,2,2,29,31,27,8,10,11,36,90,PF
1996,29,82,3008,395,838,31,86,364,752,257,337,248,540,788,183,108,34,157,233,1078,PF
1996,27,62,1641,242,502,0,0,242,502,80,103,104,214,318,119,22,84,114,223,564,C
1996,25,76,1012,117,272,4,13,113,259,53,80,82,127,209,51,47,10,40,106,291,SF
1996,25,31,868,121,287,54,135,67,152,39,46,18,80,98,79,22,9,28,75,335,SF
1996,26,56,1107,233,547,14,49,219,498,145,198,62,143,205,89,21,5,68,105,625,SF
1996,26,23,287,29,67,7,15,22,52,9,11,10,12,22,16,15,0,9,34,74,PG
1996,37,50,450,43,122,0,1,43,121,34,47,31,79,110,16,14,13,30,72,120,C
1996,30,82,2367,303,748,146,414,157,334,120,169,70,235,305,214,81,34,93,131,872,SF
1996,34,32,510,76,193,5,16,71,177,29,32,8,32,40,26,16,0,22,25,186,SG
1996,34,25,407,63,160,5,16,58,144,24,26,8,24,32,19,13,0,19,19,155,SG
1996,34,7,103,13,33,0,0,13,33,5,6,0,8,8,7,3,0,3,6,31,SG
1996,32,82,3113,789,1520,16,40,773,1480,512,708,175,629,804,345,138,56,199,245,2106,PF
1996,29,33,816,178,388,3,14,175,374,82,109,30,113,143,65,38,24,77,121,441,PF
1996,25,29,311,49,113,0,1,49,112,9,14,16,39,55,7,3,6,17,37,107,PF
1996,31,53,1039,176,389,64,157,112,232,155,200,20,57,77,118,52,4,96,112,571,SG
1996,23,34,208,24,68,7,30,17,38,22,35,9,17,26,7,8,2,7,26,77,SF
1996,22,62,934,125,314,28,94,97,220,64,83,65,148,213,49,22,31,48,83,342,SF
1996,24,4,19,3,5,3,3,0,2,0,2,1,1,2,2,1,0,1,1,9,SG
1996,24,59,1149,147,362,20,69,127,293,101,120,16,66,82,217,53,3,107,123,415,PG
1996,24,24,402,59,131,5,22,54,109,38,46,13,25,38,61,27,1,37,47,161,PG
1996,24,35,747,88,231,15,47,73,184,63,74,3,41,44,156,26,2,70,76,254,PG
1996,23,18,669,145,383,35,102,110,281,97,133,37,60,97,50,14,3,55,39,422,SF
1996,29,82,3457,449,798,0,0,449,798,298,414,220,544,764,363,69,34,211,246,1196,SF
1996,28,54,1463,214,432,0,3,214,429,111,157,127,225,352,30,28,20,73,140,539,PF
1996,28,24,659,100,196,0,0,100,196,43,65,52,114,166,18,13,9,35,67,243,PF
1996,28,30,804,114,236,0,3,114,233,68,92,75,111,186,12,15,11,38,73,296,PF
1996,30,75,2467,410,1052,146,460,264,592,251,332,39,190,229,330,96,12,215,182,1217,PG
1996,25,82,1705,153,364,75,189,78,175,41,68,21,69,90,302,64,10,89,144,422,PG
1996,31,62,653,76,153,1,2,75,151,35,74,46,97,143,24,21,15,42,116,188,PF
1996,28,79,2846,530,1281,257,678,273,603,180,224,116,263,379,212,113,38,166,212,1497,SF
1996,23,12,71,8,23,2,6,6,17,12,16,3,7,10,7,5,0,2,10,30,SG
1996,21,76,2280,427,881,0,4,427,877,166,243,229,343,572,75,54,114,154,250,1020,PF
1996,23,80,1195,62,145,0,0,62,145,58,105,66,164,230,11,21,166,36,171,182,C
1996,29,75,2440,346,712,17,68,329,644,170,221,123,238,361,262,83,44,143,246,879,SF
1996,23,81,2259,337,722,38,117,299,605,152,199,86,218,304,205,92,21,135,205,864,SG
1996,31,55,1261,100,238,46,121,54,117,29,41,41,169,210,197,95,18,75,143,275,PG
1996,23,72,1266,145,330,3,11,142,319,70,102,114,205,319,57,20,32,67,224,363,C
1996,24,27,123,15,35,0,2,15,33,6,10,11,14,25,4,4,1,8,19,36,PF
1996,25,76,2516,418,795,0,11,418,784,146,221,177,385,562,219,108,143,202,277,982,PF
1996,30,76,2621,504,1066,168,410,336,656,430,498,38,176,214,253,77,13,189,175,1606,SG
1996,26,80,3060,454,971,79,210,375,761,218,263,112,331,443,188,73,52,121,241,1205,SF
1996,28,82,1656,283,675,82,207,201,468,121,157,108,244,352,98,42,20,98,197,769,PF
1996,24,19,136,23,52,2,10,21,42,13,13,4,8,12,8,0,0,14,23,61,SG
1996,24,78,1761,320,640,7,27,313,613,99,130,93,164,257,146,36,11,78,161,746,SG
1996,32,78,2145,303,618,1,18,302,600,237,291,107,232,339,74,49,26,87,220,844,SF
1996,25,39,676,74,138,1,2,73,136,39,87,54,86,140,22,14,24,50,87,188,C
1996,25,5,65,2,7,0,0,2,7,2,4,3,9,12,0,1,1,1,5,6,C
1996,25,34,611,72,131,1,2,71,129,37,83,51,77,128,22,13,23,49,82,182,C
1996,24,61,1432,196,346,0,0,196,346,50,133,119,233,352,43,19,29,83,181,442,C
1996,30,8,190,30,76,13,30,17,46,18,19,10,12,22,6,2,0,8,16,91,SG
1996,30,66,1424,265,606,63,197,202,409,98,127,100,129,229,77,63,20,71,140,691,SG
1996,23,44,573,112,247,18,55,94,192,49,75,36,25,61,50,29,8,44,54,291,SG
1996,25,70,2671,563,1076,9,30,554,1046,488,712,218,509,727,159,70,189,262,245,1623,C
1996,32,55,1617,269,539,59,150,210,389,137,160,44,115,159,194,75,32,122,127,734,SF
1996,25,33,151,16,41,0,0,16,41,5,8,11,17,28,3,2,5,3,29,37,C
1996,25,24,118,13,32,0,0,13,32,5,8,10,15,25,2,1,4,3,23,31,C
1996,25,9,33,3,9,0,0,3,9,0,0,1,2,3,1,1,1,0,6,6,C
1996,27,73,1673,244,587,45,145,199,442,114,143,26,143,169,327,135,9,132,140,647,PG
1996,27,9,193,24,66,6,23,18,43,8,12,5,9,14,35,6,0,12,16,62,PG
1996,27,64,1480,220,521,39,122,181,399,106,131,21,134,155,292,129,9,120,124,585,PG
1996,24,76,2242,466,798,0,1,466,797,172,278,248,480,728,56,52,172,143,297,1104,C
1996,22,77,1816,257,575,37,116,220,459,99,132,89,157,246,84,61,25,108,151,650,SF
1996,24,82,2458,496,1092,151,358,345,734,182,219,114,238,352,131,87,40,132,208,1325,SF
1996,29,74,2713,284,569,0,1,284,568,246,354,249,622,871,108,38,332,150,258,814,C
1996,32,71,1092,91,247,14,58,77,189,80,122,35,105,140,145,34,17,81,132,276,SG
1996,32,39,639,62,160,11,42,51,118,49,76,21,52,73,97,14,11,56,75,184,SG
1996,32,32,453,29,87,3,16,26,71,31,46,14,53,67,48,20,6,25,57,92,SG
1996,24,5,15,5,9,0,1,5,8,3,4,0,0,0,2,3,0,8,2,13,PG
1996,32,82,2690,321,649,61,162,260,487,186,232,66,134,200,154,90,15,108,257,889,SG
1996,31,34,770,127,273,33,84,94,189,17,48,40,92,132,63,15,16,46,68,304,SF
1996,23,64,1253,156,400,10,56,146,344,77,108,65,103,168,63,44,11,62,95,399,SG
1996,23,54,1946,592,1033,1,2,591,1031,249,511,182,414,596,155,34,115,155,193,1434,C
1996,27,5,139,13,35,0,1,13,34,7,8,13,19,32,2,2,4,5,13,33,C
1996,32,53,1775,211,448,7,26,204,422,175,210,162,298,460,137,58,14,104,195,604,PF
1996,33,72,2797,768,1494,3,14,765,1480,397,548,176,608,784,257,113,207,247,242,1936,C
1996,22,57,661,86,182,0,0,86,182,36,54,57,118,175,5,5,63,25,91,208,C
1996,24,80,985,107,186,0,3,107,183,72,162,87,113,200,50,44,91,45,127,286,PF
1996,26,55,607,67,178,8,26,59,152,40,55,8,55,63,106,13,5,40,49,182,PG
1996,26,62,1982,323,673,5,18,318,655,157,247,143,268,411,204,49,38,164,192,808,SF
1996,26,40,1388,239,473,0,6,239,467,112,177,94,192,286,134,30,22,113,132,590,SF
1996,26,22,594,84,200,5,12,79,188,45,70,49,76,125,70,19,16,51,60,218,SF
1996,26,31,1084,190,444,26,98,164,346,154,182,29,103,132,242,62,1,114,68,560,PG
1996,42,74,1086,120,241,0,0,120,241,50,71,89,214,303,29,21,54,50,80,290,C
1996,23,64,869,101,247,7,26,94,221,41,62,66,150,216,29,25,32,31,100,250,C
1996,27,81,3162,618,1276,98,299,520,977,229,306,104,235,339,608,231,19,260,221,1563,PG
1996,26,73,1608,272,602,105,254,167,348,61,86,45,92,137,118,59,10,56,139,710,SG
1996,25,7,17,3,5,0,0,3,5,1,3,1,3,4,1,1,2,2,10,7,C
1996,25,5,12,3,5,0,0,3,5,1,3,1,3,4,1,1,2,2,6,7,C
1996,30,80,1396,173,331,0,1,173,330,67,125,175,310,485,33,28,75,86,183,413,C
1996,34,82,2169,325,797,129,363,196,434,191,241,101,266,367,120,83,48,82,174,970,PF
1996,26,81,1668,261,549,24,59,237,490,151,194,34,102,136,353,87,5,146,140,697,PG
1996,30,30,254,31,65,4,8,27,57,5,9,21,27,48,8,4,13,10,16,71,PF
1996,30,8,87,8,18,1,1,7,17,2,3,6,7,13,2,2,3,3,5,19,PF
1996,30,22,167,23,47,3,7,20,40,3,6,15,20,35,6,2,10,7,11,52,PF
1996,31,80,2131,308,705,190,463,118,242,67,104,76,337,413,100,49,26,91,197,873,SF
1996,24,82,2609,390,877,117,313,273,564,148,192,56,265,321,138,55,22,89,148,1045,SG
1996,26,72,2530,386,826,93,211,293,615,186,240,62,199,261,271,102,27,126,192,1051,SG
1996,25,65,784,98,242,38,114,60,128,67,82,40,63,103,48,24,10,45,83,301,SG
1996,36,76,1404,264,590,35,104,229,486,174,205,40,96,136,101,57,6,93,188,737,SG
1996,32,74,1710,171,335,0,3,171,332,136,179,189,269,458,72,64,28,77,156,478,PF
1996,32,47,1031,117,233,0,3,117,230,94,124,115,167,282,50,31,17,54,101,328,PF
1996,32,27,679,54,102,0,0,54,102,42,55,74,102,176,22,33,11,23,55,150,PF
1996,30,77,2825,563,1216,150,401,413,815,220,324,152,344,496,452,133,57,207,198,1496,SF
1996,31,81,2441,431,818,1,3,430,815,122,203,257,507,764,58,52,66,127,250,985,C
1996,32,82,2072,269,608,71,226,198,382,164,209,36,176,212,452,89,15,173,154,773,PG
1996,27,81,2042,252,534,139,301,113,233,167,191,38,190,228,416,78,4,153,184,810,PG
1996,31,7,127,18,60,10,30,8,30,10,10,1,6,7,18,6,0,10,7,56,PG
1996,28,2,22,2,3,1,1,1,2,2,3,0,2,2,7,2,0,0,3,7,PG
1996,28,53,1984,426,852,0,0,426,852,191,275,113,409,522,83,48,81,117,161,1043,PF
1996,22,75,1305,128,230,0,1,128,229,85,120,110,187,297,13,16,116,56,144,341,C
1996,28,63,1275,149,359,81,191,68,168,57,66,31,113,144,170,23,5,61,111,436,SG
1996,22,77,2460,401,877,0,3,401,874,219,299,178,392,570,109,43,55,157,226,1021,C
1996,23,51,833,95,227,28,91,67,136,61,82,18,61,79,118,37,3,63,115,279,PG
1996,23,20,418,54,118,11,36,43,82,43,51,11,29,40,72,16,1,30,46,162,PG
1996,23,31,415,41,109,17,55,24,54,18,31,7,32,39,46,21,2,33,69,117,PG
1996,22,69,997,106,187,0,0,106,187,51,77,78,125,203,11,47,40,41,199,263,PF
1996,27,65,1313,160,324,0,1,160,323,107,142,73,182,255,42,43,17,79,187,427,PF
1996,27,32,643,72,164,0,1,72,163,64,87,35,88,123,14,25,10,49,98,208,PF
1996,27,33,670,88,160,0,0,88,160,43,55,38,94,132,28,18,7,30,89,219,PF
1996,22,36,405,33,100,9,29,24,71,31,46,9,35,44,54,16,2,43,37,106,PG
1996,22,34,397,32,99,9,29,23,70,30,43,9,33,42,54,16,1,41,36,103,PG
1996,22,2,8,1,1,0,0,1,1,1,3,0,2,2,0,0,1,2,1,3,PG
1996,23,62,845,113,292,42,122,71,170,35,42,28,46,74,68,32,4,42,67,303,SG
1996,33,19,191,21,53,1,10,20,43,13,21,13,20,33,12,15,6,16,20,56,SF
1996,28,79,3142,610,1296,171,403,439,893,319,381,86,292,378,232,91,19,163,217,1710,SF
1996,29,63,2013,281,664,94,245,187,419,78,105,35,123,158,340,77,13,95,134,734,PG
1996,30,81,2946,611,1368,225,515,386,853,425,491,54,215,269,255,125,19,220,233,1872,SG
1996,24,75,2594,560,1206,102,275,458,931,248,296,99,210,309,213,48,23,201,204,1470,SG
1996,25,25,310,35,74,0,1,35,73,22,28,32,44,76,5,8,16,17,42,92,C
1996,34,78,1235,108,290,47,137,61,153,48,64,30,108,138,123,73,21,57,175,311,PG
1996,35,33,317,48,97,4,14,44,83,22,28,18,29,47,26,16,4,24,24,122,C
1996,25,51,795,141,304,0,0,141,304,74,133,42,120,162,41,15,39,48,153,356,C
1996,33,77,2478,285,607,41,151,244,456,107,158,110,232,342,323,166,36,183,268,718,SG
1996,29,78,2980,553,1306,178,471,375,835,360,542,123,320,443,190,86,68,194,248,1644,SF
1996,30,82,3019,711,1378,3,9,708,1369,626,823,319,681,1000,247,111,271,190,262,2051,C
1996,23,82,3249,627,1382,90,263,537,1119,316,389,136,368,504,293,95,42,282,236,1660,SF
1996,25,76,1627,229,574,102,284,127,290,89,135,44,113,157,150,34,16,111,146,649,PG
1996,29,43,715,92,221,30,79,62,142,33,51,19,59,78,142,26,5,72,79,247,PG
1996,34,64,2088,146,304,3,27,143,277,56,106,356,596,952,160,36,27,138,196,351,PF
1996,23,49,372,32,90,2,9,30,81,24,32,30,48,78,15,10,8,17,42,90,SF
1996,24,56,1043,178,344,3,21,175,323,71,130,80,90,170,35,25,48,61,87,430,PF
1996,24,67,1950,306,641,49,153,257,488,113,180,113,173,286,167,75,35,144,216,774,SF
1996,26,65,1117,144,285,1,7,143,278,135,202,81,174,255,47,23,42,80,141,424,C
1996,26,49,902,112,227,1,6,111,221,106,159,60,144,204,38,19,28,49,106,331,C
1996,26,16,215,32,58,0,1,32,57,29,43,21,30,51,9,4,14,31,35,93,C
1996,23,80,2134,290,604,32,108,258,496,191,277,46,214,260,495,53,39,234,229,803,SG
1996,29,64,963,106,216,0,2,106,214,125,164,57,96,153,42,29,15,52,97,337,SF
1996,23,59,723,79,135,0,2,79,133,26,55,71,100,171,22,19,30,40,135,184,C
1996,25,61,1551,263,648,104,284,159,364,148,182,21,111,132,269,43,2,149,132,778,PG
1996,27,7,30,3,9,0,0,3,9,2,5,3,3,6,3,0,2,3,10,8,PF
1996,25,59,577,56,142,14,40,42,102,48,67,28,62,90,29,29,8,36,66,174,SF
1996,31,73,1735,394,723,39,104,355,619,231,305,147,441,588,130,64,78,154,211,1058,C
1996,31,42,673,63,140,0,0,63,140,59,85,46,94,140,54,19,27,55,110,185,PF
1996,31,25,482,51,105,0,0,51,105,47,65,26,71,97,39,11,12,39,72,149,PF
1996,31,17,191,12,35,0,0,12,35,12,20,20,23,43,15,8,15,16,38,36,PF
1996,36,32,399,32,94,0,0,32,94,37,46,29,60,89,9,11,16,23,60,101,C
1996,28,35,181,24,45,1,5,23,40,9,19,15,18,33,2,6,2,8,25,58,C
1996,27,33,297,49,110,0,0,49,110,13,21,23,55,78,14,9,12,19,53,111,C
1996,33,63,2200,360,740,73,179,287,561,287,370,73,255,328,276,56,8,146,179,1080,SF
1996,34,80,1894,271,676,74,221,197,455,203,243,40,152,192,123,63,22,100,126,819,SG
1996,27,82,3041,491,1117,267,628,224,489,182,222,63,246,309,243,90,29,122,169,1431,SF
1996,25,62,1601,272,655,21,100,251,555,147,184,76,164,240,116,84,28,113,150,712,SF
1996,30,64,1813,285,568,2,3,283,565,204,282,166,333,499,71,40,69,180,219,776,C
1996,29,75,1679,182,486,41,144,141,342,91,114,58,166,224,336,58,11,173,160,496,PG
1996,27,54,810,86,217,19,51,67,166,55,75,41,104,145,83,31,20,51,85,246,SF
1996,23,60,685,77,160,1,1,76,159,61,97,66,90,156,38,9,8,56,78,216,PF
1996,31,10,236,20,57,15,34,5,23,8,10,1,15,16,38,7,0,16,21,63,PG
1996,25,11,72,14,27,0,0,14,27,3,7,4,11,15,2,2,3,9,11,31,PF
1996,25,4,20,3,5,0,0,3,5,0,0,0,3,3,0,1,2,3,1,6,PF
1996,25,4,26,6,11,0,0,6,11,2,5,3,4,7,2,1,1,3,4,14,PF
1996,25,3,26,5,11,0,0,5,11,1,2,1,4,5,0,0,0,3,6,11,PF
1996,28,8,39,3,10,0,3,3,7,0,2,0,5,5,6,1,0,5,7,6,PG
1996,30,73,1716,244,578,2,15,242,563,119,163,133,229,362,65,50,80,106,224,609,PF
1996,30,41,890,114,294,2,15,112,279,73,103,59,101,160,29,18,51,61,124,303,PF
1996,30,32,826,130,284,0,0,130,284,46,60,74,128,202,36,32,29,45,100,306,PF
1996,26,17,92,14,39,0,0,14,39,5,8,12,10,22,4,3,0,11,21,33,PF
1996,20,82,2821,469,1024,10,28,459,996,303,392,300,417,717,79,85,134,138,224,1251,PF
1996,30,68,1617,201,464,91,238,110,226,87,106,21,75,96,245,47,3,100,116,580,PG
1996,23,65,1384,144,238,1,1,143,237,68,177,143,246,389,110,47,46,72,166,357,PF
1996,26,80,2856,494,1143,140,423,354,720,318,385,124,202,326,224,68,17,151,207,1446,SG
1996,27,59,938,116,274,38,116,78,158,28,46,30,65,95,154,37,10,66,106,298,SG
1996,27,34,528,70,173,25,77,45,96,24,37,24,32,56,86,21,5,40,60,189,SG
1996,27,25,410,46,101,13,39,33,62,4,9,6,33,39,68,16,5,26,46,109,SG
1996,29,63,1901,466,894,1,5,465,889,231,293,119,314,433,110,21,45,160,226,1164,C
1996,22,43,389,42,100,2,10,40,90,29,49,9,34,43,73,28,0,38,53,115,PG
1996,26,17,58,5,13,0,0,5,13,4,6,3,10,13,1,0,2,6,12,14,C
1996,26,6,21,0,1,0,0,0,1,0,0,1,3,4,0,0,0,3,8,0,C
1996,26,11,37,5,12,0,0,5,12,4,6,2,7,9,1,0,2,3,4,14,C
1996,28,71,1267,146,281,0,0,146,281,104,151,100,206,306,11,20,54,77,240,396,C
1996,25,78,3064,515,1202,91,282,424,920,352,446,124,256,380,328,127,45,222,150,1473,SG
1996,21,72,2701,452,1091,93,292,359,799,387,518,90,175,265,278,76,79,252,179,1384,SG
1996,30,81,2491,375,846,143,396,232,450,131,174,31,206,237,315,103,11,156,226,1024,SG
1996,25,82,2810,379,911,41,148,338,763,320,379,125,275,400,241,114,16,157,187,1119,SG
1996,33,82,2915,440,818,95,225,345,593,234,282,54,172,226,916,140,15,246,207,1209,PG
1996,22,70,2865,481,1129,133,337,348,792,236,296,59,222,281,653,98,19,267,166,1331,PG
1996,29,67,2526,471,1023,38,111,433,912,276,423,89,208,297,640,97,16,255,135,1256,PG
1996,27,63,746,72,169,1,9,71,160,69,85,60,118,178,32,18,12,20,80,214,PF
1996,22,79,1150,148,360,27,78,121,282,99,141,34,101,135,233,56,21,115,126,422,SG
1996,28,48,655,85,217,47,117,38,100,35,46,8,42,50,102,25,2,62,92,252,PG
1996,28,18,190,20,50,7,21,13,29,15,19,4,11,15,39,8,0,17,36,62,PG
1996,28,30,465,65,167,40,96,25,71,20,27,4,31,35,63,17,2,45,56,190,PG
1996,25,67,1332,225,414,0,1,225,413,64,114,117,203,320,62,24,31,101,204,514,C
1996,23,74,1655,274,547,0,2,274,545,118,178,122,317,439,46,47,36,98,271,666,PF
1996,25,33,246,48,103,25,64,23,39,19,27,4,20,24,31,12,0,24,35,140,PG
1996,34,44,773,33,83,0,0,33,83,19,24,62,137,199,26,19,20,37,125,85,C
1996,33,7,31,1,6,0,0,1,6,1,2,6,6,12,0,1,0,1,7,3,PF
1996,33,82,2841,452,853,0,4,452,849,257,362,211,477,688,158,53,39,195,300,1161,PF
1996,34,82,1687,241,526,60,169,181,357,54,71,20,75,95,269,68,11,74,178,596,PG
1996,31,63,1152,279,564,0,0,279,564,114,149,55,159,214,58,15,36,63,188,672,PF
1996,30,13,53,8,22,3,12,5,10,3,4,0,6,6,1,0,0,2,12,22,SF
1996,25,34,305,32,72,0,1,32,71,18,26,22,29,51,5,4,11,16,50,82,C
1996,21,69,1219,220,429,0,9,220,420,78,141,84,154,238,50,25,11,92,116,518,PF
1996,33,13,192,18,51,9,27,9,24,2,2,10,18,28,6,2,1,11,33,47,PF
1996,24,74,2513,396,950,144,403,252,547,163,204,29,152,181,509,70,10,156,115,1099,PG
1996,24,15,31,3,14,0,5,3,9,3,4,1,5,6,1,0,0,0,4,9,SF
1996,22,33,266,27,80,0,1,27,79,10,18,33,47,80,8,6,15,18,68,64,PF
1996,27,80,2966,571,1087,7,19,564,1068,149,205,204,604,808,112,87,40,158,241,1298,PF
1996,21,65,1788,275,565,27,82,248,483,78,120,93,210,303,85,42,54,103,206,655,PF
1996,25,44,610,61,148,22,66,39,82,42,52,13,42,55,106,25,4,41,53,186,SG
1996,25,11,87,12,33,3,12,9,21,6,6,2,5,7,11,3,0,7,4,33,SG
1996,25,33,523,49,115,19,54,30,61,36,46,11,37,48,95,22,4,34,49,153,SG
1996,25,62,787,87,218,33,99,54,119,37,54,29,73,102,132,54,6,79,98,244,PG
1996,23,16,217,18,43,3,7,15,36,9,13,5,22,27,24,8,2,17,30,48,SF
1996,25,78,3096,491,1015,0,2,491,1013,318,426,237,516,753,158,112,108,179,214,1300,SF
1996,32,77,1462,186,430,47,129,139,301,125,145,26,74,100,294,52,7,110,109,544,PG
1996,32,51,817,104,222,18,57,86,165,74,87,19,41,60,140,27,2,51,68,300,PG
1996,32,26,645,82,208,29,72,53,136,51,58,7,33,40,154,25,5,59,41,244,PG
1996,22,15,558,150,276,15,34,135,242,41,69,37,77,114,75,27,9,49,51,356,PF
1996,24,11,58,8,23,2,6,6,17,0,0,2,5,7,3,4,0,3,7,18,SF
1996,32,71,1065,169,343,1,1,168,342,37,43,58,116,174,46,21,16,37,171,376,C
1996,25,13,93,16,32,0,0,16,32,7,13,5,18,23,2,5,3,6,17,39,C
1996,25,82,2104,338,736,116,272,222,464,217,288,68,196,264,390,100,11,159,207,1009,PG
1996,28,73,1639,175,393,1,13,174,380,114,144,48,113,161,119,30,17,81,228,465,SG
1996,35,47,682,61,126,0,0,61,126,28,45,49,84,133,6,6,37,35,135,150,C
1996,23,8,122,13,30,0,0,13,30,14,22,9,16,25,2,3,2,8,14,40,PF
1996,24,21,335,45,99,19,44,26,55,41,44,2,31,33,51,18,1,23,46,150,PG
1996,32,28,738,77,205,14,64,63,141,20,23,22,43,65,68,22,2,37,55,188,SG
1996,35,70,1672,192,384,2,3,190,381,125,187,159,245,404,42,40,47,90,187,511,PF
1996,23,64,1470,241,546,3,10,238,536,200,298,92,125,217,70,56,11,88,147,685,SF
1996,37,1,31,3,8,0,0,3,8,0,0,1,7,8,0,1,2,0,4,6,C
1996,37,43,540,59,144,1,4,58,140,13,20,14,68,82,27,13,31,22,75,132,PF
1996,33,62,1652,180,397,0,1,180,396,95,130,129,243,372,62,46,90,62,170,455,C
1996,27,80,1858,279,660,2,7,277,653,161,272,342,461,803,47,35,57,106,238,721,PF
1996,26,65,1806,87,214,0,1,87,213,24,70,234,287,521,85,48,122,78,226,198,C
1996,29,9,189,13,40,1,3,12,37,28,33,3,20,23,31,5,3,23,37,55,PG
1996,24,31,184,27,68,0,1,27,67,14,20,20,20,40,8,6,2,18,26,68,SF
1996,24,14,62,7,22,0,0,7,22,5,8,9,8,17,4,2,0,5,9,19,SF
1996,24,17,122,20,46,0,1,20,45,9,12,11,12,23,4,4,2,13,17,49,SF
1996,31,52,817,94,254,20,89,74,165,33,39,25,97,122,74,34,21,51,137,241,SF
1996,27,13,193,15,29,0,2,15,27,10,12,13,33,46,5,6,7,8,27,40,PF
1996,25,73,2169,359,808,114,293,245,515,163,232,99,220,319,230,85,58,151,238,995,SF
1996,25,45,1381,235,540,58,170,177,370,130,172,62,145,207,165,53,42,103,151,658,SF
1996,25,28,788,124,268,56,123,68,145,33,60,37,75,112,65,32,16,48,87,337,SF
1996,22,53,609,125,268,0,3,125,265,47,84,56,58,114,23,11,9,76,115,297,SF
1996,33,75,2135,325,712,1,9,324,703,143,202,208,430,638,53,32,41,161,253,794,PF
1996,33,47,1357,195,412,0,5,195,407,89,125,134,286,420,34,19,25,99,158,479,PF
1996,33,28,778,130,300,1,4,129,296,54,77,74,144,218,19,13,16,62,95,315,PF
1996,27,6,79,10,20,0,0,10,20,3,4,7,7,14,4,3,0,1,9,23,PF
1996,32,60,695,88,212,15,34,73,178,32,41,17,39,56,58,20,4,42,66,223,SG
1996,21,44,487,60,157,19,63,41,94,26,34,45,59,104,28,20,6,31,73,165,SF
1996,31,64,1065,135,263,0,6,135,257,21,29,49,138,187,63,15,5,42,163,291,PF
1996,31,1,18,0,1,0,0,0,1,0,0,0,2,2,0,2,0,2,2,0,PF
1996,31,63,1047,135,262,0,6,135,256,21,29,49,136,185,63,13,5,40,161,291,PF
1996,31,62,772,75,174,20,62,55,112,38,50,51,103,154,34,19,10,24,150,208,PF
1996,31,21,96,7,14,1,3,6,11,7,8,7,9,16,5,2,1,3,23,22,PF
1996,31,4,34,1,6,0,0,1,6,2,2,2,3,5,2,1,0,2,9,4,PF
1996,31,37,642,67,154,19,59,48,95,29,40,42,91,133,27,16,9,19,118,182,PF
1996,25,8,72,6,22,5,21,1,1,2,2,3,3,6,12,6,1,5,13,19,PG
1996,30,77,1164,101,259,23,71,78,188,54,73,27,97,124,213,65,4,93,152,279,PG
1996,23,57,1434,248,512,1,3,247,509,167,259,148,208,356,38,30,49,109,163,664,C
1996,23,46,1136,183,384,0,0,183,384,117,186,124,175,299,27,24,39,81,125,483,C
1996,23,11,298,65,128,1,3,64,125,50,73,24,33,57,11,6,10,28,38,181,C
1996,22,71,888,105,248,0,0,105,248,71,93,69,114,183,16,9,7,38,170,281,C
1997,27,75,2131,411,924,94,246,317,678,115,136,16,106,122,189,56,6,119,174,1031,PG
1997,20,80,2802,550,1214,7,27,543,1187,387,519,216,339,555,175,79,79,225,199,1494,PF
1997,32,41,355,49,122,8,20,41,102,22,28,19,26,45,34,8,3,17,52,128,SF
1997,23,80,1454,194,490,94,252,100,238,95,129,29,94,123,254,82,16,146,148,577,PG
1997,24,76,943,78,221,30,93,48,128,42,72,25,73,98,152,31,4,69,84,228,SG
1997,24,51,692,57,147,23,59,34,88,27,47,13,52,65,109,27,0,56,67,164,SG
1997,24,25,251,21,74,7,34,14,40,15,25,12,21,33,43,4,4,13,17,64,SG
1997,21,82,2532,390,908,117,298,273,610,205,249,97,229,326,210,75,10,149,218,1102,SG
1997,24,2,11,0,5,0,0,0,5,0,2,3,1,4,0,0,0,0,0,0,C
1997,25,31,144,12,40,1,1,11,39,15,28,19,33,52,3,7,3,10,29,40,PF
1997,32,82,1659,130,262,0,1,130,261,62,93,157,291,448,34,63,67,73,225,322,C
1997,26,82,3081,485,1137,132,366,353,771,334,435,91,272,363,584,162,15,193,222,1436,PG
1997,29,63,2163,288,725,143,405,145,320,38,94,66,238,304,182,120,32,86,160,757,SG
1997,23,65,1066,147,318,24,47,123,271,68,99,52,127,179,49,27,8,73,113,386,SG
1997,30,28,303,29,64,8,19,21,45,17,20,15,27,42,34,14,4,19,36,83,SG
1997,29,65,1863,199,507,88,238,111,269,130,178,25,159,184,407,129,4,129,122,616,PG
1997,29,49,1020,148,327,25,90,123,237,68,79,7,67,74,126,25,2,53,56,389,PG
1997,28,67,1010,132,345,55,181,77,164,92,106,35,41,76,175,61,9,99,114,411,PG
1997,30,43,838,81,186,7,24,74,162,70,88,25,73,98,90,17,6,46,123,239,SG
1997,30,41,822,79,183,7,24,72,159,68,86,25,73,98,90,17,6,42,122,233,SG
1997,30,1,9,2,3,0,0,2,3,2,2,0,0,0,0,0,0,4,0,6,SG
1997,29,78,1773,138,319,69,172,69,147,39,58,86,185,271,75,53,19,59,196,384,SF
1997,28,60,942,105,220,0,0,105,220,69,97,47,91,138,56,42,17,64,87,279,SG
1997,28,20,292,31,77,0,0,31,77,28,41,14,35,49,15,10,10,27,29,90,SG
1997,28,40,650,74,143,0,0,74,143,41,56,33,56,89,41,32,7,37,58,189,SG
1997,27,82,1881,321,639,0,3,321,636,150,226,136,342,478,101,45,43,161,244,792,C
1997,25,78,3159,632,1251,15,54,617,1197,358,521,267,537,804,211,81,112,245,275,1637,PF
1997,33,53,2009,335,692,58,205,277,487,288,415,212,504,716,248,69,25,151,153,1016,PF
1997,29,24,708,110,253,43,105,67,148,37,43,5,43,48,81,26,6,39,34,300,PG
1997,25,59,1094,155,379,56,173,99,206,76,93,30,80,110,154,51,15,76,88,442,SG
1997,27,58,965,100,246,48,124,52,122,37,46,26,73,99,115,55,3,59,56,285,SG
1997,32,4,44,5,12,0,0,5,12,3,4,3,6,9,1,1,0,2,5,13,C
1997,26,9,75,6,19,3,9,3,10,7,10,0,4,4,11,4,0,10,7,22,PG
1997,26,4,16,2,6,1,3,1,3,5,6,0,1,1,4,2,0,0,1,10,PG
1997,26,5,59,4,13,2,6,2,7,2,4,0,3,3,7,2,0,10,6,12,PG
1997,24,76,2064,274,620,57,155,217,465,149,197,36,130,166,318,98,5,153,221,754,PG
1997,29,78,3056,501,1159,221,604,280,555,131,174,114,299,413,463,212,20,185,141,1354,PG
1997,28,58,1009,92,179,1,3,91,176,56,83,113,163,276,35,22,26,50,121,241,PF
1997,32,65,1880,204,443,60,144,144,299,54,64,25,116,141,469,82,2,108,114,522,PG
1997,26,8,48,6,19,1,6,5,13,6,8,3,3,6,0,2,1,1,3,19,SG
1997,24,21,430,46,105,12,37,34,68,18,20,7,22,29,53,3,2,27,28,122,PG
1997,24,5,21,2,4,1,2,1,2,0,0,0,1,1,3,0,0,7,0,5,PG
1997,24,16,409,44,101,11,35,33,66,18,20,7,21,28,50,3,2,20,28,117,PG
1997,23,22,154,21,63,2,16,19,47,11,22,7,8,15,13,10,4,16,17,55,SG
1997,24,73,2288,406,905,0,8,406,897,149,228,221,390,611,52,40,248,134,237,961,C
1997,24,40,1228,199,456,0,5,199,451,81,122,118,207,325,20,23,160,64,122,479,C
1997,24,33,1060,207,449,0,3,207,446,68,106,103,183,286,32,17,88,70,115,482,C
1997,28,36,251,25,58,0,0,25,58,9,13,26,42,68,7,5,5,9,34,59,C
1997,26,78,2868,575,1313,101,271,474,1042,268,297,48,253,301,490,138,30,178,177,1519,PG
1997,37,17,255,32,73,7,20,25,53,10,14,6,28,34,15,5,4,19,42,81,PF
1997,31,38,251,19,39,5,12,14,27,14,15,6,12,18,29,21,0,17,35,57,PG
1997,28,70,757,78,154,1,6,77,148,47,70,41,107,148,28,9,22,19,100,204,SF
1997,28,10,83,13,26,0,0,13,26,8,11,3,13,16,4,0,2,4,14,34,SF
1997,28,60,674,65,128,1,6,64,122,39,59,38,94,132,24,9,20,15,86,170,SF
1997,28,21,522,61,166,20,65,41,101,18,22,8,40,48,67,31,7,24,45,160,PG
1997,22,21,184,28,70,13,32,15,38,13,19,4,11,15,20,8,2,13,26,82,PG
1997,33,6,83,5,12,0,0,5,12,6,10,9,16,25,5,1,1,2,9,16,C
1997,27,80,2592,300,656,0,2,300,654,161,220,239,431,670,92,85,98,113,283,761,PF
1997,28,72,1057,140,333,4,22,136,311,57,84,34,77,111,133,81,17,58,116,341,PG
1997,18,71,1103,176,422,51,136,125,286,136,166,47,85,132,91,49,23,112,102,539,SG
1997,31,41,1018,152,275,0,0,152,275,76,108,67,145,212,47,22,5,46,136,380,PF
1997,28,76,703,58,158,18,54,40,104,5,14,45,81,126,60,23,21,27,50,139,SF
1997,29,71,1025,114,284,67,183,47,101,25,34,13,104,117,67,21,18,38,68,320,PF
1997,26,57,939,98,271,41,116,57,155,57,76,49,109,158,74,28,19,53,120,294,SF
1997,26,28,482,45,131,19,55,26,76,42,53,24,55,79,39,14,11,25,60,151,SF
1997,26,29,457,53,140,22,61,31,79,15,23,25,54,79,35,14,8,28,60,143,SF
1997,28,24,380,39,116,13,46,26,70,57,68,11,30,41,11,8,3,26,55,148,SF
1997,26,49,465,52,125,12,39,40,86,32,50,19,34,53,30,13,2,27,55,148,SG
1997,23,75,1405,205,385,0,1,205,384,139,211,135,166,301,89,25,9,97,149,549,PF
1997,35,82,1247,66,141,0,0,66,141,19,41,112,208,320,43,48,42,17,118,151,C
1997,30,45,569,40,92,0,2,40,90,21,50,58,109,167,12,16,8,28,87,101,PF
1997,30,18,204,10,35,0,2,10,33,9,17,20,36,56,5,8,1,12,27,29,PF
1997,30,27,365,30,57,0,0,30,57,12,33,38,73,111,7,8,7,16,60,72,PF
1997,22,63,1897,375,778,2,14,373,764,183,264,131,263,394,97,66,130,134,214,935,C
1997,28,77,2516,442,942,1,4,441,938,263,370,207,408,615,126,46,117,130,276,1148,PF
1997,35,82,1460,252,522,0,3,252,519,99,127,60,135,195,74,24,63,75,214,603,PF
1997,22,55,830,125,271,31,88,94,183,56,73,31,82,113,48,24,10,37,93,337,SG
1997,27,4,21,2,3,0,0,2,3,1,1,0,4,4,0,0,2,1,4,5,PF
1997,27,61,1714,337,783,81,231,256,552,212,251,47,135,182,305,77,19,168,200,967,PG
1997,27,22,539,100,241,19,62,81,179,106,124,12,38,50,99,23,6,60,66,325,PG
1997,27,16,398,70,165,15,49,55,116,42,50,14,36,50,57,17,6,41,48,197,PG
1997,27,23,777,167,377,47,120,120,257,64,77,21,61,82,149,37,7,67,86,445,PG
1997,28,46,581,48,94,2,3,46,91,20,37,57,70,127,20,15,38,34,131,118,C
1997,27,50,1426,282,617,26,102,256,515,139,186,102,228,330,64,33,23,85,113,729,SF
1997,27,8,279,34,83,5,21,29,62,13,15,11,42,53,15,5,6,17,19,86,SF
1997,27,42,1147,248,534,21,81,227,453,126,171,91,186,277,49,28,17,68,94,643,SF
1997,37,12,83,7,31,2,3,5,28,3,4,3,11,14,4,1,0,9,14,19,PF
1997,29,65,1833,332,749,110,314,222,435,124,149,25,156,181,182,52,7,96,108,898,SG
1997,25,79,2411,369,730,4,30,365,700,95,137,70,198,268,114,77,18,94,226,837,SG
1997,28,54,662,72,165,25,69,47,96,13,22,67,89,156,47,26,17,28,52,182,PF
1997,24,23,155,14,40,5,19,9,21,6,8,1,5,6,17,9,0,18,16,39,PG
1997,24,19,125,10,30,3,16,7,14,6,8,1,4,5,15,7,0,13,11,29,PG
1997,24,4,30,4,10,2,3,2,7,0,0,0,1,1,2,2,0,5,5,10,PG
1997,29,65,2076,211,510,70,181,141,329,113,149,22,169,191,398,78,11,180,213,605,PG
1997,26,81,3127,396,949,147,383,249,566,237,306,85,347,432,315,201,45,200,245,1176,SG
1997,29,57,2102,364,836,32,119,332,717,272,365,157,416,573,193,50,75,184,164,1032,PF
1997,28,51,1183,122,314,30,102,92,212,37,49,39,79,118,149,35,7,59,96,311,PG
1997,29,74,1614,214,454,2,10,212,444,144,171,128,195,323,104,46,18,109,154,574,C
1997,34,70,2305,253,600,74,208,179,392,86,108,76,218,294,124,90,7,85,176,666,SF
1997,27,9,100,11,30,0,0,11,30,3,5,9,7,16,0,0,0,3,14,25,PF
1997,27,4,52,6,14,0,0,6,14,0,0,5,4,9,0,0,0,1,8,12,PF
1997,27,5,48,5,16,0,0,5,16,3,5,4,3,7,0,0,0,2,6,13,PF
1997,27,48,659,79,154,20,49,59,105,54,64,15,32,47,102,18,0,42,79,232,PG
1997,35,45,828,155,319,3,5,152,314,57,82,70,113,183,39,33,7,45,113,370,PF
1997,39,9,46,3,8,0,0,3,8,1,3,4,5,9,4,0,0,1,10,7,PF
1997,32,68,2078,384,836,126,296,258,540,114,142,40,171,211,118,60,14,93,147,1008,SG
1997,28,81,1217,99,221,23,77,76,144,97,108,23,96,119,43,31,12,28,128,318,SG
1997,21,72,1052,131,336,1,1,130,335,107,168,96,198,294,43,19,73,84,153,370,C
1997,29,22,310,36,119,21,70,15,49,5,6,19,24,43,26,10,3,14,33,98,SG
1997,29,5,28,2,16,2,11,0,5,0,0,1,3,4,1,1,0,3,4,6,SG
1997,29,17,282,34,103,19,59,15,44,5,6,18,21,39,25,9,3,11,29,92,SG
1997,26,56,1789,248,570,85,236,163,334,121,151,29,107,136,102,54,9,116,160,702,SG
1997,26,43,1351,175,396,63,176,112,220,73,94,21,81,102,77,39,8,94,123,486,SG
1997,26,13,438,73,174,22,60,51,114,48,57,8,26,34,25,15,1,22,37,216,SG
1997,24,41,313,19,54,0,0,19,54,19,37,35,47,82,3,4,28,21,51,57,C
1997,28,82,2335,308,641,1,14,307,627,241,362,190,408,598,65,42,84,141,260,858,PF
1997,24,20,98,10,26,0,0,10,26,9,20,12,15,27,0,4,1,3,16,29,PF
1997,27,80,2589,370,688,0,0,370,688,92,215,301,471,772,59,60,77,108,233,832,PF
1997,28,13,230,24,54,12,27,12,27,5,8,2,20,22,26,9,2,17,20,65,PG
1997,26,36,623,74,184,16,70,58,114,17,23,11,29,40,34,11,2,21,40,181,SG
1997,23,75,1705,251,535,24,93,227,442,113,168,138,185,323,135,85,31,118,230,639,SF
1997,27,81,2277,398,999,126,348,272,651,256,331,109,221,330,117,108,48,127,208,1178,SG
1997,23,71,1065,142,273,0,0,142,273,91,151,122,176,298,32,33,27,76,229,375,C
1997,25,73,1053,148,383,52,160,96,223,122,148,15,80,95,158,27,3,96,142,470,PG
1997,30,72,2243,365,781,44,140,321,641,112,129,39,171,210,231,59,7,92,131,886,SG
1997,27,9,138,26,63,0,0,26,63,11,15,14,19,33,12,3,5,11,20,63,C
1997,23,61,867,119,256,52,112,67,144,42,51,31,68,99,99,36,6,68,71,332,PG
1997,26,2,10,0,3,0,1,0,2,2,2,0,0,0,0,1,0,0,1,2,SG
1997,28,81,2840,418,847,11,47,407,800,177,259,241,484,725,301,103,180,193,277,1024,C
1997,29,8,61,8,16,5,7,3,9,4,5,1,4,5,5,0,0,5,3,25,SG
1997,30,79,2316,306,610,38,114,268,496,114,171,57,136,193,427,78,10,153,191,764,PG
1997,34,40,389,34,74,1,1,33,73,11,27,19,57,76,11,8,7,9,65,80,C
1997,34,62,2271,397,899,119,335,278,564,201,268,118,255,373,354,119,36,156,151,1114,SG
1997,23,15,132,13,43,0,9,13,34,10,14,12,10,22,6,3,2,6,10,36,SG
1997,32,26,384,45,103,3,4,42,99,11,16,23,37,60,16,9,11,33,63,104,C
1997,31,81,1840,126,293,0,0,126,293,65,137,204,389,593,41,39,96,80,247,317,C
1997,33,79,2923,385,875,166,384,219,491,222,256,38,153,191,318,57,1,128,97,1158,SG
1997,24,24,278,33,96,4,28,29,68,16,25,3,13,16,25,10,2,16,45,86,SG
1997,24,18,227,27,77,3,24,24,53,15,23,3,11,14,22,10,1,15,36,72,SG
1997,24,6,51,6,19,1,4,5,15,1,2,0,2,2,3,0,1,1,9,14,SG
1997,26,47,500,67,180,0,5,67,175,54,84,35,61,96,20,15,28,35,61,188,C
1997,26,38,457,59,157,0,5,59,152,44,70,33,52,85,18,12,27,33,54,162,C
1997,26,9,43,8,23,0,0,8,23,10,14,2,9,11,2,3,1,2,7,26,C
1997,23,70,1376,150,391,8,42,142,349,177,215,34,79,113,226,60,2,112,98,485,PG
1997,31,61,1439,182,458,25,89,157,369,89,109,49,140,189,114,38,20,81,135,478,SF
1997,31,32,477,69,183,15,43,54,140,37,43,9,34,43,57,17,4,49,34,190,PG
1997,35,62,848,87,248,27,95,60,153,13,26,39,71,110,68,36,4,45,71,214,SG
1997,24,82,1083,139,308,20,72,119,236,70,89,20,64,84,198,44,10,110,141,368,PG
1997,33,78,2687,291,585,120,286,171,299,207,231,60,175,235,310,92,12,135,200,909,SF
1997,28,39,1393,196,464,42,126,154,338,148,196,48,142,190,124,24,24,89,105,582,SF
1997,36,82,2940,477,1151,192,528,285,623,215,263,99,194,293,165,60,7,146,178,1361,SF
1997,26,55,2002,445,1014,95,259,350,755,218,282,107,279,386,131,44,41,117,181,1203,PF
1997,29,6,125,6,16,0,0,6,16,3,5,9,17,26,4,5,9,7,21,15,PF
1997,23,14,59,8,22,4,8,4,14,0,0,1,7,8,7,1,2,2,6,20,SF
1997,34,78,2887,655,1342,2,9,653,1333,439,582,175,659,834,156,69,189,269,250,1751,C
1997,22,3,10,2,4,1,1,1,3,0,2,1,2,3,0,0,1,0,3,5,C
1997,22,38,614,54,153,4,13,50,140,34,65,81,130,211,26,16,13,31,75,146,PF
1997,31,62,1115,159,337,18,44,141,293,58,94,57,84,141,66,38,6,55,120,394,SF
1997,30,82,2633,341,794,114,284,227,510,74,87,82,255,337,151,56,32,94,245,870,PF
1997,23,83,2790,475,1071,101,280,374,791,198,245,88,284,372,224,68,24,164,138,1249,SF
1997,23,27,796,141,297,14,55,127,242,56,69,34,86,120,68,18,4,44,42,352,SF
1997,23,56,1994,334,774,87,225,247,549,142,176,54,198,252,156,50,20,120,96,897,SF
1997,27,6,8,1,3,0,0,1,3,0,0,1,4,5,0,0,0,2,2,2,C
1997,27,5,7,1,3,0,0,1,3,0,0,1,4,5,0,0,0,2,2,2,C
1997,22,80,921,104,262,22,73,82,189,79,120,25,72,97,119,41,5,71,87,309,PG
1997,28,79,920,111,245,2,3,109,242,54,65,56,131,187,31,10,20,54,145,278,C
1997,27,76,2650,433,950,101,278,332,672,207,263,114,280,394,286,167,40,178,279,1174,SF
1997,22,75,949,114,266,0,0,114,266,76,110,108,141,249,24,10,20,52,146,304,C
1997,31,62,953,123,286,54,112,69,174,7,10,13,94,107,77,21,17,27,76,307,SF
1997,20,77,2995,549,1100,6,21,543,1079,205,272,190,428,618,236,105,163,175,199,1309,SF
1997,30,68,1665,223,389,0,0,223,389,96,138,149,346,495,38,40,95,34,158,542,C
1997,29,47,1283,327,623,1,6,326,617,236,329,134,236,370,28,39,31,120,138,891,PF
1997,29,44,1191,309,580,1,6,308,574,221,313,126,222,348,25,35,31,114,125,840,PF
1997,29,3,92,18,43,0,0,18,43,15,16,8,14,22,3,4,0,6,13,51,PF
1997,23,39,246,22,58,8,21,14,37,5,11,4,11,15,36,13,2,15,36,57,PG
1997,27,49,1044,171,350,6,20,165,330,89,127,100,158,258,38,20,27,67,153,437,C
1997,28,82,3199,644,1453,74,220,570,1233,427,536,183,316,499,326,154,46,218,225,1789,SF
1997,32,80,2050,246,522,0,0,246,522,199,259,136,361,497,53,61,40,105,206,691,PF
1997,25,60,1188,131,330,64,153,67,177,61,78,12,72,84,219,33,2,76,104,387,PG
1997,25,33,576,62,154,36,82,26,72,30,40,3,35,38,94,19,1,41,58,190,PG
1997,25,27,612,69,176,28,71,41,105,31,38,9,37,46,125,14,1,35,46,197,PG
1997,26,28,197,29,80,9,31,20,49,26,40,2,11,13,11,12,1,10,12,93,SG
1997,24,24,607,91,207,0,0,91,207,70,90,49,93,142,28,19,25,44,75,252,PF
1997,31,28,365,39,110,14,46,25,64,18,22,8,30,38,45,16,0,27,39,110,PG
1997,31,78,1604,129,314,28,89,101,225,30,39,63,193,256,68,46,48,30,167,316,PF
1997,31,67,2496,358,695,1,6,357,689,128,179,206,394,600,163,101,65,99,157,845,PF
1997,24,6,49,8,26,0,0,8,26,2,5,6,8,14,2,4,0,5,11,18,PF
1997,24,3,25,3,11,0,0,3,11,2,4,3,6,9,2,3,0,0,3,8,PF
1997,24,3,24,5,15,0,0,5,15,0,1,3,2,5,0,1,0,5,8,10,PF
1997,27,5,42,4,15,1,4,3,11,4,4,1,2,3,2,1,0,3,5,13,SF
1997,31,25,316,38,83,4,11,34,72,11,20,21,17,38,25,8,7,15,42,91,SG
1997,33,83,2492,234,484,1,20,233,464,128,197,222,434,656,69,70,16,74,145,597,PF
1997,33,27,548,61,128,0,3,61,125,31,48,33,105,138,17,18,1,20,34,153,PF
1997,33,56,1944,173,356,1,17,172,339,97,149,189,329,518,52,52,15,54,111,444,PF
1997,26,45,311,30,64,0,10,30,54,30,47,6,16,22,41,16,1,15,27,90,PG
1997,27,81,3131,592,1339,24,93,568,1246,464,566,187,515,702,335,130,89,293,237,1672,PF
1997,33,20,74,13,37,0,0,13,37,14,19,13,19,32,5,1,1,2,14,40,C
1997,23,36,318,33,62,0,0,33,62,17,35,29,27,56,14,9,8,22,57,83,SF
1997,23,35,313,32,61,0,0,32,61,16,33,29,27,56,14,8,8,21,57,80,SF
1997,23,1,5,1,1,0,0,1,1,1,2,0,0,0,0,1,0,1,0,3,SF
1997,23,35,268,30,57,0,2,30,55,16,29,17,43,60,7,2,4,13,39,76,C
1997,29,81,1758,191,398,0,2,191,396,124,172,135,266,401,64,16,24,88,205,506,PF
1997,25,24,133,16,35,0,0,16,35,10,14,4,14,18,12,9,1,11,15,42,SF
1997,25,9,39,2,6,0,0,2,6,0,0,1,4,5,4,2,0,4,7,4,SF
1997,25,14,86,13,27,0,0,13,27,8,12,3,10,13,7,7,1,7,6,34,SF
1997,25,1,8,1,2,0,0,1,2,2,2,0,0,0,1,0,0,0,2,4,SF
1997,25,59,2221,421,941,85,267,336,674,283,345,82,181,263,332,93,35,145,123,1210,PG
1997,30,81,3136,575,1384,203,590,372,794,291,364,49,228,277,695,151,9,230,165,1644,PG
1997,35,75,2210,299,674,60,176,239,498,95,128,30,107,137,321,92,12,132,144,753,PG
1997,33,76,1740,177,406,68,188,109,218,58,82,46,147,193,191,86,38,50,138,480,PG
1997,23,57,860,112,204,0,3,112,201,49,81,75,123,198,18,12,22,57,112,273,PF
1997,26,54,813,112,294,36,99,76,195,33,47,27,44,71,50,41,3,34,45,293,SG
1997,26,6,26,5,11,0,0,5,11,5,6,2,8,10,1,0,4,1,8,15,PF
1997,30,82,2755,369,795,143,355,226,440,258,295,92,228,320,250,159,12,130,146,1139,SG
1997,24,29,326,29,68,10,31,19,37,12,15,9,22,31,64,16,1,28,40,80,PG
1997,26,43,236,26,97,20,65,6,32,3,5,2,16,18,33,3,3,17,20,75,PG
1997,24,30,501,77,162,0,0,77,162,45,75,47,69,116,23,21,6,29,73,199,PF
1997,22,29,301,32,77,3,12,29,65,18,26,35,57,92,3,10,4,14,32,85,PF
1997,30,75,1837,257,593,2,6,255,587,81,118,118,222,340,50,62,53,95,217,597,PF
1997,24,80,3147,625,1259,10,33,615,1226,450,633,123,598,721,583,144,48,259,186,1710,SF
1997,28,74,2582,357,595,0,1,357,594,241,381,259,477,736,92,63,30,147,268,955,C
1997,24,47,572,67,156,29,70,38,86,61,77,13,68,81,41,27,6,22,51,224,SG
1997,33,82,2592,413,856,72,195,341,661,293,326,60,181,241,361,124,26,134,188,1191,SG
1997,26,54,1395,157,360,49,154,108,206,60,90,68,169,237,110,66,55,72,153,423,SF
1997,26,32,719,82,195,24,78,58,117,32,50,40,79,119,54,28,26,46,81,220,SF
1997,26,22,676,75,165,25,76,50,89,28,40,28,90,118,56,38,29,26,72,203,SF
1997,25,81,2681,437,1032,148,384,289,648,175,218,43,197,240,179,41,18,167,233,1197,SG
1997,23,82,3324,638,1313,0,2,638,1311,294,389,202,450,652,311,93,23,246,259,1570,SF
1997,26,49,418,62,108,0,0,62,108,52,81,29,56,85,11,19,12,25,62,176,SF
1997,26,7,69,7,12,0,0,7,12,12,14,4,5,9,1,8,2,5,7,26,SF
1997,26,42,349,55,96,0,0,55,96,40,67,25,51,76,10,11,10,20,55,150,SF
1997,26,82,3023,421,1042,166,468,255,574,158,203,59,174,233,154,129,24,96,206,1166,PG
1997,25,49,632,46,125,14,45,32,80,37,53,9,29,38,146,27,3,55,53,143,PG
1997,21,76,3045,625,1504,155,455,470,1049,382,544,115,197,312,567,157,24,337,233,1787,PG
1997,29,75,1133,134,329,53,158,81,171,53,69,31,101,132,65,45,16,60,131,374,SG
1997,26,46,1676,260,588,46,139,214,449,148,188,81,146,227,156,57,15,107,113,714,SG
1997,26,31,1155,184,441,40,108,144,333,104,122,51,133,184,160,29,17,101,81,512,SF
1997,31,82,3054,289,679,66,178,223,501,168,213,91,304,395,935,97,12,274,161,812,PG
1997,31,52,2001,192,452,48,121,144,331,109,136,71,200,271,641,51,9,172,104,541,PG
1997,31,30,1053,97,227,18,57,79,170,59,77,20,104,124,294,46,3,102,57,271,PG
1997,31,53,945,125,306,76,181,49,125,30,36,27,54,81,21,11,1,29,98,356,PF
1997,27,3,10,2,6,2,3,0,3,0,0,1,0,1,1,0,0,0,2,6,SF
1997,31,76,2472,327,685,6,26,321,659,140,203,32,115,147,513,96,15,146,158,800,PG
1997,37,52,913,160,362,49,131,111,231,55,68,27,111,138,52,15,2,47,81,424,SF
1997,37,28,306,59,136,9,28,50,108,20,27,3,37,40,17,5,1,17,33,147,SF
1997,37,24,607,101,226,40,103,61,123,35,41,24,74,98,35,10,1,30,48,277,SF
1997,29,82,2599,243,467,0,2,243,465,96,156,231,682,913,71,65,227,118,288,582,C
1997,30,70,2658,441,890,89,202,352,688,439,515,54,199,253,653,102,12,217,141,1410,PG
1997,27,76,2613,376,735,34,105,342,630,190,274,165,228,393,174,64,36,136,249,976,SF
1997,39,12,93,2,5,0,0,2,5,0,0,5,8,13,3,2,4,0,8,4,PF
1997,25,80,2998,473,1081,152,389,321,692,276,337,90,236,326,270,189,49,169,226,1374,SG
1997,26,79,2421,258,537,1,13,257,524,99,121,270,410,680,84,58,39,116,269,616,PF
1997,33,82,3106,920,1892,111,297,809,1595,480,576,113,369,482,352,140,44,166,156,2431,SG
1997,29,19,130,16,26,0,0,16,26,8,17,11,16,27,12,7,3,8,15,40,SG
1997,29,9,99,8,16,0,0,8,16,4,10,11,12,23,11,5,3,6,13,20,SG
1997,29,10,31,8,10,0,0,8,10,4,7,0,4,4,1,2,0,2,2,20,SG
1997,26,62,915,82,160,0,1,82,159,71,103,75,141,216,32,30,13,45,97,235,C
1997,27,81,2750,526,1032,12,33,514,999,452,609,275,532,807,156,125,81,280,320,1516,PF
1997,33,10,59,1,5,0,0,1,5,2,2,3,5,8,2,1,1,7,4,4,PF
1997,31,82,1861,249,467,110,237,139,230,54,67,29,101,130,175,67,3,43,98,662,PG
1997,34,70,1766,194,449,17,65,177,384,71,118,112,251,363,89,119,49,74,219,476,SF
1997,23,55,1964,213,529,61,165,152,364,112,165,64,185,249,496,124,20,142,114,599,PG
1997,23,22,791,75,203,21,65,54,138,46,69,30,60,90,200,45,8,66,42,217,PG
1997,23,33,1173,138,326,40,100,98,226,66,96,34,125,159,296,79,12,76,72,382,PG
1997,24,7,59,7,17,1,2,6,15,5,5,4,10,14,5,4,0,3,7,20,SG
1997,23,2,22,2,6,0,0,2,6,2,4,2,0,2,2,3,0,1,2,6,SG
1997,30,11,103,11,22,0,0,11,22,2,7,11,16,27,1,2,1,6,14,24,C
1997,30,5,33,5,7,0,0,5,7,2,3,1,8,9,1,0,1,1,3,12,C
1997,30,6,70,6,15,0,0,6,15,0,4,10,8,18,0,2,0,5,11,12,C
1997,22,82,3012,507,1189,158,419,349,770,175,227,106,213,319,249,157,35,127,165,1347,SG
1997,35,59,848,69,170,2,3,67,167,28,38,62,141,203,35,17,18,41,110,168,C
1997,35,23,365,32,80,1,1,31,79,13,18,21,59,80,12,9,6,20,47,78,C
1997,35,8,30,2,8,0,0,2,8,2,2,2,7,9,0,0,0,0,6,6,C
1997,35,28,453,35,82,1,2,34,80,13,18,39,75,114,23,8,12,21,57,84,C
1997,22,71,1156,140,275,0,0,140,275,62,100,130,189,319,39,31,58,49,170,342,C
1997,32,3,11,1,2,0,0,1,2,1,2,2,3,5,3,2,0,1,3,3,PF
1997,28,57,1610,285,605,50,151,235,454,134,174,94,167,261,256,60,29,91,97,754,SF
1997,27,82,3140,548,1128,31,88,517,1040,359,440,212,508,720,223,102,64,218,277,1486,PF
1997,30,52,1194,115,248,0,0,115,248,44,61,94,184,278,25,26,47,39,140,274,C
1997,24,64,843,68,162,0,6,68,156,35,48,52,75,127,33,33,30,50,111,171,PF
1997,23,35,180,49,89,0,1,49,88,13,23,16,27,43,12,1,9,37,39,111,C
1997,30,20,126,14,33,0,0,14,33,6,12,5,31,36,5,3,2,10,35,34,C
1997,30,1,11,0,3,0,0,0,3,0,0,0,1,1,1,0,0,0,3,0,C
1997,30,19,115,14,30,0,0,14,30,6,12,5,30,35,4,3,2,10,32,34,C
1997,30,15,182,15,48,8,29,7,19,6,7,0,21,21,7,3,5,9,21,44,SG
1997,23,73,2111,314,684,183,442,131,242,86,105,38,179,217,161,50,18,109,168,897,SG
1997,21,9,50,6,14,1,3,5,11,1,2,4,2,6,4,1,2,1,8,14,SF
1997,38,53,516,32,77,0,0,32,77,23,31,66,102,168,13,8,14,30,95,87,C
1997,21,64,981,100,229,9,22,91,207,42,65,32,62,94,155,39,12,102,107,251,PG
1997,23,20,101,15,28,0,0,15,28,4,8,4,14,18,4,10,5,11,25,34,C
1997,32,6,45,4,15,2,7,2,8,0,0,1,6,7,1,1,0,1,6,10,PF
1997,30,65,1166,123,275,17,47,106,228,63,84,88,134,222,39,43,6,48,106,326,PF
1997,40,32,370,46,117,12,34,34,83,25,28,6,34,40,21,9,2,24,28,129,SG
1997,28,59,1472,221,485,0,2,221,483,95,120,121,211,332,141,23,66,111,191,537,C
1997,26,41,1059,137,291,8,31,129,260,60,97,98,163,261,76,63,17,64,97,342,SF
1997,26,52,904,105,262,47,142,58,120,35,42,20,86,106,58,29,6,42,67,292,SF
1997,27,37,733,163,365,12,38,151,327,64,97,41,99,140,37,12,10,47,71,402,SF
1997,38,22,218,20,54,0,1,20,53,16,22,19,34,53,6,4,3,10,34,56,C
1997,31,36,1264,141,347,68,201,73,146,40,59,45,117,162,116,54,14,50,75,390,SF
1997,33,82,2998,864,1571,0,13,864,1558,521,690,193,616,809,368,113,48,233,217,2249,PF
1997,25,82,2386,271,615,154,381,117,234,71,93,19,141,160,303,82,1,122,125,767,PG
1997,30,77,2134,426,795,7,36,419,759,181,251,137,332,469,173,81,74,161,268,1040,PF
1997,26,26,201,32,82,2,4,30,78,9,14,16,23,39,3,4,2,7,29,75,PF
1997,26,16,128,18,48,2,3,16,45,6,8,8,15,23,2,3,1,5,18,44,PF
1997,26,10,73,14,34,0,1,14,33,3,6,8,8,16,1,1,1,2,11,31,PF
1997,19,67,2324,355,871,102,288,253,583,245,337,54,130,184,522,67,19,210,159,1057,PG
1997,32,17,255,38,101,11,30,27,71,29,36,12,18,30,25,12,1,40,38,116,SG
1997,24,56,548,52,160,33,87,19,73,38,54,22,48,70,24,24,3,32,60,175,SF
1997,23,61,1022,174,421,35,111,139,310,61,98,92,184,276,54,25,46,55,96,444,SF
1997,25,3,13,0,7,0,2,0,5,0,0,1,0,1,1,0,0,1,1,0,SG
1997,25,82,1820,292,718,91,234,201,484,218,250,26,87,113,339,57,2,127,165,893,PG
1997,24,69,2164,286,743,90,277,196,466,160,228,69,225,294,204,78,12,114,186,822,SF
1997,24,37,975,140,376,42,131,98,245,72,111,28,87,115,93,35,5,57,69,394,SF
1997,24,32,1189,146,367,48,146,98,221,88,117,41,138,179,111,43,7,57,117,428,SF
1997,30,73,3143,433,825,1,3,432,822,319,428,186,643,829,414,76,33,165,202,1186,PF
1997,29,79,1954,219,452,0,1,219,451,130,206,222,295,517,23,38,50,91,217,568,PF
1997,31,72,2068,340,906,115,372,225,534,134,180,27,132,159,153,87,19,121,168,929,SG
1997,26,80,1952,149,370,83,221,66,149,29,46,29,105,134,329,60,8,90,159,410,PG
1997,22,35,192,26,68,4,14,22,54,8,14,8,15,23,13,7,9,17,38,64,PF
1997,23,17,109,10,32,0,2,10,30,8,12,4,18,22,7,3,5,11,7,28,C
1997,29,64,1493,238,578,99,254,139,324,83,101,36,143,179,109,61,8,61,126,658,SF
1997,29,41,1207,204,482,78,205,126,277,77,92,29,114,143,92,52,8,52,106,563,SF
1997,29,23,286,34,96,21,49,13,47,6,9,7,29,36,17,9,0,9,20,95,SF
1997,33,62,1170,138,355,5,25,133,330,65,89,124,194,318,65,36,17,70,144,346,PF
1997,22,74,2565,536,1157,6,35,530,1122,274,387,155,382,537,106,62,126,199,276,1352,PF
1997,24,82,1477,130,276,1,7,129,269,53,107,132,198,330,23,39,164,62,247,314,C
1997,22,13,117,23,49,12,26,11,23,7,10,2,4,6,18,2,1,13,16,65,PG
1997,30,50,1449,148,379,15,58,133,321,89,123,80,161,241,135,47,30,83,141,400,SF
1997,24,83,1625,150,365,41,103,109,262,92,110,40,181,221,161,77,22,90,130,433,SG
1997,24,41,775,53,156,23,55,30,101,41,49,13,80,93,84,34,15,48,61,170,SG
1997,24,42,850,97,209,18,48,79,161,51,61,27,101,128,77,43,7,42,69,263,SG
1997,32,37,798,61,149,28,84,33,65,19,29,15,103,118,140,58,6,32,78,169,PG
1997,24,54,708,108,244,4,7,104,237,46,64,53,92,145,19,11,15,62,125,266,PF
1997,24,19,259,34,78,1,2,33,76,9,12,14,35,49,7,6,3,27,52,78,PF
1997,24,35,449,74,166,3,5,71,161,37,52,39,57,96,12,5,12,35,73,188,PF
1997,25,1,14,0,5,0,0,0,5,0,0,2,5,7,0,0,0,0,2,0,PF
1997,26,61,1152,123,238,0,2,123,236,48,79,105,201,306,87,47,63,90,181,294,C
1997,26,42,836,76,154,0,1,76,153,28,53,82,151,233,58,34,50,70,133,180,C
1997,26,19,316,47,84,0,1,47,83,20,26,23,50,73,29,13,13,20,48,114,C
1997,31,81,2966,552,1244,229,536,323,708,418,475,53,233,286,273,75,25,166,172,1751,SG
1997,27,80,3167,405,894,86,220,319,674,176,209,118,379,497,198,86,41,120,222,1072,SF
1997,29,79,1997,312,702,175,415,137,287,58,70,68,309,377,99,35,27,85,161,857,PF
1997,25,23,547,94,196,1,8,93,188,31,36,30,50,80,34,15,2,22,45,220,SF
1997,33,82,2044,269,603,4,25,265,578,224,295,112,214,326,79,51,20,93,232,766,SF
1997,26,28,307,28,63,0,0,28,63,16,30,30,28,58,14,5,10,29,44,72,C
1997,25,78,1828,159,349,0,0,159,349,21,62,181,337,518,61,20,73,77,268,339,C
1997,25,47,984,86,187,0,0,86,187,10,34,66,170,236,32,9,34,51,150,182,C
1997,25,31,844,73,162,0,0,73,162,11,28,115,167,282,29,11,39,26,118,157,C
1997,31,27,237,33,85,11,43,22,42,22,31,11,15,26,20,5,0,14,19,99,SG
1997,31,73,977,122,299,31,113,91,186,39,54,37,125,162,43,29,24,45,121,314,SF
1997,24,67,1214,171,441,41,141,130,300,64,99,43,76,119,129,48,24,81,83,447,SG
1997,26,66,2320,473,885,1,9,472,876,363,565,189,467,656,104,56,189,226,272,1310,C
1997,33,79,2733,438,792,83,202,355,590,184,213,75,242,317,322,130,33,192,155,1143,SF
1997,28,12,114,15,33,4,10,11,23,11,12,1,10,11,24,9,2,11,9,45,PG
1997,25,73,1849,327,541,0,0,327,541,123,199,141,340,481,29,43,96,117,230,777,C
1997,23,74,1295,181,435,31,91,150,344,156,211,85,148,233,57,53,29,86,113,549,SF
1997,25,82,1814,288,678,106,300,182,378,135,161,84,169,253,78,69,19,86,150,817,SF
1997,30,80,2973,380,721,0,0,380,721,306,434,268,661,929,110,49,264,186,249,1066,C
1997,22,42,348,54,131,4,24,50,107,44,70,35,32,67,20,12,11,18,58,156,PF
1997,22,10,27,5,14,1,4,4,10,6,14,2,3,5,3,0,1,3,3,17,PF
1997,22,32,321,49,117,3,20,46,97,38,56,33,29,62,17,12,10,15,55,139,PF
1997,22,65,684,74,175,23,55,51,120,42,51,16,47,63,138,20,0,63,92,213,PG
1997,24,8,94,12,29,0,4,12,25,8,10,3,5,8,12,6,0,3,9,32,SG
1997,24,2,19,4,8,0,2,4,6,0,0,0,0,0,5,3,0,5,3,8,PG
1997,26,72,850,40,91,0,0,40,91,20,52,76,128,204,24,28,15,42,115,100,PF
1997,33,82,2060,246,547,34,98,212,449,189,247,66,120,186,116,73,17,115,257,715,SF
1997,27,4,42,4,12,0,2,4,10,7,7,1,4,5,1,1,1,1,1,15,SG
1997,27,3,36,3,9,0,1,3,8,7,7,1,3,4,1,0,1,0,1,13,SG
1997,27,1,6,1,3,0,1,1,2,0,0,0,1,1,0,1,0,1,0,2,SG
1997,32,17,220,27,94,6,38,21,56,4,12,8,31,39,12,7,3,18,17,64,SF
1997,23,8,89,4,22,2,10,2,12,2,5,3,9,12,23,4,0,5,5,12,PG
1997,24,64,809,93,279,18,70,75,209,31,35,50,98,148,39,29,12,20,97,235,SF
1997,24,45,634,76,207,17,60,59,147,20,23,41,71,112,28,24,10,14,78,189,SF
1997,24,19,175,17,72,1,10,16,62,11,12,9,27,36,11,5,2,6,19,46,SF
1997,18,45,458,69,153,0,1,69,152,47,78,39,85,124,8,2,26,27,46,185,PF
1997,24,51,1941,552,991,0,4,552,987,232,479,195,445,640,159,46,147,146,180,1336,C
1997,33,80,2873,339,694,5,19,334,675,181,224,246,535,781,221,111,21,171,305,864,PF
1997,34,78,2852,727,1426,5,16,722,1410,351,446,173,543,716,236,117,173,281,249,1810,C
1997,27,4,43,4,13,1,6,3,7,2,2,1,4,5,1,2,0,3,2,11,SG
1997,23,77,1818,210,408,0,4,210,404,139,205,180,385,565,27,24,152,74,233,559,C
1997,25,82,2195,254,417,0,8,254,409,117,232,174,280,454,157,94,142,107,227,625,PF
1997,27,61,634,81,190,10,40,71,150,45,48,18,50,68,101,24,0,39,44,217,PG
1997,27,66,1995,299,640,25,72,274,568,101,145,134,258,392,187,62,25,133,187,724,SF
1997,24,57,592,75,180,1,5,74,175,26,46,64,99,163,15,15,20,23,86,177,PF
1997,27,54,1782,272,693,31,112,241,581,196,243,28,118,146,452,94,6,217,139,771,PG
1997,27,34,1185,193,474,22,74,171,400,134,170,15,71,86,325,59,3,150,83,542,PG
1997,27,20,597,79,219,9,38,70,181,62,73,13,47,60,127,35,3,67,56,229,PG
1997,43,43,406,70,143,0,0,70,143,21,31,42,47,89,22,6,19,28,40,161,C
1997,24,76,961,103,202,0,1,103,201,46,76,83,112,195,34,41,48,32,150,252,PF
1997,28,82,3213,706,1482,119,380,587,1102,254,355,106,272,378,583,197,13,215,208,1785,PG
1997,27,72,2291,402,1011,128,343,274,668,109,133,54,193,247,256,105,17,157,168,1041,SG
1997,31,65,1918,233,410,0,0,233,410,99,171,251,387,638,38,32,102,87,184,565,C
1997,35,81,1976,290,661,122,309,168,352,187,229,74,226,300,103,69,49,77,134,889,C
1997,27,82,1595,217,458,49,137,168,321,79,106,24,100,124,247,98,3,111,117,562,PG
1997,25,80,2326,409,903,171,414,238,489,91,114,68,224,292,123,86,20,76,102,1080,SG
1997,27,69,2375,328,766,85,216,243,550,125,174,63,182,245,233,113,21,135,174,866,SG
1997,26,65,747,134,298,51,120,83,178,69,84,49,56,105,52,33,10,46,85,388,SG
1997,37,60,1250,239,497,42,95,197,402,139,155,36,85,121,80,28,9,68,97,659,SG
1997,37,33,600,120,260,12,39,108,221,83,92,17,36,53,31,14,5,38,49,335,SG
1997,37,27,650,119,237,30,56,89,181,56,63,19,49,68,49,14,4,30,48,324,SG
1997,33,27,273,23,43,0,0,23,43,20,25,25,40,65,6,8,9,19,30,66,PF
1997,31,82,3095,648,1366,156,424,492,942,204,291,160,371,531,467,154,45,214,213,1656,SF
1997,32,82,2893,442,967,0,6,442,961,141,251,272,500,772,178,46,80,166,298,1025,C
1997,33,82,1568,187,449,67,200,120,249,127,166,31,145,176,295,54,11,128,104,568,PG
1997,21,80,1238,186,423,1,2,185,421,92,125,105,112,217,40,26,34,109,216,465,C
1997,28,25,390,44,105,17,53,27,52,21,21,10,19,29,65,17,0,32,34,126,PG
1997,32,70,1876,263,589,112,283,151,306,155,171,36,143,179,342,67,3,161,100,793,PG
1997,29,25,874,149,339,0,1,149,338,51,71,44,167,211,48,23,48,70,76,349,C
1997,23,76,1292,179,337,0,0,179,337,81,116,109,147,256,13,29,111,56,181,439,C
1997,29,71,1207,148,350,58,140,90,210,51,58,35,80,115,94,38,4,65,97,405,SG
1997,23,75,2777,498,1025,1,11,497,1014,216,307,174,436,610,160,29,67,175,270,1213,C
1997,24,63,1432,184,470,83,227,101,243,65,87,34,85,119,226,34,9,108,159,516,PG
1997,24,50,1048,141,359,76,192,65,167,56,75,22,66,88,170,23,7,82,119,414,PG
1997,24,13,384,43,111,7,35,36,76,9,12,12,19,31,56,11,2,26,40,102,PG
1997,23,47,462,54,112,0,1,54,111,24,32,36,65,101,14,16,15,23,105,132,PF
1997,24,41,495,59,139,20,57,39,82,34,39,14,25,39,40,20,2,30,40,172,SG
1997,24,14,83,6,19,1,9,5,10,7,7,3,4,7,8,0,0,8,5,20,SG
1997,24,27,412,53,120,19,48,34,72,27,32,11,21,32,32,20,2,22,35,152,SG
1997,29,79,3362,722,1513,207,440,515,1073,464,535,67,251,318,160,72,26,177,190,2115,SF
1997,30,59,1065,131,344,42,128,89,216,26,43,25,73,98,169,54,5,62,82,330,PG
1997,31,81,3125,717,1578,204,477,513,1101,457,531,59,260,319,338,118,24,237,211,2095,SG
1997,25,76,2563,456,983,99,257,357,726,212,261,94,210,304,198,45,19,212,199,1223,SG
1997,36,12,40,6,15,0,0,6,15,10,14,2,8,10,0,0,1,5,2,22,PF
1997,26,18,378,63,148,0,0,63,148,45,64,24,67,91,9,8,23,23,57,171,C
1997,22,41,681,69,182,34,89,35,93,16,26,23,48,71,65,28,9,34,85,188,SG
1997,30,81,3077,444,1043,121,350,323,693,215,309,90,231,321,261,99,66,172,251,1224,SF
1997,31,6,147,36,72,0,0,36,72,34,52,19,32,51,8,6,6,8,9,106,C
1997,24,80,3114,669,1438,63,180,606,1258,288,364,130,372,502,248,103,68,269,225,1689,SF
1997,26,69,1309,196,482,102,267,94,215,78,114,24,88,112,126,30,8,69,125,572,PG
1997,30,54,508,66,164,18,56,48,108,26,35,6,41,47,73,24,2,43,60,176,PG
1997,30,15,126,17,48,6,23,11,25,5,8,2,8,10,13,5,2,11,12,45,PG
1997,30,12,87,16,34,3,10,13,24,1,4,1,6,7,8,1,0,5,8,36,PG
1997,30,27,295,33,82,9,23,24,59,20,23,3,27,30,52,18,0,27,40,95,PG
1997,35,55,1947,128,286,5,19,123,267,50,88,320,563,883,170,32,19,111,172,311,PF
1997,24,17,107,14,48,3,11,11,37,9,19,7,7,14,6,3,1,11,10,40,SF
1997,25,56,1397,212,404,25,66,187,338,102,170,120,184,304,37,42,69,53,140,551,PF
1997,25,81,2480,408,884,65,180,343,704,191,288,137,274,411,222,88,61,221,272,1072,SF
1997,23,82,1848,244,483,1,1,243,482,54,94,139,247,386,46,21,163,86,214,543,PF
1997,27,69,735,87,185,0,1,87,184,91,130,56,107,163,42,17,38,51,123,265,C
1997,24,66,1188,172,377,21,72,151,305,117,156,27,94,121,155,57,18,107,136,482,SF
1997,22,54,525,61,128,0,2,61,126,38,62,70,94,164,32,28,17,41,114,160,PF
1997,30,62,858,62,146,0,2,62,144,94,117,52,102,154,25,23,11,47,100,218,SF
1997,30,1,29,4,10,0,0,4,10,4,4,1,0,1,1,0,0,3,3,12,SF
1997,30,36,509,37,96,0,2,37,94,62,78,33,62,95,14,11,9,22,55,136,SF
1997,30,25,320,21,40,0,0,21,40,28,35,18,40,58,10,12,2,22,42,70,SF
1997,24,42,737,79,174,0,2,79,172,31,61,102,132,234,31,24,44,29,97,189,C
1997,24,1,5,0,1,0,0,0,1,0,0,0,0,0,0,0,0,0,0,0,C
1997,24,41,732,79,173,0,2,79,171,31,61,102,132,234,31,24,44,29,97,189,C
1997,26,81,2525,297,620,108,264,189,356,171,244,79,252,331,123,129,27,94,237,873,SF
1997,32,69,1762,328,658,49,132,279,526,223,287,114,433,547,146,63,84,151,203,928,C
1997,26,23,154,12,33,0,0,12,33,13,18,6,19,25,10,2,13,12,17,37,C
1997,23,8,69,9,23,1,3,8,20,0,0,1,7,8,2,3,0,2,11,19,SF
1997,23,6,62,8,19,1,2,7,17,0,0,0,7,7,1,2,0,2,11,17,SF
1997,23,2,7,1,4,0,1,1,3,0,0,1,0,1,1,1,0,0,0,2,SF
1997,37,45,540,47,120,0,1,47,119,39,52,41,84,125,14,15,16,27,74,133,PF
1997,29,7,29,6,7,0,0,6,7,1,2,1,2,3,0,0,0,5,5,13,C
1997,28,15,116,13,36,1,2,12,34,7,8,9,13,22,4,1,9,7,22,34,C
1997,34,61,2192,356,724,57,161,299,563,253,316,87,307,394,266,63,16,150,151,1022,SF
1997,25,16,55,8,17,0,0,8,17,3,6,3,6,9,3,1,1,4,14,19,PF
1997,35,79,1440,163,379,73,188,90,191,127,151,21,97,118,99,46,16,53,72,526,SG
1997,28,66,2166,298,749,147,373,151,376,80,101,40,163,203,139,74,19,81,138,823,SF
1997,24,8,32,0,8,0,4,0,4,1,2,1,5,6,3,2,0,2,5,1,SF
1997,24,16,50,8,16,0,0,8,16,4,11,8,8,16,0,0,3,0,6,20,C
1997,26,80,2456,373,942,79,222,294,720,254,290,59,179,238,165,124,45,154,185,1079,SG
1997,31,74,2615,460,907,0,3,460,904,357,500,274,427,701,92,49,107,218,275,1277,C
1997,30,77,1867,189,516,63,194,126,322,111,140,47,147,194,319,67,26,170,197,552,PG
1997,28,41,521,45,136,7,30,38,106,42,48,30,74,104,57,8,13,34,63,139,SF
1997,24,48,395,31,93,1,4,30,89,28,40,36,56,92,31,5,5,35,44,91,PF
1997,26,26,406,82,149,0,2,82,147,39,75,40,55,95,21,9,6,29,34,203,PF
1997,31,19,329,34,84,0,1,34,83,20,26,18,47,65,14,13,22,22,44,88,PF
1997,21,80,3086,587,1293,12,46,575,1247,307,377,261,418,679,125,74,86,192,244,1493,PF
1997,31,48,765,101,239,59,135,42,104,39,45,4,40,44,116,19,0,71,30,300,PG
1997,31,9,64,8,20,5,10,3,10,2,2,0,5,5,10,1,0,3,2,23,PG
1997,31,6,47,6,13,3,5,3,8,2,2,1,1,2,4,0,0,6,3,17,PG
1997,31,33,654,87,206,51,120,36,86,35,41,3,34,37,102,18,0,62,25,260,PG
1997,24,81,2526,202,375,0,0,202,375,128,258,257,512,769,191,82,60,130,251,532,PF
1997,27,72,2818,491,1145,130,388,361,757,333,393,90,148,238,305,62,23,176,173,1445,SG
1997,25,8,60,6,18,1,6,5,12,1,1,2,8,10,4,1,0,4,9,14,SG
1997,28,69,1291,138,337,32,99,106,238,38,59,38,56,94,150,48,19,73,110,346,PG
1997,30,52,1518,356,733,2,8,354,725,173,217,105,256,361,67,22,59,126,175,887,C
1997,23,67,775,74,164,4,15,70,149,47,66,17,53,70,159,37,3,48,94,199,PG
1997,27,1,5,0,1,0,0,0,1,0,0,0,0,0,0,1,0,1,0,0,C
1997,29,73,1558,139,284,0,0,139,284,94,161,157,259,416,22,34,50,88,275,372,C
1997,29,1,19,2,2,0,0,2,2,0,0,5,1,6,1,0,0,1,2,4,C
1997,29,72,1539,137,282,0,0,137,282,94,161,152,258,410,21,34,50,87,273,368,C
1997,26,80,3353,649,1444,147,415,502,1029,493,585,58,308,366,507,132,45,322,153,1938,SG
1997,22,81,3166,533,1308,102,342,431,966,511,667,156,182,338,253,93,63,316,219,1679,SG
1997,31,77,2042,369,856,150,407,219,449,173,225,36,169,205,217,90,11,158,196,1061,SG
1997,26,2,12,1,4,0,2,1,2,1,2,0,3,3,2,1,1,2,1,3,SF
1997,24,2,9,1,5,1,3,0,2,0,0,2,1,3,0,3,0,3,3,3,PF
1997,28,70,982,112,252,9,37,103,215,67,93,75,96,171,52,31,23,63,108,300,SF
1997,26,52,1788,251,603,70,182,181,421,202,234,74,143,217,133,60,20,101,119,774,SG
1997,34,82,2896,416,759,76,180,340,579,275,325,45,183,228,860,166,15,248,194,1183,PG
1997,23,81,3311,564,1407,176,496,388,911,330,401,86,244,330,709,123,13,288,162,1634,PG
1997,23,28,759,102,256,28,92,74,164,65,80,21,69,90,68,27,5,66,75,297,SG
1997,26,31,153,25,60,0,1,25,59,12,21,16,21,37,1,4,10,15,17,62,PF
1997,30,82,2997,515,1105,13,77,502,1028,367,497,95,240,335,727,143,14,270,166,1410,PG
1997,28,82,2004,262,586,0,13,262,573,175,218,174,345,519,73,47,20,102,196,699,PF
1997,23,82,2269,253,587,53,164,200,423,196,319,76,232,308,390,90,33,181,218,755,SG
1997,28,70,662,54,121,0,1,54,120,45,61,56,109,165,17,16,32,41,119,153,C
1997,26,13,218,32,71,0,0,32,71,20,29,20,29,49,14,6,11,21,35,84,C
1997,27,19,77,9,24,2,12,7,12,1,1,3,10,13,8,2,1,6,7,21,SG
1997,24,18,374,39,105,0,1,39,104,35,46,31,76,107,9,12,9,25,67,113,PF
1997,26,67,1055,162,406,97,244,65,162,24,38,18,78,96,180,55,2,87,126,445,PG
1997,26,2,8,0,1,0,0,0,1,0,0,0,0,0,1,0,0,1,1,0,PG
1997,26,65,1047,162,405,97,244,65,161,24,38,18,78,96,179,55,2,86,125,445,PG
1997,35,26,140,3,19,0,0,3,19,4,6,7,27,34,2,3,6,9,33,10,C
1997,35,17,105,3,16,0,0,3,16,1,2,5,21,26,0,3,6,7,26,7,C
1997,35,9,35,0,3,0,0,0,3,3,4,2,6,8,2,0,0,2,7,3,C
1997,34,79,2661,419,787,0,2,419,785,198,303,226,396,622,133,59,17,145,298,1036,C
1997,35,21,334,28,74,8,20,20,54,6,8,5,19,24,40,15,3,13,29,70,SG
1997,32,53,778,158,371,0,0,158,371,30,48,35,85,120,20,8,21,36,111,346,PF
1997,26,5,72,3,8,0,0,3,8,1,8,2,7,9,1,2,1,2,12,7,C
1997,22,82,1918,361,674,0,11,361,663,160,229,156,272,428,87,48,35,129,186,882,PF
1997,25,79,2937,432,1075,177,468,255,607,165,200,44,182,226,672,75,10,212,110,1206,PG
1997,23,35,298,31,72,0,0,31,72,19,30,35,60,95,7,8,15,29,43,81,PF
1997,28,82,2838,542,1084,2,12,540,1072,134,191,222,595,817,110,85,25,137,241,1220,PF
1997,33,53,766,78,139,0,0,78,139,25,37,57,111,168,14,10,67,52,121,181,C
1997,20,82,2970,576,1354,52,159,524,1195,231,366,288,453,741,262,105,53,230,271,1435,PF
1997,20,43,602,83,187,0,1,83,186,48,74,47,100,147,17,15,22,39,71,214,PF
1997,22,34,197,16,46,0,0,16,46,6,20,25,33,58,2,8,11,18,27,38,PF
1997,22,68,787,122,236,2,4,120,232,79,110,51,104,155,37,21,25,76,102,325,SF
1997,22,62,1892,380,681,9,33,371,648,169,265,122,297,419,74,48,59,114,198,938,PF
1997,26,59,1041,148,325,57,148,91,177,49,62,21,86,107,113,28,3,61,75,402,SG
1997,26,79,1763,133,337,48,154,85,183,95,125,45,175,220,326,83,15,147,188,409,PG
1997,24,23,340,31,72,4,12,27,60,12,16,18,29,47,33,22,4,24,34,78,SF
1997,24,13,129,11,25,1,3,10,22,10,12,4,14,18,10,11,2,9,16,33,SF
1997,24,10,211,20,47,3,9,17,38,2,4,14,15,29,23,11,2,15,18,45,SF
1997,26,82,2949,398,811,1,6,397,805,206,279,219,460,679,140,74,86,137,187,1003,SF
1997,23,72,2806,604,1167,60,151,544,1016,177,313,238,505,743,331,122,137,230,258,1445,PF
1997,33,61,783,118,237,0,2,118,235,44,53,46,83,129,41,10,11,31,132,280,C
1997,26,6,31,3,7,0,0,3,7,3,3,3,3,6,0,2,1,2,10,9,C
1997,26,74,2991,456,974,103,286,353,688,225,288,67,197,264,537,162,13,211,221,1240,PG
1997,29,68,1920,226,484,15,45,211,439,64,94,37,111,148,113,61,24,66,218,531,SG
1997,36,70,959,100,180,0,0,100,180,27,56,69,117,186,19,11,55,52,142,227,C
1997,34,3,22,2,4,0,0,2,4,0,0,0,3,3,3,0,0,1,5,4,PG
1997,27,27,259,18,55,12,36,6,19,11,15,2,10,12,36,11,0,17,23,59,PG
1997,25,82,1117,139,330,58,163,81,167,94,113,13,91,104,182,49,4,68,100,430,PG
1997,37,63,1945,397,953,70,239,327,714,281,350,169,233,402,119,39,31,135,100,1145,SF
1997,33,80,2202,323,759,66,203,257,556,136,190,59,114,173,173,54,12,123,144,848,SG
1997,25,1,10,3,5,0,0,3,5,0,0,2,3,5,0,0,3,4,0,6,C
1997,25,32,553,82,143,0,1,82,142,33,49,60,78,138,15,16,26,28,72,197,PF
1997,36,74,1496,175,326,0,1,175,325,115,179,166,231,397,53,40,38,79,204,465,PF
1997,24,72,2435,374,820,2,8,372,812,328,436,126,203,329,129,72,13,139,213,1078,SG
1997,38,21,184,18,46,0,1,18,45,3,4,9,22,31,5,4,5,5,18,39,PF
1997,34,68,2137,204,416,0,2,204,414,133,198,178,384,562,100,67,88,66,176,541,C
1997,28,41,1432,221,540,0,4,221,536,108,183,242,311,553,51,24,36,82,158,550,PF
1997,23,33,177,20,51,0,0,20,51,9,17,22,28,50,7,13,1,13,18,49,PF
1997,27,19,264,20,31,0,0,20,31,5,7,28,41,69,4,6,8,18,49,45,C
1997,25,65,1345,234,460,0,1,234,459,120,186,98,108,206,91,55,52,116,161,588,SF
1997,32,13,200,29,76,9,34,20,42,9,12,5,26,31,10,8,4,12,33,76,SF
1997,32,2,33,2,9,0,1,2,8,1,2,1,6,7,2,0,0,2,5,5,SF
1997,32,11,167,27,67,9,33,18,34,8,10,4,20,24,8,8,4,10,28,71,SF
1997,28,62,1317,162,318,0,2,162,316,38,55,155,242,397,41,44,41,50,206,362,C
1997,26,73,2647,419,982,175,437,244,545,186,243,103,264,367,197,97,62,174,282,1199,SF
1997,23,79,1992,371,745,0,3,371,742,173,251,139,187,326,124,60,49,157,263,915,SF
1997,34,75,1964,350,728,2,14,348,714,140,202,146,415,561,71,42,32,119,216,842,PF
1997,33,65,929,89,214,25,71,64,143,33,40,23,51,74,80,44,5,37,108,236,SG
1997,22,47,569,79,193,26,77,53,116,27,40,63,74,137,45,14,6,49,101,211,SF
1997,32,56,525,40,89,1,7,39,82,14,19,32,80,112,20,14,11,14,105,95,C
1997,32,46,240,20,38,5,15,15,23,12,18,5,22,27,13,7,6,6,36,57,PF
1997,31,4,81,11,20,0,3,11,17,0,1,4,3,7,11,3,0,5,10,22,PG
1997,21,77,1936,236,491,1,4,235,487,88,150,206,265,471,49,48,60,79,211,561,C
1997,24,60,1009,161,403,0,1,161,402,68,133,79,107,186,28,15,50,93,146,390,C
1997,23,52,376,49,118,0,2,49,116,45,57,35,51,86,14,5,3,27,61,143,C
1997,23,36,288,33,85,0,2,33,83,25,32,25,38,63,9,4,3,23,44,91,C
1997,23,16,88,16,33,0,0,16,33,20,25,10,13,23,5,1,0,4,17,52,C
1998,28,31,530,103,273,5,31,98,242,16,16,6,31,37,58,16,1,19,31,227,PG
1998,23,59,959,144,357,4,19,140,338,84,125,44,72,116,51,35,13,65,81,376,SG
1998,21,82,2950,653,1347,21,51,632,1296,502,640,227,354,581,213,89,76,257,201,1829,SF
1998,24,60,1298,171,400,66,176,105,224,80,102,17,129,146,209,70,11,112,98,488,PG
1998,24,37,501,60,145,20,64,40,81,25,37,7,40,47,71,25,5,47,53,165,PG
1998,24,23,797,111,255,46,112,65,143,55,65,10,89,99,138,45,6,65,45,323,PG
1998,22,82,3287,563,1315,134,368,429,947,342,391,127,278,405,356,111,12,263,244,1602,SG
1998,23,66,1839,239,586,17,84,222,502,275,315,55,132,187,227,86,13,128,136,770,SF
1998,33,50,398,36,81,0,5,36,76,16,41,39,79,118,15,19,10,17,85,88,C
1998,27,61,1858,268,674,57,160,211,514,153,194,39,134,173,345,87,1,143,135,746,PG
1998,27,45,1472,204,527,47,133,157,394,112,145,36,98,134,245,61,1,114,99,567,PG
1998,27,16,386,64,147,10,27,54,120,41,49,3,36,39,100,26,0,29,36,179,PG
1998,30,58,1701,343,754,77,214,266,540,127,199,98,199,297,119,72,23,85,98,890,SF
1998,24,82,1602,269,500,7,32,262,468,136,185,86,141,227,89,66,18,91,145,681,SG
1998,23,41,680,92,231,3,16,89,215,53,74,53,104,157,35,31,27,41,95,240,C
1998,30,80,1021,150,349,66,159,84,190,53,80,18,93,111,205,64,3,91,97,419,PG
1998,30,66,831,105,213,9,35,96,178,42,50,16,60,76,150,29,0,42,74,261,PG
1998,30,4,59,6,19,0,1,6,18,5,7,4,3,7,6,4,0,7,6,17,PG
1998,30,62,772,99,194,9,34,90,160,37,43,12,57,69,144,25,0,35,68,244,PG
1998,29,48,1236,156,380,25,68,131,312,105,123,65,94,159,236,58,5,112,96,442,PG
1998,31,30,443,19,54,0,2,19,52,28,39,21,47,68,38,19,5,35,39,66,SG
1998,30,46,681,39,122,21,74,18,48,12,19,28,73,101,29,27,12,26,107,111,SF
1998,29,71,1445,154,372,1,7,153,365,94,156,104,131,235,88,57,32,81,144,403,SG
1998,28,78,2266,406,871,0,8,406,863,243,363,199,358,557,175,61,56,206,231,1055,C
1998,28,52,1371,252,532,0,3,252,529,155,228,119,211,330,87,43,34,117,162,659,C
1998,28,26,895,154,339,0,5,154,334,88,135,80,147,227,88,18,22,89,69,396,C
1998,26,82,2944,631,1164,1,7,630,1157,311,526,286,370,656,152,91,86,174,278,1574,C
1998,34,68,2243,361,744,18,84,343,660,296,397,241,553,794,217,71,28,147,187,1036,PF
1998,30,80,1686,281,609,100,246,181,363,122,144,28,125,153,286,83,6,107,124,784,PG
1998,26,58,1600,213,506,90,229,123,277,115,134,29,142,171,153,64,27,104,118,631,SG
1998,26,41,1341,190,444,78,195,112,249,103,122,27,116,143,132,50,23,95,88,561,SG
1998,26,17,259,23,62,12,34,11,28,12,12,2,26,28,21,14,4,9,30,70,SG
1998,24,27,256,18,38,9,21,9,17,11,13,5,30,35,49,10,1,30,28,56,PG
1998,28,49,374,38,104,18,61,20,43,27,29,8,29,37,51,24,3,22,33,121,SG
1998,21,65,1506,234,525,3,14,231,511,73,104,138,213,351,60,54,69,98,199,544,PF
1998,26,59,738,73,159,2,4,71,155,43,59,27,63,90,98,33,7,70,100,191,PG
1998,33,14,197,22,41,0,0,22,41,19,30,18,35,53,3,4,4,12,26,63,C
1998,24,45,354,80,135,1,2,79,133,16,44,60,66,126,18,19,11,21,61,177,PF
1998,29,77,1123,152,408,55,170,97,238,61,74,60,143,203,25,35,20,52,157,420,SF
1998,29,53,799,102,269,41,119,61,150,37,44,42,99,141,17,26,16,39,120,282,SF
1998,29,24,324,50,139,14,51,36,88,24,30,18,44,62,8,9,4,13,37,138,SF
1998,25,82,1547,201,480,21,70,180,410,112,131,28,94,122,281,85,5,111,193,535,PG
1998,21,80,2216,280,749,107,325,173,424,226,266,62,128,190,314,107,4,174,172,893,PG
1998,21,51,1296,177,454,64,189,113,265,147,180,40,73,113,217,77,2,118,118,565,PG
1998,21,29,920,103,295,43,136,60,159,79,86,22,55,77,97,30,2,56,54,328,PG
1998,30,70,2700,368,938,90,334,278,604,95,134,81,260,341,469,183,21,176,122,921,PG
1998,29,70,1029,107,187,0,4,107,183,39,78,114,184,298,37,29,25,51,157,253,PF
1998,33,61,1570,141,323,4,16,137,307,61,68,30,102,132,331,67,3,105,58,347,PG
1998,33,2,16,2,5,0,0,2,5,2,2,0,1,1,4,2,0,1,2,6,PG
1998,33,59,1554,139,318,4,16,135,302,59,66,30,101,131,327,65,3,104,56,341,PG
1998,24,5,11,0,4,0,0,0,4,0,0,2,4,6,1,0,2,3,3,0,PF
1998,23,6,17,2,6,0,1,2,5,6,6,2,2,4,1,0,0,3,3,10,SF
1998,26,61,1305,122,298,20,59,102,239,76,122,79,95,174,81,87,29,52,174,340,SF
1998,34,27,224,32,59,3,4,29,55,8,9,9,17,26,11,6,2,7,25,75,SG
1998,25,64,1822,300,711,1,3,299,708,130,180,164,354,518,60,51,214,96,214,731,C
1998,27,50,1784,339,731,31,93,308,638,132,156,23,153,176,387,111,17,145,120,841,PG
1998,27,6,30,4,11,1,3,3,8,1,2,0,2,2,2,2,1,1,1,10,SF
1998,32,43,312,28,66,5,11,23,55,18,20,6,24,30,49,18,3,12,25,79,PG
1998,29,77,1202,161,372,2,8,159,364,63,87,57,126,183,55,23,13,51,100,387,SF
1998,29,72,1719,246,562,108,271,138,291,58,71,24,128,152,154,82,23,73,123,658,SG
1998,29,41,811,109,255,43,113,66,142,19,28,10,52,62,53,44,6,32,76,280,SG
1998,29,31,908,137,307,65,158,72,149,39,43,14,76,90,101,38,17,41,47,378,SG
1998,28,74,2362,278,590,0,0,278,590,151,197,235,400,635,103,66,98,97,264,707,PF
1998,29,71,1147,116,302,0,5,116,297,56,78,34,60,94,151,71,12,63,118,288,PG
1998,25,38,622,49,141,22,61,27,80,42,62,14,42,56,100,25,3,52,55,162,PG
1998,19,79,2056,391,913,75,220,316,693,363,457,79,163,242,199,74,40,157,180,1220,SG
1998,32,70,1110,109,225,0,1,109,224,73,95,92,152,244,46,36,15,58,180,291,C
1998,29,74,608,85,176,25,65,60,111,3,6,24,53,77,49,22,15,21,47,198,SF
1998,30,67,1190,175,389,96,231,79,158,20,27,25,121,146,60,31,24,39,104,466,SF
1998,27,80,1096,159,375,51,144,108,231,47,64,80,118,198,65,64,37,50,131,416,SF
1998,29,13,43,8,21,3,9,5,12,8,12,3,6,9,1,2,2,1,7,27,SF
1998,27,18,206,15,47,1,6,14,41,6,10,6,16,22,18,8,0,8,26,37,SG
1998,24,80,1423,226,466,0,2,226,464,131,200,160,184,344,67,25,20,105,181,583,PF
1998,24,51,710,100,199,0,1,100,198,68,103,76,97,173,36,13,17,48,92,268,PF
1998,24,29,713,126,267,0,1,126,266,63,97,84,87,171,31,12,3,57,89,315,PF
1998,36,79,1201,43,84,0,1,43,83,20,36,115,193,308,32,45,44,23,105,106,C
1998,23,63,2002,308,747,0,2,308,745,149,244,203,263,466,111,68,230,134,200,765,C
1998,29,81,1784,289,624,1,2,288,622,237,342,143,312,455,78,35,102,115,209,816,PF
1998,36,66,1086,151,325,0,0,151,325,76,98,42,89,131,48,11,53,48,195,378,PF
1998,23,51,1165,190,452,40,127,150,325,84,99,43,112,155,85,17,11,69,129,504,SG
1998,28,75,2606,510,1156,15,80,495,1076,436,507,73,155,228,603,121,20,269,262,1471,PG
1998,23,74,1007,98,229,0,3,98,226,86,125,91,161,252,23,29,94,44,164,282,C
1998,29,37,363,37,89,0,0,37,89,15,26,29,70,99,5,7,27,18,73,89,C
1998,28,47,990,204,415,21,70,183,345,107,145,75,146,221,60,33,16,72,88,536,SF
1998,28,35,626,129,258,15,50,114,208,60,84,51,98,149,35,22,8,39,59,333,SF
1998,28,12,364,75,157,6,20,69,137,47,61,24,48,72,25,11,8,33,29,203,SF
1998,38,1,10,2,2,0,0,2,2,2,2,0,2,2,0,2,0,1,2,6,PF
1998,30,68,2263,408,956,120,311,288,645,146,187,30,143,173,203,71,14,116,102,1082,SG
1998,26,82,2841,448,981,15,53,433,928,139,215,82,242,324,173,96,36,104,264,1050,SG
1998,29,82,1420,156,359,54,130,102,229,39,59,77,229,306,104,53,37,62,158,405,PF
1998,30,68,1599,149,354,27,87,122,267,104,126,29,133,162,268,56,6,103,179,429,PG
1998,27,78,2939,458,1071,100,307,358,764,271,327,94,310,404,282,190,57,228,198,1287,SG
1998,21,58,740,93,207,0,0,93,207,46,77,63,105,168,19,12,81,38,73,232,C
1998,30,59,2135,356,867,26,98,330,769,302,391,149,438,587,145,46,68,157,144,1040,PF
1998,29,53,1471,166,438,13,57,153,381,78,88,17,106,123,248,51,13,89,135,423,PG
1998,24,23,103,21,55,9,20,12,35,8,14,7,7,14,3,6,3,8,12,59,SG
1998,30,18,209,28,62,0,0,28,62,32,44,16,30,46,12,9,5,11,27,88,C
1998,35,79,2699,328,747,49,141,279,606,101,128,78,284,362,173,105,7,86,197,806,SF
1998,22,9,33,8,21,0,4,8,17,8,9,2,4,6,0,1,1,6,3,24,SG
1998,22,40,256,46,110,1,3,45,107,57,68,20,21,41,9,12,7,18,27,150,PF
1998,22,26,243,32,86,4,13,28,73,8,14,10,35,45,8,9,5,13,32,76,PF
1998,28,26,379,29,90,6,20,23,70,32,34,4,28,32,63,10,1,42,28,96,PG
1998,36,74,1185,200,428,0,1,200,427,67,98,97,186,283,47,38,10,51,181,467,PF
1998,36,44,656,97,212,0,1,97,211,39,58,55,93,148,21,22,5,17,102,233,PF
1998,36,30,529,103,216,0,0,103,216,28,40,42,93,135,26,16,5,34,79,234,PF
1998,23,7,39,4,9,0,0,4,9,0,0,4,6,10,1,2,0,0,10,8,C
1998,23,6,38,4,9,0,0,4,9,0,0,4,4,8,1,2,0,0,10,8,C
1998,25,11,146,16,33,0,1,16,32,2,3,11,17,28,4,3,1,3,28,34,PF
1998,33,52,971,194,434,61,145,133,289,41,52,26,75,101,69,31,4,54,85,490,SG
1998,29,82,1978,196,418,4,9,192,409,147,176,26,72,98,137,56,14,77,218,543,SG
1998,22,82,2656,352,791,0,2,352,789,267,399,272,443,715,94,39,139,175,281,971,C
1998,22,74,1956,228,548,11,52,217,496,112,170,22,121,143,334,55,10,164,88,579,SG
1998,30,6,82,12,29,2,9,10,20,8,10,4,3,7,4,3,2,4,4,34,SG
1998,25,10,60,4,18,0,0,4,18,4,8,10,7,17,1,0,2,2,9,12,C
1998,29,82,2191,254,528,0,3,254,525,277,398,192,368,560,61,45,72,103,234,785,PF
1998,25,7,13,2,10,0,0,2,10,0,0,6,0,6,0,1,0,0,3,4,PF
1998,28,78,2174,273,498,0,0,273,498,80,172,233,378,611,70,51,87,73,209,626,C
1998,29,45,599,63,142,27,72,36,70,31,37,10,37,47,59,17,3,52,55,184,PG
1998,27,81,2378,350,767,101,230,249,537,97,116,34,135,169,157,43,5,88,117,898,SG
1998,24,71,906,109,244,0,6,109,238,64,101,64,94,158,73,49,18,91,95,282,SF
1998,30,74,1705,127,256,0,1,127,255,69,119,209,271,480,30,41,24,56,193,323,PF
1998,28,5,69,11,31,2,12,9,19,6,9,4,2,6,7,7,0,3,10,30,SG
1998,24,81,1523,169,340,0,1,169,339,101,168,180,212,392,59,85,49,84,277,439,C
1998,26,77,1410,180,451,50,132,130,319,79,99,21,85,106,196,52,4,96,150,489,PG
1998,31,54,1721,211,479,17,39,194,440,74,93,13,139,152,183,39,6,53,113,513,SG
1998,28,78,2619,531,1040,1,3,530,1037,198,280,223,472,695,94,67,55,181,252,1261,C
1998,24,77,1681,314,798,42,157,272,641,111,151,38,134,172,172,73,12,109,96,781,PG
1998,24,3,34,3,4,1,1,2,3,1,2,0,2,2,3,0,0,4,8,8,PG
1998,24,74,1647,311,794,41,156,270,638,110,149,38,132,170,169,73,12,105,88,773,PG
1998,29,64,1805,267,536,3,14,264,522,130,188,183,335,518,172,83,94,114,179,667,C
1998,31,80,1699,255,515,14,46,241,469,115,172,52,83,135,319,55,7,110,156,639,PG
1998,35,70,2473,452,1059,106,334,346,725,277,346,105,241,346,382,126,42,189,193,1287,SG
1998,32,51,858,58,143,0,0,58,143,41,92,108,167,275,21,13,51,44,139,157,C
1998,34,72,2326,329,791,158,426,171,365,127,154,14,90,104,253,44,2,84,99,943,SG
1998,25,7,47,6,12,2,4,4,8,0,3,1,4,5,5,0,0,5,5,14,SG
1998,21,82,3204,706,1287,0,10,706,1277,319,482,274,703,977,224,55,206,279,254,1731,PF
1998,31,42,547,75,175,16,46,59,129,52,59,25,50,75,16,17,0,29,43,218,SG
1998,24,52,623,93,216,3,10,90,206,88,111,20,35,55,139,51,1,66,69,277,PG
1998,32,81,1968,326,742,40,120,286,622,180,215,61,156,217,201,86,27,134,183,872,SG
1998,32,39,487,57,165,6,15,51,150,30,35,20,34,54,39,26,1,30,28,150,SG
1998,32,27,352,37,106,4,11,33,95,13,15,11,23,34,26,21,0,20,20,91,SG
1998,32,12,135,20,59,2,4,18,55,17,20,9,11,20,13,5,1,10,8,59,SG
1998,25,82,1726,229,519,48,118,181,401,127,149,25,141,166,346,54,13,160,182,633,PG
1998,34,73,1988,206,456,55,189,151,267,145,174,39,117,156,221,81,8,100,115,612,SF
1998,29,36,1012,122,303,34,90,88,213,56,78,16,108,124,62,24,14,57,92,334,SF
1998,37,79,1939,348,700,127,274,221,426,111,142,51,133,184,89,60,5,74,128,934,SF
1998,27,27,344,62,111,0,4,62,107,40,63,27,23,50,18,19,4,19,53,164,SF
1998,27,76,2575,410,1007,57,201,353,806,206,256,146,398,544,213,65,49,173,226,1083,SF
1998,30,33,447,40,70,0,0,40,70,20,34,52,57,109,31,20,31,28,90,100,PF
1998,24,72,893,123,312,29,87,94,225,46,57,49,88,137,55,29,13,38,101,321,SF
1998,24,44,561,77,206,12,45,65,161,40,48,31,54,85,31,22,8,24,57,206,SF
1998,24,28,332,46,106,17,42,29,64,6,9,18,34,52,24,7,5,14,44,115,SF
1998,35,26,848,203,403,0,2,203,401,134,186,59,206,265,28,16,58,77,74,540,C
1998,28,27,169,17,53,2,9,15,44,31,39,16,16,32,5,10,4,9,23,67,C
1998,23,45,450,39,90,4,13,35,77,20,41,45,79,124,16,25,17,21,67,102,PF
1998,32,50,461,41,111,0,6,41,105,12,22,25,22,47,26,21,6,18,50,94,SF
1998,31,69,1034,113,286,33,99,80,187,32,40,23,91,114,59,26,17,53,118,291,PF
1998,24,82,3394,675,1505,87,244,588,1261,326,416,150,288,438,405,132,30,219,163,1763,SF
1998,23,82,1760,164,378,31,81,133,297,115,152,38,155,193,333,75,5,119,126,474,PG
1998,21,80,1811,276,611,1,3,275,608,263,339,182,266,448,76,44,30,157,314,816,PF
1998,29,78,1446,186,418,2,9,184,409,67,87,85,188,273,51,15,28,68,187,441,C
1998,28,82,2709,363,771,86,265,277,506,171,230,78,280,358,276,100,48,201,309,983,SF
1998,22,55,656,69,170,0,1,69,169,27,62,73,111,184,14,13,52,50,94,165,C
1998,23,57,613,86,205,0,4,86,201,55,80,61,135,196,10,6,16,37,89,227,C
1998,27,52,1094,191,390,1,7,190,383,110,162,80,154,234,63,19,15,62,56,493,PF
1998,22,38,293,23,70,4,14,19,56,3,7,7,17,24,45,21,4,25,50,53,PG
1998,21,82,3222,635,1293,3,16,632,1277,245,332,222,564,786,348,139,150,192,224,1518,PF
1998,31,82,2632,242,565,0,0,242,565,114,176,227,417,644,90,57,133,84,197,598,C
1998,23,28,225,22,65,5,14,17,51,19,25,3,16,19,28,7,1,15,22,68,SG
1998,30,57,1359,248,545,1,4,247,541,159,265,118,216,334,53,52,29,99,152,656,PF
1998,24,62,685,56,169,12,40,44,129,28,56,19,48,67,74,37,12,42,95,152,PG
1998,28,78,1839,358,709,1,11,357,698,168,236,196,325,521,78,68,87,111,191,885,C
1998,29,81,2733,418,974,26,101,392,873,225,327,112,279,391,200,156,64,124,268,1087,SF
1998,33,82,2114,327,676,0,4,327,672,267,333,146,293,439,104,65,37,148,177,921,PF
1998,26,82,2212,269,636,63,164,206,472,150,186,40,107,147,277,86,7,85,149,751,PG
1998,27,6,56,7,12,0,3,7,9,2,2,0,1,1,6,1,0,10,7,16,SG
1998,25,61,1921,283,557,0,1,283,556,171,228,197,358,555,86,44,45,110,184,737,SF
1998,32,22,359,43,93,7,19,36,74,12,14,8,40,48,84,17,2,24,30,105,PG
1998,32,65,895,75,196,1,6,74,190,19,30,60,108,168,39,23,15,26,94,170,SF
1998,32,76,2803,393,857,0,7,393,850,135,199,228,390,618,172,81,79,88,180,921,C
1998,22,30,472,77,202,18,46,59,156,55,65,9,36,45,34,15,11,30,73,227,SG
1998,32,5,34,4,11,2,6,2,5,0,0,0,4,4,2,2,0,4,7,10,SG
1998,32,1,11,0,4,0,3,0,1,0,0,0,0,0,1,0,0,2,0,0,SG
1998,32,4,23,4,7,2,3,2,4,0,0,0,4,4,1,2,0,2,7,10,SG
1998,34,82,2649,242,534,0,4,242,530,116,162,219,449,668,123,78,27,68,157,600,PF
1998,27,21,124,5,23,0,2,5,21,15,20,1,6,7,16,4,0,8,11,25,PG
1998,23,9,34,4,14,4,12,0,2,2,2,0,4,4,0,3,1,3,6,14,SF
1998,28,41,1582,319,635,2,17,317,618,183,223,106,250,356,167,61,22,109,102,823,SF
1998,34,16,51,5,18,0,1,5,17,12,21,5,10,15,0,0,1,4,9,22,C
1998,24,71,635,55,104,0,0,55,104,35,74,72,59,131,16,21,25,37,118,145,SF
1998,30,57,1140,127,246,0,1,127,245,92,132,100,171,271,36,15,17,48,127,346,PF
1998,29,8,26,3,6,0,0,3,6,0,0,3,3,6,1,2,1,3,8,6,SF
1998,26,19,625,103,273,15,50,88,223,90,118,8,68,76,68,28,15,46,45,311,SG
1998,31,81,3031,558,1296,155,442,403,854,257,329,48,251,299,672,136,16,224,200,1528,PG
1998,36,66,1761,226,542,59,164,167,378,55,79,23,80,103,233,72,10,101,140,566,SG
1998,34,82,2284,293,665,16,84,277,581,162,216,107,183,290,241,108,48,91,181,764,PG
1998,24,58,903,129,266,0,1,129,265,92,122,73,134,207,24,10,27,47,112,350,PF
1998,27,50,671,69,177,12,39,57,138,41,55,21,31,52,42,42,5,21,77,191,SG
1998,31,82,2597,280,636,125,301,155,335,177,204,71,263,334,221,148,17,102,153,862,SG
1998,25,69,2000,365,753,3,6,362,747,253,388,200,242,442,73,42,36,110,175,986,PF
1998,22,82,2527,348,725,0,4,348,721,136,190,71,254,325,168,96,45,165,238,832,SF
1998,23,48,737,58,149,0,5,58,144,47,57,33,110,143,41,26,9,31,60,163,PF
1998,29,23,65,13,26,3,8,10,18,7,7,0,2,2,4,1,0,6,9,36,PG
1998,31,58,516,76,175,0,1,76,174,18,44,24,67,91,22,19,12,38,71,170,PF
1998,29,2,12,0,5,0,2,0,3,0,0,0,0,0,0,2,0,1,3,0,SF
1998,25,81,3294,615,1361,3,21,612,1340,479,647,93,530,623,551,143,53,285,196,1712,SF
1998,29,57,2064,208,418,0,1,208,417,155,255,212,396,608,88,67,30,106,230,571,PF
1998,25,65,874,85,222,32,85,53,137,59,69,14,109,123,45,40,3,22,101,261,SG
1998,23,38,530,90,221,29,77,61,144,36,58,27,66,93,33,20,6,49,83,245,PF
1998,34,80,2460,399,828,56,127,343,701,285,322,65,205,270,349,109,15,132,175,1139,SG
1998,27,72,2192,200,420,19,93,181,327,117,169,186,356,542,163,112,94,99,238,536,PF
1998,26,82,2848,571,1277,82,213,489,1064,285,335,43,231,274,212,63,24,200,207,1509,SG
1998,24,64,2559,463,991,0,2,463,989,258,358,161,288,449,208,82,23,185,225,1184,PF
1998,27,13,53,8,21,0,0,8,21,9,18,6,6,12,3,3,1,6,13,25,SF
1998,21,8,23,6,14,0,3,6,11,0,0,1,1,2,4,2,0,1,1,12,PG
1998,27,71,2505,316,826,85,265,231,561,145,196,61,186,247,224,123,10,110,174,862,PG
1998,26,61,875,93,238,5,22,88,216,59,76,12,54,66,177,23,0,86,79,250,PG
1998,26,34,417,47,115,4,15,43,100,30,37,7,29,36,80,13,0,42,36,128,PG
1998,26,27,458,46,123,1,7,45,116,29,39,5,25,30,97,10,0,44,43,122,PG
1998,22,82,2379,454,876,1,4,453,872,230,302,279,444,723,71,52,135,146,288,1139,C
1998,22,80,3150,649,1407,70,235,579,1172,390,535,86,210,296,494,176,25,244,200,1758,PG
1998,24,68,2042,310,791,21,81,289,710,149,183,78,224,302,317,105,11,184,160,790,PG
1998,30,82,2226,258,654,112,297,146,357,94,118,55,155,210,156,60,8,104,222,722,SG
1998,27,79,3046,476,1107,61,191,415,916,229,282,130,270,400,381,79,8,263,186,1242,SG
1998,27,48,1788,246,535,39,112,207,423,126,154,69,158,227,223,41,6,145,112,657,SG
1998,27,31,1258,230,572,22,79,208,493,103,128,61,112,173,158,38,2,118,74,585,SG
1998,32,82,2413,249,598,43,137,206,461,137,180,67,255,322,713,84,2,174,132,678,PG
1998,32,28,166,24,59,11,25,13,34,21,22,2,13,15,5,1,1,12,24,80,PF
1998,23,77,2266,226,609,42,128,184,481,80,110,51,120,171,329,64,6,120,188,574,PG
1998,32,75,2674,321,671,2,13,319,658,122,168,30,120,150,591,84,18,165,140,766,PG
1998,38,75,1490,227,544,66,198,161,346,113,136,50,103,153,88,32,3,62,89,633,SF
1998,30,81,2261,253,471,0,0,253,471,143,238,242,443,685,59,79,158,117,321,649,C
1998,31,50,1290,155,347,4,26,151,321,162,186,35,129,164,245,27,8,101,57,476,PG
1998,28,70,2412,429,884,15,63,414,821,214,283,175,226,401,150,40,13,127,193,1087,SF
1998,40,24,127,7,10,0,0,7,10,1,2,12,12,24,5,1,6,4,22,15,PF
1998,22,15,91,19,57,6,23,13,34,0,0,3,6,9,5,2,3,11,12,44,SF
1998,26,80,2910,486,1005,143,368,343,637,234,306,85,217,302,246,160,55,146,164,1349,SG
1998,27,14,352,52,127,2,3,50,124,14,19,50,52,102,18,10,3,16,39,120,PF
1998,34,82,3181,881,1893,30,126,851,1767,565,721,130,345,475,283,141,45,185,151,2357,SG
1998,30,57,487,54,113,0,1,54,112,41,72,57,40,97,50,35,9,30,63,149,SG
1998,27,80,2047,229,424,0,0,229,424,162,200,179,259,438,89,52,24,71,172,620,C
1998,28,80,2769,518,1164,2,8,516,1156,404,556,219,526,745,197,108,90,271,310,1442,PF
1998,34,8,47,2,9,0,0,2,9,0,0,4,2,6,3,1,2,4,10,4,PF
1998,34,3,15,0,2,0,0,0,2,0,0,0,1,1,1,0,0,0,3,0,PF
1998,34,5,32,2,7,0,0,2,7,0,0,4,1,5,2,1,2,4,7,4,PF
1998,32,50,1119,137,302,57,130,80,172,45,49,14,63,77,96,26,5,27,71,376,PG
1998,35,37,717,97,233,1,10,96,223,39,65,56,79,135,44,52,14,36,104,234,SF
1998,24,82,3118,357,859,73,233,284,626,167,209,108,402,510,745,162,26,261,142,954,PG
1998,23,77,2814,508,1154,110,263,398,891,202,250,132,230,362,176,132,37,106,152,1328,SG
1998,36,46,397,39,106,0,0,39,106,15,18,27,50,77,30,4,5,28,63,93,C
1998,22,80,2483,261,592,0,7,261,585,201,251,67,186,253,656,196,18,194,271,723,PG
1998,23,74,1503,193,438,15,55,178,383,81,103,146,219,365,104,54,82,87,253,482,C
1998,29,74,2235,383,841,63,174,320,667,155,219,121,206,327,314,76,37,154,149,984,SF
1998,28,74,2282,354,730,6,27,348,703,306,354,142,345,487,190,71,73,183,246,1020,PF
1998,31,57,692,54,143,0,1,54,142,44,57,56,97,153,16,18,27,33,101,152,C
1998,25,6,29,3,5,0,0,3,5,6,8,2,3,5,1,2,0,4,3,12,SF
1998,24,14,140,20,49,4,16,16,33,5,8,1,7,8,5,3,1,6,12,49,PG
1998,24,39,345,53,127,0,0,53,127,38,69,27,73,100,21,7,17,46,63,144,C
1998,23,17,80,9,15,0,0,9,15,8,10,8,19,27,5,4,4,2,14,26,C
1998,31,8,76,3,19,0,6,3,13,3,4,2,2,4,3,1,0,4,11,9,SG
1998,24,81,2621,363,854,153,378,210,476,141,179,72,220,292,180,58,16,99,219,1020,SG
1998,39,7,44,3,8,0,0,3,8,0,0,2,9,11,1,1,1,2,12,6,C
1998,22,12,82,3,12,0,0,3,12,4,5,1,5,6,5,7,2,6,6,10,PG
1998,24,8,42,8,21,1,3,7,18,7,10,4,14,18,1,1,3,9,14,24,C
1998,33,9,102,7,21,4,14,3,7,1,3,3,9,12,5,1,2,3,10,19,PF
1998,31,40,739,50,117,0,4,50,113,41,57,57,93,150,25,29,12,22,91,141,PF
1998,29,58,1703,277,609,0,0,277,609,109,148,113,228,341,161,34,62,130,206,663,C
1998,27,82,1493,248,516,9,30,239,486,111,158,147,215,362,122,65,41,104,161,616,SF
1998,27,57,1414,222,559,110,269,112,290,62,77,30,103,133,101,41,11,69,117,616,SF
1998,28,9,42,1,10,1,2,0,8,0,0,3,2,5,0,0,0,2,7,3,SF
1998,28,19,243,13,34,6,15,7,19,5,7,2,13,15,45,13,1,13,18,37,SG
1998,39,59,707,59,129,0,0,59,129,23,34,65,130,195,15,14,7,37,123,141,C
1998,32,72,1928,184,439,111,295,73,144,40,51,48,220,268,157,68,15,65,139,519,SG
1998,34,81,3030,780,1472,2,6,778,1466,628,825,189,645,834,316,96,70,247,237,2190,PF
1998,26,78,2217,239,586,126,346,113,240,65,78,16,126,142,219,62,5,107,99,669,PG
1998,31,70,1794,390,756,0,7,390,749,167,226,110,282,392,139,71,46,100,201,947,PF
1998,20,82,3112,513,1237,95,304,418,933,329,450,58,172,230,704,104,7,256,222,1450,PG
1998,24,73,2611,451,1090,63,201,388,889,158,216,210,418,628,159,95,73,147,226,1123,SF
1998,26,82,2299,275,730,107,293,168,437,184,217,19,145,164,331,82,10,154,198,841,PG
1998,25,48,1729,251,577,37,122,214,455,184,231,72,164,236,132,43,14,108,137,723,SF
1998,31,81,3148,389,764,0,4,389,760,261,402,177,649,826,342,68,18,146,182,1039,PF
1998,30,61,894,148,309,0,0,148,309,100,137,80,152,232,21,25,24,60,123,396,C
1998,32,42,636,103,258,37,112,66,146,48,60,14,43,57,52,16,4,40,71,291,SG
1998,32,11,169,26,78,6,26,20,52,23,26,5,8,13,12,2,1,12,20,81,SG
1998,32,31,467,77,180,31,86,46,94,25,34,9,35,44,40,14,3,28,51,210,SG
1998,27,79,1835,131,349,63,180,68,169,38,51,19,95,114,349,65,10,113,164,363,PG
1998,33,1,5,0,1,0,0,0,1,0,0,0,1,1,0,0,0,0,1,0,SF
1998,23,82,2340,295,730,54,175,241,555,144,194,141,223,364,177,110,44,141,274,788,SF
1998,30,63,1213,173,427,71,208,102,219,39,51,45,173,218,84,54,13,63,132,456,SF
1998,34,20,180,10,30,0,0,10,30,5,8,12,19,31,9,3,2,8,23,25,SF
1998,23,81,2441,497,927,0,2,497,925,231,329,206,407,613,106,100,135,142,292,1225,PF
1998,18,64,1179,179,398,14,41,165,357,79,111,105,164,269,98,49,61,66,86,451,SF
1998,25,78,1211,101,223,0,3,101,220,45,81,96,163,259,19,24,137,54,240,247,C
1998,31,57,1316,150,327,4,17,146,310,55,77,74,137,211,88,57,30,79,156,359,SF
1998,25,24,472,43,104,3,17,40,87,20,23,24,44,68,38,23,1,24,47,109,SF
1998,25,57,1341,96,277,9,46,87,231,22,32,34,129,163,137,78,12,52,117,223,SG
1998,33,18,279,23,67,15,34,8,33,1,1,13,27,40,55,14,4,12,41,62,SG
1998,21,80,2662,515,1145,3,28,512,1117,188,224,109,171,280,176,125,17,132,213,1221,SG
1998,20,33,163,39,64,3,6,36,58,11,17,10,15,25,12,10,0,21,17,92,SF
1998,26,37,228,29,52,0,0,29,52,21,39,30,40,70,3,15,3,14,41,79,PF
1998,27,64,1628,170,369,0,4,170,365,61,101,146,254,400,196,58,72,131,184,401,C
1998,32,81,2795,516,1081,164,382,352,699,382,440,46,186,232,171,78,11,128,148,1578,SG
1998,28,80,2183,292,675,40,137,252,538,152,189,120,288,408,133,45,30,107,218,776,SF
1998,30,50,782,81,206,25,81,56,125,25,33,34,118,152,39,19,9,45,129,212,PF
1998,26,69,1126,140,321,6,31,134,290,59,86,55,95,150,88,53,11,43,100,345,SG
1998,34,81,2239,371,800,15,43,356,757,243,292,118,267,385,107,64,22,66,200,1000,SF
1998,26,48,691,61,144,0,0,61,144,16,40,69,130,199,11,13,27,29,127,138,C
1998,26,20,337,30,76,0,0,30,76,7,19,28,64,92,7,7,12,15,61,67,C
1998,26,28,354,31,68,0,0,31,68,9,21,41,66,107,4,6,15,14,66,71,C
1998,32,54,538,85,207,19,62,66,145,44,61,35,79,114,24,25,17,33,61,233,SF
1998,25,8,27,3,13,0,1,3,12,3,4,1,0,1,3,0,0,1,6,9,SG
1998,27,58,1939,403,732,0,0,403,732,309,465,193,365,558,52,40,130,179,208,1115,C
1998,34,82,2177,333,692,107,243,226,449,154,164,38,211,249,186,95,39,117,186,927,SF
1998,29,82,1395,177,419,28,91,149,328,125,156,39,117,156,219,103,13,104,173,507,PG
1998,24,79,2579,473,984,54,153,419,831,220,294,172,312,484,142,118,54,171,193,1220,SF
1998,26,82,2227,449,1007,158,403,291,604,182,209,75,202,277,84,67,25,102,167,1238,SF
1998,31,82,2917,399,743,0,0,399,743,303,452,276,656,932,82,34,277,168,254,1101,C
1998,23,41,603,83,191,16,38,67,153,51,67,46,68,114,30,29,14,29,96,233,PF
1998,34,9,40,5,10,0,0,5,10,4,6,5,5,10,3,4,0,4,7,14,SG
1998,23,76,1664,268,584,81,195,187,389,74,86,32,128,160,262,63,4,98,145,691,PG
1998,27,28,249,20,57,1,1,19,56,17,30,24,45,69,9,10,3,17,38,58,PF
1998,34,74,2176,344,799,36,105,308,694,365,445,50,91,141,138,77,24,147,208,1089,SF
1998,24,13,48,5,18,0,0,5,18,8,9,4,10,14,3,2,0,3,7,18,PF
1998,22,30,234,26,69,0,3,26,66,12,15,14,19,33,17,9,1,9,15,64,SG
1998,19,60,808,112,231,0,2,112,229,45,89,80,121,201,17,15,58,55,101,269,PF
1998,25,60,2175,670,1147,0,0,670,1147,359,681,208,473,681,142,39,144,175,193,1699,C
1998,34,79,2734,307,698,0,6,307,692,97,114,218,506,724,201,123,22,126,280,711,PF
1998,35,47,1633,306,633,0,3,306,630,160,212,116,344,460,143,84,96,126,152,772,C
1998,29,5,61,7,19,0,0,7,19,1,4,3,6,9,2,1,0,1,4,15,SG
1998,28,1,10,2,4,1,2,1,2,0,0,0,2,2,1,0,0,0,1,5,SG
1998,25,35,430,37,98,0,1,37,97,49,70,9,30,39,65,13,0,44,31,123,PG
1998,25,16,214,14,42,0,0,14,42,18,25,6,15,21,32,6,0,16,16,46,PG
1998,25,19,216,23,56,0,1,23,55,31,45,3,15,18,33,7,0,28,15,77,PG
1998,24,63,1288,115,239,0,0,115,239,67,140,134,240,374,25,28,132,74,166,297,C
1998,26,82,2953,301,543,1,4,300,539,180,313,255,382,637,216,107,181,175,260,783,PF
1998,28,23,277,24,63,0,3,24,60,14,16,2,12,14,37,8,1,23,34,62,PG
1998,28,78,2348,338,728,26,70,312,658,116,197,170,412,582,219,93,38,153,231,818,SF
1998,28,12,292,33,98,3,6,30,92,25,36,8,26,34,42,20,1,38,17,94,PG
1998,22,37,196,25,63,9,28,16,35,13,20,8,18,26,19,11,3,11,17,72,SG
1998,25,79,1703,224,449,0,1,224,448,110,169,140,297,437,53,36,86,66,237,558,C
1998,29,82,3145,579,1278,134,397,445,881,279,375,77,299,376,679,185,18,229,195,1571,PG
1998,28,38,1193,190,420,53,125,137,295,36,47,37,86,123,137,61,6,51,97,469,SG
1998,28,8,202,35,72,5,19,30,53,4,6,6,14,20,23,9,0,6,16,79,SG
1998,28,30,991,155,348,48,106,107,242,32,41,31,72,103,114,52,6,45,81,390,SG
1998,32,79,1491,162,295,0,1,162,294,70,133,177,358,535,57,22,50,81,137,394,C
1998,36,81,1675,196,471,87,222,109,249,101,128,53,202,255,113,62,29,62,158,580,PF
1998,28,81,1752,241,561,17,50,224,511,92,109,21,87,108,230,90,2,128,129,591,PG
1998,33,61,1455,143,398,95,276,48,122,28,37,17,187,204,86,29,10,67,121,409,PF
1998,26,82,3198,440,957,192,447,248,510,132,170,65,298,363,188,129,49,110,108,1204,SG
1998,28,62,1887,246,552,44,114,202,438,106,140,59,157,216,187,81,18,108,181,642,SG
1998,27,67,1740,257,568,106,259,151,309,140,170,70,166,236,85,51,12,80,137,760,SG
1998,38,39,442,52,143,4,13,48,130,43,52,19,26,45,34,9,0,21,35,151,SG
1998,32,44,1652,315,704,61,192,254,512,150,193,53,174,227,254,79,43,109,116,841,SF
1998,22,33,317,35,70,0,0,35,70,19,23,34,40,74,9,8,10,12,48,89,C
1998,33,70,1458,249,542,0,1,249,541,52,115,173,266,439,107,37,45,98,158,550,C
1998,25,28,193,14,41,1,3,13,38,10,17,9,17,26,7,3,6,10,36,39,SF
1998,34,82,1786,259,577,92,233,167,344,167,195,37,131,168,271,63,16,104,103,777,PG
1998,22,80,1412,234,488,0,1,234,487,102,144,110,203,313,57,27,28,132,198,570,C
1998,29,72,1332,128,310,73,187,55,123,77,98,37,70,107,192,52,4,111,163,406,PG
1998,33,63,1430,229,531,52,155,177,376,87,103,24,105,129,297,53,5,162,92,597,PG
1998,24,82,2447,306,597,0,0,306,597,197,281,221,326,547,57,50,258,116,292,809,C
1998,24,24,586,57,111,0,0,57,111,43,63,46,75,121,15,12,55,34,83,157,C
1998,24,58,1861,249,486,0,0,249,486,154,218,175,251,426,42,38,203,82,209,652,C
1998,30,59,1454,206,452,62,148,144,304,74,79,32,110,142,117,41,1,91,94,548,SG
1998,24,74,2527,492,941,0,4,492,937,223,316,196,389,585,155,39,80,156,278,1207,C
1998,25,82,1950,248,593,56,152,192,441,165,213,54,131,185,230,80,10,130,195,717,PG
1998,24,68,994,94,176,0,0,94,176,50,71,77,98,175,26,25,55,28,183,238,PF
1998,29,79,1109,146,318,3,8,143,310,89,122,72,138,210,51,35,19,65,172,384,PF
1998,25,57,911,130,293,31,93,99,200,48,61,37,63,100,61,34,1,48,75,339,SG
1998,25,47,696,94,209,25,67,69,142,44,54,30,43,73,44,29,1,33,58,257,SG
1998,25,10,215,36,84,6,26,30,58,4,7,7,20,27,17,5,0,15,17,82,SG
1998,24,58,1070,112,305,2,8,110,297,111,180,28,42,70,110,62,10,97,125,337,SF
1998,30,82,3295,634,1386,130,300,504,1086,428,504,89,264,353,182,77,22,182,200,1826,SF
1998,31,69,1252,124,333,11,57,113,276,30,43,17,79,96,226,44,3,54,71,289,PG
1998,32,70,2569,543,1220,130,334,413,886,407,471,50,179,229,279,88,15,181,154,1623,SG
1998,26,74,2786,551,1302,135,420,416,882,221,267,99,247,346,231,55,19,187,188,1458,SG
1998,27,39,544,56,135,0,1,56,134,27,36,43,90,133,22,15,46,37,80,139,C
1998,27,74,1328,191,386,0,0,191,386,75,156,109,254,363,27,24,72,70,226,457,C
1998,23,35,414,65,174,24,66,41,108,8,16,9,37,46,39,19,4,33,50,162,SG
1998,23,16,143,23,63,7,24,16,39,1,2,0,13,13,10,7,1,15,21,54,SG
1998,23,19,271,42,111,17,42,25,69,7,14,9,24,33,29,12,3,18,29,108,SG
1998,31,80,2359,429,895,27,84,402,811,248,360,152,258,410,170,92,90,140,249,1133,SF
1998,32,73,2457,544,1065,1,4,543,1061,485,660,239,536,775,199,64,192,202,204,1574,C
1998,25,56,2294,534,1136,25,65,509,1071,215,266,82,225,307,158,69,34,200,164,1308,SF
1998,27,70,1231,195,501,74,225,121,276,77,107,37,74,111,135,37,10,97,101,541,PG
1998,30,6,41,6,19,3,6,3,13,2,2,2,10,12,1,4,0,2,0,17,SF
1998,36,80,2856,155,360,4,23,151,337,61,111,421,780,1201,230,47,18,147,238,375,PF
1998,26,21,376,47,91,0,2,47,89,18,32,35,32,67,18,10,8,14,35,112,PF
1998,26,18,351,45,87,0,1,45,86,18,32,34,31,65,16,9,8,13,34,108,PF
1998,26,3,25,2,4,0,1,2,3,0,0,1,1,2,2,1,0,1,1,4,PF
1998,26,76,2499,426,935,72,212,354,723,225,328,155,269,424,202,93,38,193,242,1149,SF
1998,24,15,106,9,25,0,0,9,25,2,6,8,9,17,2,3,8,5,18,20,PF
1998,24,9,37,3,8,0,0,3,8,1,2,0,5,5,1,2,4,1,6,7,PF
1998,24,6,69,6,17,0,0,6,17,1,4,8,4,12,1,1,4,4,12,13,PF
1998,28,41,425,46,101,0,0,46,101,47,79,46,72,118,24,2,23,19,68,139,C
1998,25,82,1706,290,607,25,73,265,534,166,228,28,167,195,155,56,14,132,171,771,SF
1998,23,53,429,59,136,1,3,58,133,39,61,40,50,90,19,21,7,44,79,158,PF
1998,31,31,323,25,69,0,0,25,69,29,33,18,23,41,17,7,1,10,35,79,SF
1998,31,2,18,1,6,0,0,1,6,3,4,2,2,4,1,1,0,3,5,5,SF
1998,31,29,305,24,63,0,0,24,63,26,29,16,21,37,16,6,1,7,30,74,SF
1998,25,6,30,3,6,0,0,3,6,0,1,3,3,6,0,0,0,4,7,6,C
1998,27,82,2219,226,525,73,214,153,311,213,278,78,248,326,101,90,31,81,229,738,SF
1998,33,73,2333,407,826,30,115,377,711,323,405,149,580,729,218,65,80,190,267,1167,C
1998,27,16,87,1,13,0,0,1,13,3,6,5,15,20,3,0,11,5,12,5,C
1998,38,74,1272,155,371,0,0,155,371,96,119,97,145,242,44,34,33,61,182,406,C
1998,35,78,2742,437,898,61,147,376,751,297,352,135,419,554,341,60,19,168,205,1232,SF
1998,29,81,2290,329,828,125,342,204,486,105,130,47,200,247,153,53,39,104,152,888,SF
1998,29,52,1797,258,666,94,273,164,393,97,118,39,158,197,129,43,32,92,121,707,SF
1998,29,29,493,71,162,31,69,40,93,8,12,8,42,50,24,10,7,12,31,181,SF
1998,25,41,188,16,36,0,0,16,36,12,18,20,39,59,8,6,8,10,45,44,C
1998,22,4,9,1,8,0,3,1,5,2,4,3,1,4,0,1,0,0,1,4,SG
1998,27,77,1641,216,505,9,41,207,464,150,182,48,171,219,100,65,20,79,156,591,SF
1998,32,56,1636,250,579,0,2,250,577,246,332,146,247,393,77,28,43,146,164,746,C
1998,32,47,1484,237,538,0,2,237,536,230,305,130,227,357,69,25,39,134,137,704,C
1998,32,9,152,13,41,0,0,13,41,16,27,16,20,36,8,3,4,12,27,42,C
1998,21,20,146,19,58,0,2,19,56,23,30,2,5,7,36,7,1,21,27,61,PG
1998,31,59,1530,154,446,28,95,126,351,36,52,37,178,215,261,49,17,99,148,372,PG
1998,31,39,1028,103,307,21,67,82,240,24,33,20,131,151,173,35,14,75,93,251,PG
1998,31,20,502,51,139,7,28,44,111,12,19,17,47,64,88,14,3,24,55,121,PG
1998,25,40,433,48,89,0,2,48,87,36,70,27,50,77,33,9,5,32,54,132,PF
1998,25,19,196,22,48,0,1,22,47,10,26,19,27,46,16,5,2,19,19,54,PF
1998,25,21,237,26,41,0,1,26,40,26,44,8,23,31,17,4,3,13,35,78,PF
1998,27,78,1662,211,459,0,0,211,459,203,322,134,171,305,74,45,30,102,201,625,PF
1998,22,34,292,49,125,15,47,34,78,6,11,13,14,27,21,12,6,27,24,119,SG
1998,22,11,32,4,18,1,3,3,15,1,2,5,3,8,2,2,1,6,3,10,SG
1998,22,23,260,45,107,14,44,31,63,5,9,8,11,19,19,10,5,21,21,109,SG
1998,22,79,2344,464,1070,0,8,464,1062,227,293,199,272,471,94,62,51,158,263,1155,PF
1998,22,49,1645,343,800,0,7,343,793,160,208,141,197,338,67,44,38,106,169,846,PF
1998,22,30,699,121,270,0,1,121,269,67,85,58,75,133,27,18,13,52,94,309,PF
1998,25,48,1053,93,194,0,1,93,193,65,103,120,186,306,88,41,15,51,95,251,PF
1998,25,18,347,26,61,0,0,26,61,17,30,35,65,100,29,15,9,15,35,69,PF
1998,25,30,706,67,133,0,1,67,132,48,73,85,121,206,59,26,6,36,60,182,PF
1998,28,73,2857,489,1101,97,276,392,825,389,455,133,176,309,292,75,29,176,219,1464,SG
1998,29,7,80,8,24,0,4,8,20,3,4,4,3,7,10,5,2,9,7,19,PG
1998,31,73,2085,514,1038,0,3,514,1035,188,240,127,378,505,101,40,88,134,243,1216,C
1998,24,64,918,79,184,2,17,77,167,49,71,19,62,81,177,60,5,63,114,209,PG
1998,24,17,74,10,23,0,1,10,22,5,10,0,4,4,13,0,1,12,15,25,PG
1998,24,47,844,69,161,2,16,67,145,44,61,19,58,77,164,60,4,51,99,184,PG
1998,30,68,813,59,129,0,0,59,129,44,79,93,133,226,17,23,37,49,175,162,C
1998,27,14,547,110,277,9,48,101,229,70,94,7,44,51,68,19,5,44,26,299,SG
1998,23,22,748,128,283,16,46,112,237,81,101,28,48,76,67,31,21,74,56,353,SF
1998,23,57,1797,296,692,31,149,265,543,273,349,77,113,190,174,58,38,150,119,896,SG
1998,32,82,2188,372,947,130,398,242,549,185,235,48,182,230,219,78,5,143,205,1059,SG
1998,25,7,37,10,28,3,10,7,18,4,6,3,3,6,1,2,0,2,2,27,SF
1998,24,15,110,12,26,0,0,12,26,16,25,9,22,31,2,5,2,8,13,40,PF
1998,22,81,1761,155,323,0,0,155,323,65,142,197,339,536,61,29,195,85,251,375,C
1998,27,31,718,75,225,10,48,65,177,75,86,15,50,65,50,21,8,35,52,235,SG
1998,35,64,1858,270,511,39,91,231,420,191,231,35,131,166,543,89,10,161,138,770,PG
1998,26,4,17,1,3,0,0,1,3,1,2,1,3,4,1,1,2,2,4,3,C
1998,24,71,2839,448,1091,91,304,357,787,238,287,87,211,298,580,113,7,223,150,1225,PG
1998,24,49,2033,354,833,65,205,289,628,179,212,63,154,217,399,80,5,159,112,952,PG
1998,24,22,806,94,258,26,99,68,159,59,75,24,57,81,181,33,2,64,38,273,PG
1998,24,67,1505,199,558,48,163,151,395,65,84,35,126,161,167,56,8,106,140,511,SG
1998,27,51,847,145,269,0,1,145,268,59,82,80,133,213,26,18,34,47,87,349,PF
1998,31,76,3020,490,1130,12,48,478,1082,357,492,112,293,405,801,126,25,266,182,1349,PG
1998,29,58,1638,259,617,0,4,259,613,218,279,152,275,427,51,31,24,74,122,736,PF
1998,24,46,942,87,231,19,60,68,171,74,131,25,69,94,171,44,7,93,113,267,SG
1998,27,57,984,142,304,0,1,142,303,23,61,84,128,212,48,20,38,61,163,307,C
1998,27,39,752,116,249,0,1,116,248,16,48,59,95,154,36,15,27,44,117,248,C
1998,27,18,232,26,55,0,0,26,55,7,13,25,33,58,12,5,11,17,46,59,C
1998,23,12,108,13,37,1,2,12,35,11,16,4,9,13,1,3,2,8,22,38,SF
1998,21,71,1513,321,675,0,1,321,674,173,244,118,178,296,53,34,40,107,222,815,PF
1998,28,43,426,56,140,20,59,36,81,16,25,10,37,47,19,21,7,18,39,148,SG
1998,28,10,139,25,65,5,21,20,44,7,10,4,6,10,9,5,1,6,12,62,SG
1998,28,4,15,4,5,0,0,4,5,1,2,0,0,0,1,0,1,0,0,9,SG
1998,28,29,272,27,70,15,38,12,32,8,13,6,31,37,9,16,5,12,27,77,SG
1998,22,54,535,55,113,0,0,55,113,41,54,48,58,106,17,22,12,46,97,151,PF
1998,22,33,368,41,80,0,0,41,80,26,33,32,38,70,13,19,9,33,65,108,PF
1998,22,21,167,14,33,0,0,14,33,15,21,16,20,36,4,3,3,13,32,43,PF
1998,25,5,73,17,45,0,0,17,45,3,3,8,16,24,3,1,0,10,19,37,PF
1998,20,77,1779,306,684,62,171,244,513,171,231,107,181,288,90,54,17,118,185,845,SF
1998,27,30,167,23,56,9,30,14,26,4,8,1,14,15,27,10,1,16,22,59,PG
1998,27,13,46,10,27,5,16,5,11,1,3,1,4,5,3,4,0,5,6,26,PG
1998,27,17,121,13,29,4,14,9,15,3,5,0,10,10,24,6,1,11,16,33,PG
1998,35,74,2197,294,624,0,5,294,619,164,240,151,386,537,222,48,30,152,238,752,PF
1998,35,47,1574,205,430,0,4,205,426,118,170,100,271,371,161,30,23,115,158,528,PF
1998,35,27,623,89,194,0,1,89,193,46,70,51,115,166,61,18,7,37,80,224,PF
1998,23,54,1360,241,505,4,12,237,493,144,212,123,215,338,72,35,27,94,161,630,PF
1998,23,41,1005,177,359,4,9,173,350,113,163,80,154,234,58,27,19,72,115,471,PF
1998,23,13,355,64,146,0,3,64,143,31,49,43,61,104,14,8,8,22,46,159,PF
1998,26,64,2053,311,743,123,316,188,427,136,172,31,163,194,442,64,6,104,120,881,PG
1998,22,62,2325,446,1047,69,224,377,823,258,305,142,266,408,106,64,25,164,216,1219,PF
1998,24,40,489,66,148,0,1,66,147,30,47,53,99,152,20,15,10,40,83,162,PF
1998,24,22,322,46,114,0,1,46,113,22,34,34,68,102,18,10,6,31,48,114,PF
1998,24,3,6,1,1,0,0,1,1,2,4,0,1,1,0,0,0,0,1,4,PF
1998,24,15,161,19,33,0,0,19,33,6,9,19,30,49,2,5,4,9,34,44,PF
1998,22,45,419,44,122,3,8,41,114,48,68,4,34,38,84,9,1,56,63,139,PG
1998,29,10,265,36,84,0,2,36,82,3,8,16,49,65,7,4,2,13,33,75,PF
1998,34,65,996,79,186,0,0,79,186,37,65,71,192,263,36,11,66,46,130,195,C
1998,21,82,3268,722,1705,91,292,631,1413,305,473,270,566,836,273,142,60,292,262,1840,PF
1998,21,41,1027,156,321,0,1,156,320,53,97,96,206,302,24,30,40,61,127,365,PF
1998,23,67,1124,85,164,0,0,85,164,35,98,112,212,324,18,61,72,28,116,205,C
1998,23,82,2361,468,979,1,2,467,977,210,293,117,256,373,110,62,101,172,239,1147,SF
1998,23,77,2896,466,875,8,39,458,836,184,278,132,346,478,195,75,88,167,268,1124,PF
1998,27,38,235,24,53,6,22,18,31,26,28,5,19,24,35,8,1,27,28,80,SG
1998,27,19,127,11,29,3,14,8,15,17,17,3,6,9,21,5,0,17,17,42,SG
1998,27,19,108,13,24,3,8,10,16,9,11,2,13,15,14,3,1,10,11,38,SG
1998,27,82,2317,235,516,81,215,154,301,91,113,32,242,274,466,144,37,175,195,642,PG
1998,23,66,1539,201,498,44,137,157,361,65,83,47,80,127,78,53,25,72,143,511,SG
1998,27,79,2325,268,608,0,0,268,608,200,277,198,396,594,89,85,74,119,194,736,PF
1998,27,48,1290,141,331,0,0,141,331,123,174,109,227,336,40,43,52,69,108,405,PF
1998,27,31,1035,127,277,0,0,127,277,77,103,89,169,258,49,42,22,50,86,331,PF
1998,34,4,34,5,12,0,1,5,11,2,2,2,1,3,5,1,0,7,6,12,PG
1998,24,71,2809,647,1341,65,205,582,1136,196,333,176,498,674,273,111,124,185,269,1555,C
1998,23,39,395,48,116,1,6,47,110,31,43,22,46,68,34,15,4,31,40,128,SG
1998,34,48,467,75,172,0,0,75,172,17,21,32,48,80,19,4,5,16,77,167,C
1998,27,81,2845,383,864,59,170,324,694,229,288,49,164,213,529,140,30,226,229,1054,PG
1998,30,38,688,64,171,0,2,64,169,29,40,23,59,82,45,11,5,21,97,157,SG
1998,37,15,105,10,21,0,0,10,21,3,6,6,9,15,2,2,4,8,15,23,C
1998,24,34,150,20,50,8,17,12,33,9,15,3,8,11,25,6,1,9,12,57,PG
1998,28,3,16,1,2,0,1,1,1,0,2,0,1,1,1,0,0,1,0,2,PG
1998,26,82,1073,126,355,52,169,74,186,118,129,16,99,115,196,34,6,65,106,422,PG
1998,34,72,1252,141,434,29,109,112,325,69,98,16,74,90,78,34,6,79,78,380,SG
1998,26,65,757,115,220,0,1,115,219,66,85,48,99,147,14,19,38,50,119,296,PF
1998,23,54,1071,125,282,9,28,116,254,65,90,24,57,81,103,38,3,58,79,324,SG
1998,23,41,864,109,238,7,24,102,214,58,79,19,41,60,83,30,2,50,60,283,SG
1998,23,13,207,16,44,2,4,14,40,7,11,5,16,21,20,8,1,8,19,41,SG
1998,22,9,140,16,50,3,9,13,41,2,4,4,11,15,3,6,3,9,18,37,SG
1998,37,41,738,75,149,0,0,75,149,52,71,78,105,183,21,17,15,38,93,202,PF
1998,25,4,145,24,61,0,0,24,61,31,45,10,11,21,12,4,0,9,9,79,SF
1998,39,27,178,18,43,0,0,18,43,1,8,6,23,29,4,6,9,5,34,37,PF
1998,35,71,1333,95,202,0,0,95,202,65,93,107,205,312,49,33,60,29,138,255,C
1998,29,65,2343,321,645,0,4,321,641,195,293,443,440,883,67,45,49,95,236,837,C
1998,24,77,1305,151,288,0,1,151,287,108,166,170,209,379,48,51,10,60,144,410,PF
1998,28,14,111,13,17,0,0,13,17,0,2,16,10,26,3,2,3,2,17,26,PF
1998,31,25,161,16,48,0,4,16,44,32,33,2,12,14,32,9,2,16,24,64,PG
1998,26,72,1314,165,368,1,2,164,366,122,182,67,112,179,89,34,24,82,133,453,SF
1998,29,58,801,93,213,0,5,93,208,51,63,87,124,211,29,17,21,30,132,237,C
1998,28,39,365,56,119,0,1,56,118,24,46,53,39,92,20,18,5,30,55,136,SF
1998,27,59,1470,210,544,80,219,130,325,108,125,50,150,200,122,59,35,92,161,608,SF
1998,27,28,876,125,319,49,129,76,190,49,60,27,91,118,69,40,23,52,100,348,SF
1998,27,31,594,85,225,31,90,54,135,59,65,23,59,82,53,19,12,40,61,260,SF
1998,24,79,2819,561,1134,0,9,561,1125,279,443,162,284,446,230,76,48,199,252,1401,SF
1998,35,81,2528,531,1041,1,7,530,1034,242,305,232,447,679,78,55,38,170,235,1305,PF
1998,34,58,546,66,140,3,7,63,133,15,29,19,60,79,37,21,3,37,58,150,SG
1998,23,3,9,0,3,0,0,0,3,1,2,2,2,4,0,0,0,1,2,1,SF
1998,33,57,621,40,121,2,10,38,111,5,10,36,90,126,30,20,7,22,92,87,PF
1998,22,69,2067,241,542,0,2,241,540,141,214,180,426,606,55,55,87,81,237,623,C
1998,25,7,44,7,14,0,0,7,14,2,4,1,8,9,4,0,0,2,7,16,C
1998,24,12,64,7,29,1,2,6,27,14,16,4,13,17,2,0,2,4,10,29,C
1998,24,6,42,4,15,0,0,4,15,10,12,4,9,13,1,0,2,3,5,18,C
1998,24,6,22,3,14,1,2,2,12,4,4,0,4,4,1,0,0,1,5,11,C
1999,24,49,1205,177,407,6,21,171,386,94,136,72,114,186,50,50,16,70,121,454,SG
1999,22,50,2021,386,893,11,36,375,857,369,439,114,260,374,172,69,55,186,137,1152,SF
1999,25,36,778,97,260,30,105,67,155,37,44,7,67,74,119,35,5,69,77,261,PG
1999,23,50,1719,303,673,74,208,229,465,176,195,57,155,212,178,53,7,122,117,856,SG
1999,25,2,5,1,2,0,0,1,2,0,0,1,1,2,0,1,1,2,4,2,C
1999,24,38,978,125,314,21,69,104,245,138,165,20,89,109,145,48,4,82,73,409,SG
1999,28,34,1010,161,357,6,24,155,333,84,101,24,79,103,193,33,2,71,78,412,PG
1999,31,47,1581,253,640,96,277,157,363,99,162,51,226,277,91,64,15,83,72,701,SF
1999,25,50,1072,162,363,14,41,148,322,89,125,49,83,132,56,39,10,66,89,427,SG
1999,24,41,470,50,139,0,7,50,132,34,48,35,62,97,27,18,13,26,98,134,C
1999,31,50,806,104,251,49,125,55,126,62,89,14,49,63,100,66,3,55,75,319,PG
1999,31,32,358,40,88,7,15,33,73,18,21,2,37,39,61,12,0,25,31,105,PG
1999,31,10,178,21,43,6,8,15,35,9,10,1,15,16,27,3,0,10,16,57,PG
1999,31,22,180,19,45,1,7,18,38,9,11,1,22,23,34,9,0,15,15,48,PG
1999,30,50,1502,230,522,69,189,161,333,161,178,53,127,180,335,108,4,158,90,690,PG
1999,31,33,415,20,62,8,29,12,33,5,8,10,34,44,10,17,3,13,58,53,SF
1999,30,48,874,78,174,0,2,78,172,52,76,47,78,125,58,57,18,30,81,208,SF
1999,29,49,1259,185,453,2,7,183,446,105,157,83,154,237,89,47,35,114,125,477,C
1999,29,5,44,4,13,0,0,4,13,1,2,8,4,12,1,2,0,7,6,9,PF
1999,37,43,543,78,175,0,2,78,173,25,34,36,58,94,26,9,28,27,78,181,PF
1999,23,27,249,34,86,1,5,33,81,9,13,24,30,54,13,9,2,11,24,78,SG
1999,29,1,2,0,1,0,0,0,1,0,0,0,0,0,0,0,0,1,0,0,PG
1999,27,34,1162,198,437,0,3,198,434,72,160,86,125,211,56,32,34,76,121,468,PF
1999,35,42,1526,240,502,4,25,236,477,192,267,167,349,516,192,43,13,100,89,676,PF
1999,31,50,1156,168,371,64,160,104,211,64,73,16,89,105,208,52,5,88,64,464,PG
1999,27,37,1181,141,356,52,172,89,184,78,101,39,105,144,116,42,11,72,98,412,SG
1999,25,17,183,10,32,8,24,2,8,9,13,3,17,20,29,7,1,12,24,37,SG
1999,29,43,736,59,138,24,79,35,59,71,84,25,71,96,112,53,5,47,61,213,SG
1999,22,50,1121,147,283,0,3,147,280,41,61,96,204,300,53,29,71,45,159,335,C
1999,27,24,180,18,39,1,1,17,38,8,15,6,22,28,20,9,2,13,26,45,PG
1999,27,8,30,4,8,0,0,4,8,2,2,3,2,5,0,2,0,2,5,10,PG
1999,27,16,150,14,31,1,1,13,30,6,13,3,20,23,20,7,2,11,21,35,PG
1999,34,6,33,2,7,0,0,2,7,0,0,3,5,8,1,0,0,3,6,4,C
1999,20,31,320,44,117,3,14,41,103,27,40,15,25,40,10,11,8,21,46,118,PG
1999,25,3,19,2,6,0,0,2,6,3,4,2,3,5,0,1,0,1,4,7,PF
1999,26,49,1043,127,305,22,59,105,246,70,83,19,61,80,169,42,4,62,111,346,PG
1999,20,50,1758,260,605,15,74,245,531,127,169,30,106,136,325,78,5,146,122,662,PG
1999,22,45,1488,191,495,85,235,106,260,157,172,24,72,96,173,58,14,98,115,624,SG
1999,31,48,1763,247,651,77,251,170,400,69,91,45,179,224,278,99,9,115,61,640,PG
1999,30,34,530,36,100,0,1,36,99,28,54,58,93,151,12,19,16,21,74,100,PF
1999,30,14,162,13,33,0,1,13,32,6,12,24,22,46,2,1,4,6,27,32,PF
1999,30,20,368,23,67,0,0,23,67,22,42,34,71,105,10,18,12,15,47,68,PF
1999,34,36,714,76,154,0,6,76,148,31,36,16,57,73,134,43,1,47,44,183,PG
1999,24,39,432,49,151,1,10,48,141,21,42,25,68,93,38,22,11,39,60,120,SF
1999,27,30,494,26,93,7,26,19,67,11,24,15,37,52,28,21,9,13,51,70,SF
1999,22,22,221,30,79,3,18,27,61,2,3,7,10,17,33,6,0,20,20,65,PG
1999,22,5,51,10,21,1,5,9,16,0,0,1,3,4,6,1,0,7,3,21,PG
1999,22,17,170,20,58,2,13,18,45,2,3,6,7,13,27,5,0,13,17,44,PG
1999,26,49,1294,167,348,0,4,167,344,86,115,130,262,392,40,35,159,56,153,420,C
1999,28,36,1217,212,507,12,47,200,460,65,78,27,107,134,309,63,10,74,82,501,PG
1999,28,15,505,85,208,7,28,78,180,26,31,11,42,53,104,24,3,36,25,203,PG
1999,28,21,712,127,299,5,19,122,280,39,47,16,65,81,205,39,7,38,57,298,PG
1999,30,48,1192,176,373,15,40,161,333,40,59,36,138,174,57,16,19,38,106,407,PF
1999,30,49,1377,187,495,135,349,52,146,40,55,15,88,103,143,56,8,80,75,549,PG
1999,23,33,236,33,89,3,10,30,79,11,14,5,17,22,31,5,1,22,21,80,SG
1999,29,50,1611,229,477,0,0,229,477,113,146,115,231,346,66,46,48,69,166,571,PF
1999,30,39,1139,132,319,0,10,132,309,78,103,27,105,132,149,68,8,80,93,342,PG
1999,26,17,95,6,21,0,5,6,16,5,18,3,7,10,19,9,0,12,8,17,PG
1999,20,50,1896,362,779,27,101,335,678,245,292,53,211,264,190,72,50,157,153,996,SG
1999,33,45,1204,168,348,0,1,168,347,71,110,92,140,232,48,34,16,68,149,407,PF
1999,30,50,1056,100,240,61,148,39,92,13,18,29,104,133,57,37,13,21,83,274,SF
1999,31,41,413,43,114,24,62,19,52,7,10,9,33,42,18,13,4,14,28,117,PF
1999,28,32,706,75,208,28,72,47,136,34,42,32,87,119,45,40,11,23,82,212,SF
1999,30,3,18,1,7,0,1,1,6,2,4,4,2,6,0,0,0,1,2,4,SF
1999,28,31,418,67,139,11,29,56,110,23,32,13,31,44,22,15,4,29,41,168,SG
1999,25,35,876,123,277,0,1,123,276,62,98,79,126,205,18,24,9,75,113,308,PF
1999,24,46,945,136,261,0,0,136,261,57,103,102,151,253,12,29,74,39,131,329,C
1999,30,49,1459,222,465,0,1,222,464,172,269,126,271,397,69,39,73,80,159,616,C
1999,30,17,325,44,101,0,0,44,101,38,62,38,58,96,8,1,16,22,51,126,C
1999,30,32,1134,178,364,0,1,178,363,134,207,88,213,301,61,38,57,58,108,490,C
1999,37,18,152,21,52,0,1,21,51,5,7,9,22,31,9,1,10,9,31,47,PF
1999,24,39,445,76,205,28,75,48,130,27,40,23,48,71,23,8,2,28,45,207,SG
1999,24,11,81,9,26,3,9,6,17,2,4,0,12,12,7,1,1,4,9,23,SG
1999,24,28,364,67,179,25,66,42,113,25,36,23,36,59,16,7,1,24,36,184,SG
1999,23,42,624,71,216,5,30,66,186,24,32,8,41,49,66,21,7,46,66,171,SG
1999,22,50,1760,345,766,19,66,326,700,204,268,94,189,283,149,55,77,110,140,913,SF
1999,29,8,199,39,93,2,10,37,83,47,50,5,10,15,36,9,0,20,22,127,PG
1999,29,4,100,21,49,1,7,20,42,29,31,1,5,6,19,3,0,12,13,72,PG
1999,29,4,99,18,44,1,3,17,41,18,19,4,5,9,17,6,0,8,9,55,PG
1999,24,43,545,58,129,1,1,57,128,34,67,49,101,150,19,23,56,27,100,151,C
1999,30,19,137,20,35,0,0,20,35,4,12,14,21,35,2,0,11,18,32,44,C
1999,29,13,352,59,140,11,28,48,112,34,49,23,62,85,12,7,5,28,23,163,SF
1999,31,38,1183,165,459,53,151,112,308,76,91,12,92,104,109,34,9,54,46,459,SG
1999,27,50,1266,172,415,8,37,164,378,33,67,33,108,141,73,39,16,42,146,385,SG
1999,30,46,697,63,172,26,68,37,104,14,17,29,88,117,30,22,12,28,52,166,PF
1999,31,48,1297,114,267,36,94,78,173,64,78,18,115,133,193,44,1,85,156,328,PG
1999,28,50,1768,252,650,49,161,203,489,207,246,59,148,207,187,113,26,119,111,760,SG
1999,23,28,409,36,80,0,1,36,79,21,37,36,60,96,10,10,31,21,52,93,C
1999,22,15,87,12,23,0,1,12,22,8,10,5,20,25,0,3,9,6,14,32,C
1999,27,14,98,13,31,0,0,13,31,5,6,7,15,22,0,1,2,2,17,31,C
1999,31,37,1178,168,406,7,33,161,373,143,190,76,252,328,78,24,42,90,96,486,PF
1999,30,48,1272,183,414,6,25,177,389,83,101,21,96,117,222,45,11,82,113,455,PG
1999,31,7,35,3,13,0,0,3,13,2,2,1,4,5,1,0,1,3,6,8,C
1999,36,47,1066,131,335,38,119,93,216,52,80,37,108,145,43,31,7,43,74,352,SF
1999,23,10,59,6,18,0,3,6,15,13,18,2,8,10,0,3,0,3,6,25,SG
1999,23,42,784,110,255,11,33,99,222,57,70,37,53,90,24,10,13,48,106,288,PF
1999,23,27,249,32,75,8,29,24,46,20,23,16,29,45,10,7,8,23,32,92,PF
1999,29,27,382,51,124,14,36,37,88,43,50,8,23,31,63,11,0,33,31,159,PG
1999,29,3,19,4,8,1,1,3,7,3,3,0,1,1,5,2,0,0,1,12,PG
1999,29,24,363,47,116,13,35,34,81,40,47,8,22,30,58,9,0,33,30,147,PG
1999,37,50,1011,186,424,1,1,185,423,81,114,95,160,255,58,46,10,58,168,454,PF
1999,24,16,162,3,18,0,0,3,18,0,2,13,15,28,1,1,11,5,30,6,C
1999,24,15,161,3,18,0,0,3,18,0,2,13,15,28,1,1,11,5,30,6,C
1999,26,35,372,29,72,1,5,28,67,19,22,20,31,51,14,17,9,10,83,78,PF
1999,34,42,864,163,336,69,145,94,191,28,34,18,67,85,48,36,3,45,42,423,SG
1999,30,50,1146,90,206,1,15,89,191,63,79,19,89,108,78,42,7,37,135,244,SF
1999,23,50,1414,161,414,0,0,161,414,120,204,164,218,382,54,26,58,92,165,442,C
1999,23,47,614,83,183,5,17,78,166,49,65,13,41,54,106,30,6,44,39,220,PG
1999,27,50,902,109,243,0,1,109,242,90,111,70,103,173,40,23,17,48,88,308,SF
1999,30,49,1271,164,348,0,0,164,348,135,192,116,228,344,33,22,42,50,136,463,PF
1999,26,8,21,7,17,0,0,7,17,3,6,9,2,11,3,0,0,1,4,17,PF
1999,29,50,1374,161,302,0,0,161,302,76,123,155,261,416,22,20,57,43,115,398,PF
1999,28,50,1378,174,397,65,144,109,253,44,50,3,83,86,89,21,3,57,76,457,SG
1999,25,4,35,2,6,0,0,2,6,5,6,2,5,7,1,1,0,7,12,9,SF
1999,19,46,557,81,200,2,12,79,188,45,59,40,44,84,58,30,7,54,46,209,SG
1999,31,37,578,49,92,0,0,49,92,28,38,50,89,139,10,11,3,16,79,126,C
1999,25,47,1102,138,276,0,0,138,276,95,141,104,151,255,31,50,29,54,161,371,C
1999,25,14,258,28,57,0,0,28,57,19,29,33,30,63,10,13,9,22,51,75,C
1999,25,33,844,110,219,0,0,110,219,76,112,71,121,192,21,37,20,32,110,296,C
1999,27,4,20,4,11,1,5,3,6,0,0,2,0,2,1,2,0,2,2,9,PG
1999,27,22,271,27,74,15,34,12,40,5,7,5,17,22,26,5,3,14,28,74,SG
1999,32,48,1093,114,270,13,30,101,240,40,50,14,88,102,174,33,3,55,62,281,PG
1999,29,49,1177,216,431,0,1,216,430,81,118,92,180,272,71,38,40,111,181,513,C
1999,25,36,630,92,253,16,66,76,187,46,71,11,43,54,95,16,6,45,47,246,PG
1999,23,50,1558,215,462,71,164,144,298,46,72,26,57,83,95,27,11,66,90,547,SG
1999,30,50,1761,262,557,11,43,251,514,179,255,140,361,501,215,44,51,131,166,714,C
1999,21,49,780,125,267,0,0,125,267,54,80,66,82,148,20,19,17,26,117,304,C
1999,32,30,842,96,219,0,11,96,208,55,87,16,42,58,124,27,3,61,54,247,PG
1999,24,34,441,47,129,16,49,31,80,8,8,3,29,32,52,12,4,31,61,118,PG
1999,33,46,685,48,109,0,0,48,109,19,40,79,114,193,7,13,38,24,116,115,C
1999,35,38,1116,144,350,89,221,55,129,51,61,12,56,68,134,23,2,53,51,428,SG
1999,22,50,1963,418,845,1,7,417,838,247,358,159,412,571,121,45,126,146,147,1084,PF
1999,33,24,283,32,72,4,10,28,62,9,13,7,26,33,30,17,5,21,23,77,SF
1999,26,50,1038,140,314,21,50,119,264,67,80,12,82,94,185,30,2,109,122,368,PG
1999,35,47,1291,156,331,40,107,116,224,103,119,36,101,137,89,46,12,61,91,455,SG
1999,30,50,1509,208,507,39,119,169,388,106,140,35,178,213,117,26,17,71,104,561,SF
1999,38,48,1232,174,395,94,217,80,178,53,70,25,90,115,38,25,3,45,77,495,SF
1999,28,20,539,80,190,1,5,79,185,43,61,25,84,109,18,8,7,34,48,204,PF
1999,25,16,145,13,44,4,13,9,31,4,4,6,13,19,15,5,3,2,8,34,SF
1999,25,11,121,11,34,4,11,7,23,4,4,4,13,17,14,3,3,2,7,30,SF
1999,25,5,24,2,10,0,2,2,8,0,0,2,0,2,1,2,0,0,1,4,SF
1999,36,38,1300,247,568,0,2,247,566,163,231,74,303,377,43,30,100,99,105,657,C
1999,24,2,3,0,1,0,0,0,1,0,0,0,2,2,0,0,0,0,0,0,C
1999,24,26,849,67,133,0,0,67,133,43,60,112,174,286,24,25,18,34,73,177,PF
1999,33,8,46,1,14,0,0,1,14,3,4,5,1,6,0,1,1,1,4,5,SF
1999,32,50,1058,141,296,38,97,103,199,29,33,16,86,102,53,23,10,39,113,349,PF
1999,25,50,2051,389,876,45,136,344,740,186,226,69,194,263,218,66,15,107,96,1009,SF
1999,24,50,1131,99,263,38,97,61,166,60,79,21,70,91,197,61,1,77,95,296,PG
1999,22,50,1417,191,386,0,3,191,383,168,231,210,371,581,32,31,22,77,212,550,PF
1999,30,42,458,52,138,1,4,51,134,13,21,28,55,83,25,6,8,24,63,118,PF
1999,29,44,944,148,330,32,95,116,235,66,89,26,63,89,89,28,10,56,114,394,SF
1999,23,44,614,52,121,0,0,52,121,25,51,79,115,194,18,15,43,31,90,129,C
1999,24,42,462,56,124,0,0,56,124,30,50,28,73,101,6,6,14,27,60,142,C
1999,28,47,936,167,299,1,5,166,294,85,120,101,121,222,30,22,23,52,77,420,PF
1999,22,47,1780,414,900,4,14,410,886,145,206,166,323,489,202,78,83,135,152,977,PF
1999,23,24,205,15,51,6,23,9,28,15,20,3,18,21,18,5,1,12,18,51,PG
1999,32,49,1054,116,231,0,0,116,231,38,51,99,158,257,28,30,45,29,113,270,C
1999,22,39,538,85,170,7,18,78,152,40,56,26,49,75,18,8,3,20,62,217,PF
1999,31,48,775,117,265,1,8,116,257,37,93,52,127,179,32,32,10,62,118,272,C
1999,31,18,281,36,97,0,1,36,96,12,24,21,44,65,12,8,4,29,40,84,C
1999,31,30,494,81,168,1,7,80,161,25,69,31,83,114,20,24,6,33,78,188,C
1999,33,19,58,8,25,5,16,3,9,0,0,2,3,5,6,2,1,4,7,21,SG
1999,29,50,1540,266,555,1,5,265,550,141,177,137,225,362,58,39,40,101,157,674,C
1999,30,50,1606,236,593,2,17,234,576,114,167,61,183,244,123,134,26,71,162,588,SF
1999,34,34,668,101,223,0,1,101,222,79,101,33,93,126,19,22,12,36,48,281,PF
1999,26,48,1525,183,382,0,0,183,382,184,226,173,297,470,67,21,34,96,136,550,PF
1999,33,2,7,0,1,0,0,0,1,0,0,0,0,0,3,1,0,0,0,0,PG
1999,33,47,798,62,168,1,6,61,162,21,29,36,74,110,23,20,16,21,73,146,PF
1999,33,50,1660,198,456,0,2,198,454,47,70,117,234,351,90,46,60,44,99,443,PF
1999,25,6,13,2,6,0,0,2,6,0,0,1,0,1,0,1,0,2,4,4,C
1999,25,4,8,1,4,0,0,1,4,0,0,1,0,1,0,0,0,1,4,2,C
1999,25,2,5,1,2,0,0,1,2,0,0,0,0,0,0,1,0,1,0,2,C
1999,23,30,337,53,182,12,42,41,140,28,37,7,21,28,12,12,1,29,30,146,SG
1999,35,50,924,108,256,0,8,108,248,30,52,82,146,228,25,28,8,19,69,246,PF
1999,28,1,2,0,1,0,0,0,1,0,0,0,0,0,0,0,0,0,0,0,PG
1999,29,43,1563,277,573,2,7,275,566,173,218,131,250,381,121,59,21,88,110,729,PF
1999,31,49,716,82,179,0,0,82,179,48,75,54,82,136,20,8,7,32,88,212,PF
1999,27,50,1944,301,717,40,140,261,577,149,211,74,210,284,266,111,23,150,111,791,SG
1999,32,48,1772,301,752,112,311,189,441,121,149,15,137,152,352,57,6,131,102,835,PG
1999,37,45,1120,120,291,43,117,77,174,26,32,13,54,67,187,44,4,52,66,309,PG
1999,35,35,1107,147,390,27,85,120,305,71,101,49,131,180,115,60,35,65,80,392,SG
1999,22,50,1114,148,320,10,25,138,295,102,143,88,126,214,45,30,6,73,112,408,SF
1999,18,21,160,18,56,0,5,18,51,9,15,20,19,39,5,4,2,11,26,45,PF
1999,25,41,903,156,304,0,0,156,304,88,122,72,174,246,15,6,25,61,103,400,PF
1999,28,36,602,73,181,11,50,62,131,36,48,21,46,67,31,18,7,18,52,193,SG
1999,32,50,1644,171,408,55,180,116,228,119,132,51,150,201,123,80,18,80,90,516,SG
1999,26,24,203,14,40,5,19,9,21,3,3,10,15,25,27,3,1,13,14,36,PG
1999,26,38,1142,187,423,0,1,187,422,100,149,100,150,250,28,33,19,58,96,474,SF
1999,23,50,1517,189,453,2,12,187,441,74,91,45,152,197,113,58,24,97,136,454,SF
1999,22,30,331,35,96,2,5,33,91,25,45,20,27,47,22,9,4,18,29,97,SF
1999,24,22,399,39,88,0,1,39,87,42,50,27,41,68,13,12,1,15,39,120,PF
1999,30,4,25,1,2,0,0,1,2,2,2,0,0,0,3,1,0,3,1,4,PG
1999,32,28,307,30,76,0,1,30,75,5,11,25,37,62,4,12,7,16,41,65,PF
1999,32,4,42,3,13,0,0,3,13,0,2,5,3,8,3,0,0,4,3,6,PF
1999,32,24,265,27,63,0,1,27,62,5,9,20,34,54,1,12,7,12,38,59,PF
1999,26,50,1852,384,802,0,14,384,788,285,379,65,290,355,300,80,27,184,114,1053,SF
1999,30,38,1104,122,268,0,0,122,268,81,150,115,172,287,35,34,16,59,145,325,PF
1999,30,17,517,50,118,0,0,50,118,46,81,51,83,134,17,18,8,24,68,146,PF
1999,30,21,587,72,150,0,0,72,150,35,69,64,89,153,18,16,8,35,77,179,PF
1999,26,12,87,6,21,1,9,5,12,6,6,2,9,11,4,0,0,3,11,19,SG
1999,24,16,102,9,32,5,17,4,15,7,10,3,9,12,3,5,2,9,16,30,PF
1999,24,3,12,2,5,0,3,2,2,1,2,0,1,1,0,1,0,1,6,5,PF
1999,24,13,90,7,27,5,14,2,13,6,8,3,8,11,3,4,2,8,10,25,PF
1999,35,48,1435,214,449,34,81,180,368,125,140,33,127,160,192,52,14,82,95,587,SG
1999,28,38,744,67,146,20,45,47,101,34,46,56,96,152,56,36,39,49,103,188,PF
1999,27,50,1815,294,703,57,140,237,563,168,195,20,132,152,137,35,9,130,115,813,SG
1999,25,36,1430,286,604,0,3,286,601,110,146,90,203,293,107,42,14,95,130,682,SF
1999,22,25,524,60,150,15,47,45,103,34,38,15,40,55,92,11,2,38,28,169,PG
1999,20,50,988,170,414,8,52,162,362,107,151,83,106,189,77,44,14,68,97,455,PG
1999,28,49,1755,228,524,59,153,169,371,67,89,26,142,168,193,86,8,92,126,582,PG
1999,23,5,171,29,57,0,0,29,57,18,30,17,27,44,4,4,7,9,24,76,C
1999,23,48,1990,435,1056,58,199,377,857,356,474,66,170,236,223,110,7,167,98,1284,SG
1999,25,50,941,141,348,10,27,131,321,61,79,43,92,135,167,39,3,75,75,353,PG
1999,31,47,861,108,284,53,147,55,137,32,39,21,78,99,49,41,9,37,63,301,SG
1999,28,49,1175,152,370,25,90,127,280,85,101,36,123,159,128,43,6,82,80,414,SG
1999,33,49,1382,138,329,32,103,106,226,65,79,33,151,184,386,42,3,99,58,373,PG
1999,23,27,271,46,108,1,7,45,101,21,32,30,24,54,8,3,11,26,29,114,PF
1999,23,2,12,3,5,0,1,3,4,2,2,0,3,3,0,0,0,1,2,8,PG
1999,23,16,42,9,24,0,0,9,24,6,12,6,11,17,1,2,6,9,11,24,C
1999,22,47,1058,178,394,3,10,175,384,90,153,131,170,301,34,38,16,68,102,449,SF
1999,24,49,885,91,225,5,19,86,206,57,82,16,59,75,107,35,7,65,67,244,PG
1999,33,50,1672,218,461,1,12,217,449,50,88,22,96,118,369,51,11,112,101,487,PG
1999,39,3,18,6,13,0,1,6,12,0,0,0,2,2,1,0,0,2,3,12,SF
1999,31,50,1027,96,189,0,0,96,189,64,105,120,200,320,19,29,57,47,151,256,C
1999,29,49,1639,210,458,33,92,177,366,134,164,91,193,284,119,34,10,89,147,587,PF
1999,23,29,476,39,123,19,61,20,62,11,22,9,33,42,41,18,5,29,30,108,SG
1999,22,24,344,43,119,25,62,18,57,14,17,6,38,44,42,13,0,17,23,125,PG
1999,22,11,131,14,44,10,29,4,15,11,13,2,11,13,13,7,0,5,7,49,PG
1999,22,13,213,29,75,15,33,14,42,3,4,4,27,31,29,6,0,12,16,76,PG
1999,27,20,724,96,227,20,64,76,163,59,80,20,56,76,61,35,24,21,42,271,SG
1999,27,30,1157,164,368,28,78,136,290,153,191,30,88,118,125,90,34,72,86,509,SF
1999,28,18,206,20,51,0,1,20,50,14,17,28,24,52,15,5,0,7,31,54,PF
1999,28,4,18,2,4,0,2,2,2,2,4,0,0,0,3,3,0,2,0,6,PG
1999,31,27,296,15,54,0,0,15,54,21,38,27,32,59,41,12,5,14,38,51,SG
1999,28,44,642,56,124,0,4,56,120,62,89,51,91,142,28,16,12,33,63,174,PF
1999,29,42,1475,277,575,1,2,276,573,307,389,131,257,388,101,48,45,127,159,862,PF
1999,24,1,5,0,1,0,0,0,1,0,0,0,0,0,0,0,0,0,2,0,C
1999,33,44,734,68,174,25,80,43,94,31,35,6,38,44,49,23,3,22,28,192,PG
1999,36,45,699,68,200,3,14,65,186,6,14,42,88,130,41,37,14,30,92,145,SF
1999,25,50,2060,310,698,45,123,265,575,181,239,87,252,339,539,114,19,150,108,846,PG
1999,29,8,42,2,7,0,0,2,7,0,4,1,10,11,1,2,1,4,8,4,SF
1999,26,19,63,6,14,0,0,6,14,11,18,6,8,14,4,2,1,4,12,23,SF
1999,24,46,1570,227,613,50,158,177,455,88,114,52,139,191,116,79,26,66,82,592,SG
1999,37,31,374,30,74,0,2,30,72,8,12,27,40,67,12,8,1,10,46,68,C
1999,23,39,1186,134,315,0,5,134,310,105,141,16,115,131,302,70,7,105,115,373,PG
1999,31,6,56,3,8,0,1,3,7,2,4,1,5,6,8,1,0,7,5,8,PG
1999,24,37,525,67,130,0,1,67,129,22,29,34,94,128,31,21,27,35,108,156,C
1999,30,44,1654,315,750,39,137,276,613,159,215,65,245,310,235,49,11,121,82,828,SF
1999,29,16,337,38,106,1,3,37,103,44,57,21,33,54,24,15,12,19,30,121,PF
1999,22,12,387,59,129,12,31,47,98,36,48,33,58,91,8,9,17,9,38,166,C
1999,32,21,386,32,99,0,0,32,99,16,23,33,60,93,13,5,12,17,43,80,C
1999,26,10,65,4,6,0,0,4,6,5,9,6,10,16,1,2,1,4,13,13,PF
1999,25,43,732,78,217,30,89,48,128,17,17,9,47,56,63,33,3,34,66,203,PG
1999,32,30,377,51,115,14,35,37,80,3,6,8,32,40,21,4,3,14,42,119,SG
1999,25,12,190,31,79,12,35,19,44,8,11,4,12,16,10,3,1,7,18,82,SG
1999,19,20,145,19,52,1,6,18,46,8,14,13,12,25,4,8,1,20,19,47,SF
1999,23,1,22,5,8,0,0,5,8,2,2,0,2,2,3,2,0,1,1,12,PG
1999,32,50,1380,151,359,3,18,148,341,184,235,100,196,296,53,57,16,74,143,489,PF
1999,30,39,933,140,290,0,0,140,290,59,76,59,162,221,45,23,21,53,119,339,C
1999,24,47,1218,169,379,12,44,157,335,87,135,69,97,166,62,49,14,82,128,437,SG
1999,21,15,188,28,65,7,16,21,49,12,21,2,4,6,25,5,0,11,28,75,PG
1999,28,43,1315,147,349,9,23,138,326,53,84,110,169,279,76,85,22,79,142,356,SF
1999,28,44,1083,167,384,87,219,80,165,51,58,14,81,95,55,35,4,33,94,472,SF
1999,28,19,577,86,212,42,108,44,104,28,30,7,46,53,23,20,1,20,53,242,SF
1999,28,25,506,81,172,45,111,36,61,23,28,7,35,42,32,15,3,13,41,230,SF
1999,29,17,365,63,159,9,33,54,126,50,80,18,47,65,16,5,5,25,34,185,PF
1999,29,7,69,4,20,1,3,3,17,0,0,3,2,5,4,5,1,6,6,9,SG
1999,40,16,127,5,18,0,0,5,18,3,8,7,16,23,2,5,1,6,22,13,PF
1999,33,48,1624,118,298,68,203,50,95,33,46,21,187,208,150,38,7,55,100,337,SG
1999,35,49,1832,393,797,0,1,393,796,378,480,107,356,463,201,62,28,162,134,1164,PF
1999,27,15,186,5,28,1,15,4,13,10,11,2,8,10,21,4,0,14,7,21,PG
1999,32,50,1184,187,386,1,9,186,377,78,112,62,157,219,113,36,38,69,129,453,PF
1999,21,49,1895,378,883,66,197,312,686,222,278,37,105,142,437,59,8,164,125,1044,PG
1999,21,18,661,124,304,8,39,116,265,63,87,17,45,62,167,29,5,55,44,319,PG
1999,21,31,1234,254,579,58,158,196,421,159,191,20,60,80,270,30,3,109,81,725,PG
1999,23,8,28,5,8,0,0,5,8,1,2,0,1,1,0,1,0,3,3,11,PF
1999,25,48,1250,208,494,26,72,182,422,88,121,115,227,342,66,47,37,80,123,530,SF
1999,27,37,941,102,278,31,106,71,172,61,76,5,43,48,144,43,4,67,82,296,PG
1999,26,24,855,134,297,13,30,121,267,75,104,24,122,146,75,20,3,60,58,356,SF
1999,31,43,1143,189,388,0,2,189,386,103,155,83,174,257,23,26,39,64,108,481,PF
1999,33,46,1007,164,421,80,231,84,190,84,114,13,72,85,76,30,3,67,111,492,SG
1999,28,9,126,7,19,2,10,5,9,4,5,0,3,3,23,7,0,11,13,20,PG
1999,23,2,4,2,3,0,0,2,3,0,0,2,1,3,0,0,0,2,0,4,SG
1999,24,32,659,64,177,13,50,51,127,40,57,36,79,115,40,24,13,40,88,181,PF
1999,31,48,1245,142,324,69,166,73,158,75,87,34,128,162,79,45,14,49,128,428,SF
1999,21,26,331,56,76,0,0,56,76,21,42,27,52,79,4,11,20,10,42,133,C
1999,24,50,1937,415,882,1,9,414,873,230,338,168,369,537,82,73,115,138,175,1061,C
1999,19,49,1106,168,385,8,35,160,350,114,157,120,158,278,113,52,66,80,94,458,SF
1999,26,22,269,22,51,0,0,22,51,4,6,31,23,54,2,9,32,13,59,48,C
1999,24,35,427,50,134,9,35,41,99,21,28,9,12,21,73,19,1,30,36,130,PG
1999,32,13,244,23,52,0,1,23,51,14,17,18,23,41,13,12,4,12,24,60,SF
1999,26,50,959,95,237,6,31,89,206,44,62,27,113,140,100,63,3,57,90,240,SG
1999,23,34,348,62,163,1,10,61,153,37,45,12,38,50,14,2,1,23,24,162,SF
1999,22,41,1551,305,707,5,30,300,677,83,105,37,118,155,104,67,12,89,81,698,SG
1999,26,14,70,7,28,1,5,6,23,1,2,4,12,16,1,0,3,4,22,16,C
1999,21,11,53,8,20,0,1,8,19,0,0,3,2,5,2,3,1,6,7,16,SG
1999,27,29,249,28,60,0,1,28,59,14,22,26,41,67,7,7,5,9,34,70,PF
1999,22,38,469,78,138,1,2,77,136,81,102,35,82,117,22,9,18,32,65,238,C
1999,28,4,35,5,11,0,0,5,11,0,0,7,1,8,0,0,2,4,3,10,C
1999,33,50,1787,294,671,106,275,188,396,226,247,25,110,135,112,37,9,76,101,920,SG
1999,29,47,1395,186,453,32,115,154,338,79,96,49,188,237,103,39,14,58,125,483,SF
1999,31,1,29,3,8,2,4,1,4,1,2,3,1,4,0,1,0,3,3,9,PF
1999,27,44,765,85,204,8,28,77,176,36,48,31,86,117,50,20,6,38,69,214,SG
1999,35,50,1344,213,522,9,38,204,484,126,165,55,127,182,98,35,16,34,111,561,SF
1999,23,49,1456,172,405,53,148,119,257,90,110,22,89,111,121,44,23,79,98,487,PG
1999,21,26,121,15,42,0,0,15,42,12,21,18,19,37,2,5,4,12,22,42,C
1999,27,46,577,42,80,0,1,42,79,11,32,45,94,139,14,12,27,16,107,95,C
1999,23,2,6,1,1,0,0,1,1,2,2,0,1,1,0,0,0,0,0,4,C
1999,33,44,535,64,149,16,56,48,93,40,46,54,67,121,23,16,11,21,54,184,SF
1999,28,46,1753,324,634,0,2,324,632,276,423,166,341,507,74,34,180,139,161,924,C
1999,35,50,1179,177,371,73,157,104,214,80,92,25,135,160,81,47,13,60,101,507,SF
1999,30,15,401,45,114,8,22,37,92,21,26,3,32,35,66,22,2,29,35,119,PG
1999,27,1,1,0,1,0,0,0,1,0,0,0,0,0,0,0,0,1,0,0,C
1999,25,50,1317,226,578,34,103,192,475,126,157,59,136,195,61,58,20,99,107,612,SF
1999,27,36,653,83,237,33,103,50,134,34,42,18,63,81,27,21,6,29,65,233,SF
1999,32,50,1829,173,338,0,0,173,338,195,285,192,418,610,57,16,147,94,145,541,C
1999,25,4,27,1,4,0,0,1,4,3,4,3,2,5,1,0,1,1,9,5,PF
1999,24,40,1269,114,314,49,131,65,183,38,46,32,82,114,219,37,2,83,98,315,PG
1999,23,50,1288,182,405,35,96,147,309,104,133,57,118,175,82,77,20,53,143,503,SF
1999,22,2,30,3,12,0,0,3,12,2,2,3,5,8,1,0,0,1,5,8,C
1999,35,50,949,106,251,23,61,83,190,68,84,15,60,75,41,28,12,41,126,303,SF
1999,25,12,140,13,40,6,15,7,25,6,16,4,16,20,24,7,0,16,17,38,PG
1999,20,47,958,136,336,14,68,122,268,99,128,41,121,162,47,29,27,73,105,385,PF
1999,23,18,165,24,56,0,1,24,55,8,8,18,16,34,12,2,3,8,22,56,SG
1999,20,36,311,36,83,0,1,36,82,18,35,42,55,97,13,4,14,14,41,90,PF
1999,26,49,1705,510,885,0,1,510,884,269,498,187,338,525,114,36,82,122,155,1289,C
1999,35,50,1633,140,327,1,5,139,322,67,83,96,278,374,168,46,21,96,182,348,PF
1999,36,50,1784,373,725,4,13,369,712,195,272,106,372,478,88,82,123,139,160,945,C
1999,29,2,11,1,3,1,1,0,2,0,0,0,0,0,0,0,0,0,2,3,SG
1999,26,8,72,4,14,0,0,4,14,5,7,0,7,7,3,3,1,3,9,13,PG
1999,26,7,68,4,13,0,0,4,13,4,5,0,6,6,3,3,1,3,8,12,PG
1999,26,1,4,0,1,0,0,0,1,1,2,0,1,1,0,0,0,0,1,1,PG
1999,23,45,1279,172,399,0,0,172,399,57,118,120,237,357,25,27,55,85,137,401,C
1999,25,48,1340,99,208,0,0,99,208,75,121,105,243,348,23,12,131,45,140,273,C
1999,27,31,851,84,154,0,3,84,151,35,81,54,113,167,56,40,43,58,79,203,PF
1999,29,24,244,36,84,2,7,34,77,18,20,7,14,21,23,5,1,20,18,92,PG
1999,29,6,33,6,12,0,2,6,10,6,6,1,1,2,3,1,0,3,2,18,PG
1999,29,8,174,25,57,2,4,23,53,12,14,6,11,17,16,3,1,15,14,64,PG
1999,29,10,37,5,15,0,1,5,14,0,0,0,2,2,4,1,0,2,2,10,PG
1999,29,21,451,65,165,5,11,60,154,28,35,35,45,80,38,12,4,33,37,163,SF
1999,29,25,468,75,174,0,4,75,170,72,88,9,27,36,81,20,1,49,41,222,PG
1999,23,2,3,1,1,0,0,1,1,0,0,0,0,0,0,0,0,0,0,2,SG
1999,26,48,1118,118,275,0,1,118,274,30,55,75,168,243,36,28,28,49,114,266,C
1999,23,35,284,43,97,0,5,43,92,28,36,30,35,65,15,19,7,22,62,114,PF
1999,23,24,144,21,51,1,6,20,45,22,31,17,13,30,2,5,3,12,16,65,SF
1999,30,50,2008,401,923,83,281,318,642,199,276,62,182,244,436,109,12,154,115,1084,PG
1999,29,28,810,103,272,34,114,69,158,30,41,30,54,84,78,35,6,38,60,270,SG
1999,33,37,445,38,60,0,0,38,60,14,26,33,105,138,18,9,10,22,63,90,C
1999,37,48,789,80,200,35,90,45,110,43,60,36,102,138,25,15,14,22,74,238,PF
1999,29,35,290,39,103,10,24,29,79,10,14,7,27,34,47,20,0,34,25,98,PG
1999,29,5,47,9,17,1,1,8,16,1,2,1,7,8,12,4,0,2,3,20,PG
1999,29,30,243,30,86,9,23,21,63,9,12,6,20,26,35,16,0,32,22,78,PG
1999,34,50,990,112,289,55,157,57,132,24,32,17,115,132,60,20,8,41,90,303,SF
1999,27,45,1342,198,437,75,200,123,237,32,53,19,123,142,80,37,16,41,52,503,SG
1999,29,43,1574,215,497,68,172,147,325,115,168,39,135,174,149,60,25,92,124,613,SG
1999,28,49,1242,180,417,65,165,115,252,88,102,39,101,140,53,44,6,53,86,513,SG
1999,21,48,1632,284,647,84,204,200,443,139,195,117,192,309,115,82,50,113,139,791,SF
1999,33,50,2011,261,604,72,212,189,392,132,183,63,260,323,293,98,37,159,118,726,SF
1999,23,16,259,33,61,0,0,33,61,16,23,38,44,82,4,8,18,5,41,82,C
1999,34,48,1481,169,358,1,1,168,357,29,94,184,241,425,43,20,30,49,150,368,C
1999,26,4,26,1,7,0,4,1,3,0,1,2,2,4,0,0,0,1,6,2,SF
1999,35,50,1365,172,370,58,141,114,229,123,148,13,127,140,146,48,11,74,97,525,PG
1999,23,50,1394,204,412,0,1,204,411,91,155,114,218,332,75,35,36,100,169,499,C
1999,23,17,467,55,126,0,1,55,125,33,49,23,71,94,16,11,16,28,53,143,C
1999,23,33,927,149,286,0,0,149,286,58,106,91,147,238,59,24,20,72,116,356,C
1999,30,40,806,100,207,46,112,54,95,46,61,18,60,78,113,33,1,65,90,292,PG
1999,25,50,1627,197,419,0,0,197,419,166,229,139,268,407,30,45,149,92,180,560,PF
1999,31,44,708,82,184,24,60,58,124,34,39,20,57,77,91,17,1,58,66,222,PG
1999,25,25,702,102,251,0,1,102,250,67,116,50,88,138,37,13,8,47,103,271,C
1999,26,11,112,8,21,1,3,7,18,8,14,3,4,7,11,4,0,7,13,25,PG
1999,25,47,935,97,174,0,0,97,174,48,79,66,104,170,33,27,43,36,156,242,PF
1999,30,41,1029,132,277,0,1,132,276,105,137,45,167,212,48,37,10,51,135,369,PF
1999,30,16,556,88,169,0,0,88,169,67,84,21,92,113,25,22,10,28,63,243,PF
1999,30,25,473,44,108,0,1,44,107,38,53,24,75,99,23,15,0,23,72,126,PF
1999,26,12,99,13,36,4,13,9,23,7,10,2,11,13,8,5,0,5,10,37,SG
1999,25,3,33,2,8,0,0,2,8,5,6,2,2,4,1,1,0,5,5,9,SF
1999,25,10,123,11,44,1,7,10,37,11,19,7,6,13,10,4,2,15,16,34,SG
1999,31,27,985,171,396,53,135,118,261,77,90,9,90,99,71,17,6,45,67,472,SF
1999,32,11,130,12,36,0,6,12,30,4,4,1,12,13,30,4,0,9,5,28,PG
1999,33,50,1912,331,803,70,221,261,582,251,293,30,142,172,122,64,10,136,121,983,SG
1999,27,47,1385,249,605,42,111,207,494,111,147,59,137,196,104,25,9,95,100,651,SG
1999,28,35,337,28,54,0,0,28,54,22,31,36,63,99,13,9,26,26,73,78,C
1999,28,6,33,5,13,0,0,5,13,4,8,4,7,11,0,0,1,4,2,14,C
1999,32,50,1740,299,629,58,139,241,490,163,234,69,158,227,128,75,59,88,153,819,SF
1999,33,49,1554,268,527,0,1,268,526,239,363,148,344,492,103,69,119,108,143,775,C
1999,26,47,1579,347,756,31,79,316,677,140,161,73,203,276,100,46,41,106,114,865,SF
1999,28,31,506,67,185,21,74,46,111,28,41,18,44,62,56,22,8,44,60,183,PG
1999,28,14,280,39,98,8,30,31,68,20,27,10,17,27,18,14,3,16,29,106,PG
1999,28,17,226,28,87,13,44,15,43,8,14,8,27,35,38,8,5,28,31,77,PG
1999,37,23,657,16,46,0,2,16,44,17,39,62,196,258,30,10,12,31,71,49,PF
1999,27,2,8,2,2,0,0,2,2,1,4,0,1,1,1,0,0,0,2,5,PF
1999,27,47,968,131,297,18,63,113,234,68,101,65,114,179,77,47,22,66,140,348,SF
1999,29,36,315,32,79,0,2,32,77,34,48,33,39,72,9,2,9,21,61,98,C
1999,26,49,1238,200,496,17,65,183,431,125,158,34,120,154,93,50,15,72,128,542,SF
1999,24,47,608,93,201,0,1,93,200,98,146,90,92,182,29,40,22,56,120,284,PF
1999,28,50,1770,217,468,52,147,165,321,136,171,65,201,266,74,76,15,76,154,622,SF
1999,34,50,1349,232,478,7,24,225,454,135,175,88,305,393,119,34,63,85,147,606,C
1999,25,6,39,5,11,0,0,5,11,1,2,2,5,7,2,2,0,2,4,11,SF
1999,39,19,143,11,29,0,0,11,29,6,8,3,11,14,4,1,2,8,23,28,C
1999,30,16,67,4,16,0,0,4,16,3,4,7,12,19,8,0,3,10,17,11,C
1999,36,50,1765,259,549,34,86,225,463,200,243,77,293,370,184,41,26,103,152,752,SF
1999,30,36,738,87,213,37,97,50,116,23,31,8,50,58,40,15,3,19,49,234,SF
1999,30,15,206,17,56,8,29,9,27,1,4,3,17,20,8,3,1,5,17,43,SF
1999,30,21,532,70,157,29,68,41,89,22,27,5,33,38,32,12,2,14,32,191,SF
1999,28,31,731,95,231,6,23,89,208,55,61,23,69,92,36,30,5,33,68,251,SF
1999,33,9,88,4,20,0,0,4,20,7,18,5,16,21,2,4,6,10,15,15,C
1999,32,32,367,44,90,0,0,44,90,19,29,41,88,129,13,5,13,27,66,107,C
1999,32,1,5,0,1,0,0,0,1,0,0,0,1,1,1,0,0,1,1,0,PG
1999,23,9,14,1,8,0,0,1,8,0,0,3,0,3,0,0,0,2,2,2,C
1999,24,18,185,15,39,2,7,13,32,8,13,6,16,22,16,3,0,7,12,40,SG
1999,23,5,19,1,5,0,2,1,3,0,0,1,1,2,0,1,0,3,1,2,SG
1999,26,50,1448,150,324,0,1,150,323,156,242,110,229,339,65,36,13,72,128,456,C
1999,24,4,25,4,10,1,1,3,9,2,5,3,1,4,5,2,0,6,2,11,SG
1999,22,21,258,33,71,0,0,33,71,20,33,20,33,53,1,10,13,19,20,86,PF
1999,28,30,263,31,81,0,0,31,81,53,85,36,34,70,5,3,3,25,50,115,PF
1999,23,23,317,35,97,7,33,28,64,7,16,7,17,24,13,17,14,20,35,84,SG
1999,23,43,1418,223,522,0,3,223,519,142,188,154,200,354,68,32,66,66,147,588,C
1999,26,48,1098,77,144,0,1,77,143,76,128,135,215,350,48,46,18,60,107,230,PF
1999,29,36,1314,217,540,47,139,170,401,191,225,50,101,151,118,36,11,99,100,672,SG
1999,32,49,1271,310,633,0,2,310,631,108,132,73,202,275,52,18,52,75,159,728,C
1999,25,48,1716,149,348,5,21,144,327,110,150,25,137,162,301,100,1,111,149,413,PG
1999,31,26,159,15,33,0,0,15,33,12,26,18,28,46,0,5,10,9,41,42,C
1999,28,37,1233,215,518,21,77,194,441,155,191,41,115,156,91,46,2,79,65,606,SF
1999,23,18,199,14,37,0,0,14,37,19,20,19,15,34,5,2,11,9,31,47,PF
1999,24,42,1188,181,488,35,126,146,362,210,247,26,81,107,118,34,19,121,79,607,SG
1999,33,50,1686,269,728,78,269,191,459,74,100,33,130,163,235,69,5,83,135,690,SG
1999,22,23,313,53,125,0,3,53,122,21,40,27,48,75,12,10,23,32,58,127,C
1999,23,42,394,22,53,0,0,22,53,17,25,43,56,99,5,4,28,12,76,61,C
1999,28,46,1194,114,290,31,106,83,184,61,71,30,77,107,82,28,15,45,65,320,SG
1999,36,50,1410,200,410,16,50,184,360,137,169,31,115,146,374,81,13,110,107,553,PG
1999,21,48,1025,141,373,57,178,84,195,63,74,43,100,143,72,41,7,53,43,402,SF
1999,25,50,1673,249,629,44,142,205,487,89,122,41,126,167,312,49,4,110,81,631,PG
1999,25,33,567,89,221,18,59,71,162,53,65,12,71,83,64,40,2,36,44,249,SG
1999,28,32,357,50,101,0,1,50,100,19,26,26,52,78,9,7,8,13,28,119,PF
1999,32,44,1632,251,603,12,42,239,561,176,236,56,156,212,434,76,5,142,91,690,PG
1999,30,44,695,76,180,0,2,76,178,71,99,66,95,161,17,15,7,37,64,223,PF
1999,18,3,11,2,7,0,0,2,7,0,0,0,0,0,1,0,0,1,4,4,C
1999,25,50,841,70,210,9,45,61,165,65,103,21,81,102,152,46,14,67,98,214,PG
1999,24,36,724,82,198,26,68,56,130,17,23,30,71,101,24,28,17,34,97,207,SF
1999,22,46,1505,311,675,1,6,310,669,150,206,100,142,242,67,16,29,120,179,773,PF
1999,23,39,593,71,123,0,1,71,122,27,48,65,69,134,15,17,9,21,82,169,C
1999,26,50,1182,170,368,0,1,170,367,66,108,82,204,286,55,45,17,73,159,406,PF
1999,21,50,812,132,279,21,68,111,211,73,112,49,77,126,46,26,12,46,107,358,SF
1999,21,17,188,27,67,5,19,22,48,19,24,7,26,33,15,3,3,15,21,78,SF
1999,21,33,624,105,212,16,49,89,163,54,88,42,51,93,31,23,9,31,86,280,SF
1999,36,49,1539,240,440,0,2,240,438,74,106,96,238,334,101,42,19,88,196,554,PF
1999,21,49,786,108,201,0,1,108,200,43,80,80,102,182,38,44,44,42,140,259,C
1999,24,45,1362,287,602,0,5,287,597,145,235,127,224,351,77,29,23,66,122,719,PF
1999,27,50,1802,306,769,72,234,234,535,142,175,14,99,113,368,40,3,121,90,826,PG
1999,23,42,1576,322,752,16,53,306,699,256,298,114,244,358,65,43,53,133,134,916,PF
1999,25,10,103,13,24,0,0,13,24,8,10,13,21,34,1,2,8,11,22,34,PF
1999,23,19,87,11,30,2,8,9,22,20,24,1,10,11,12,5,0,14,14,44,PG
1999,30,37,481,59,155,0,1,59,154,9,14,36,110,146,11,15,6,17,54,127,PF
1999,35,2,12,1,4,0,0,1,4,0,0,4,2,6,0,0,0,0,2,2,C
1999,22,42,1549,303,735,65,176,238,559,113,202,106,253,359,130,63,28,119,142,784,PF
1999,22,39,568,88,190,0,1,88,189,53,98,46,97,143,6,9,16,37,87,229,PF
1999,24,46,1231,115,199,0,0,115,199,47,132,137,247,384,18,50,90,36,111,277,C
1999,24,48,812,153,354,0,0,153,354,105,150,54,117,171,46,12,43,70,92,411,SF
1999,24,49,1414,242,476,13,31,229,445,131,179,57,184,241,60,48,54,80,175,628,PF
1999,28,33,506,35,95,12,38,23,57,19,23,10,40,50,58,10,3,32,63,101,SG
1999,28,50,1556,135,334,53,149,82,185,55,78,23,149,172,271,103,8,131,105,378,PG
1999,24,38,761,73,184,37,97,36,87,22,32,35,54,89,30,25,18,34,87,205,SG
1999,26,3,18,1,2,0,0,1,2,0,0,0,1,1,1,0,0,1,1,2,SF
1999,28,49,1040,141,264,0,0,141,264,115,143,72,171,243,34,28,17,61,107,397,SF
1999,25,42,1719,378,778,4,34,374,744,79,174,149,396,545,173,60,89,148,145,839,PF
1999,22,7,35,11,20,1,3,10,17,8,18,4,5,9,3,1,1,6,5,31,SF
1999,35,38,451,62,178,1,1,61,177,18,22,20,59,79,18,13,12,17,79,143,C
1999,28,50,1848,243,545,61,170,182,375,159,191,23,138,161,322,100,10,142,130,706,PG
1999,31,14,294,31,65,0,2,31,63,19,25,5,20,25,19,16,7,12,38,81,SG
1999,38,49,499,22,59,0,0,22,59,16,45,49,76,125,13,4,22,17,81,60,C
1999,25,46,590,73,193,22,60,51,133,40,55,11,34,45,102,26,2,48,59,208,PG
1999,22,20,191,17,32,0,0,17,32,15,35,23,35,58,1,3,11,16,39,49,PF
1999,27,39,441,64,156,32,95,32,61,27,31,8,39,47,69,18,2,36,49,187,PG
1999,39,27,252,50,132,5,19,45,113,29,42,30,41,71,16,4,1,23,19,134,SF
1999,35,3,28,0,9,0,0,0,9,2,2,0,1,1,1,0,0,3,3,2,SG
1999,27,40,458,52,123,0,1,52,122,54,74,54,74,128,22,14,24,30,75,158,PF
1999,24,50,1051,95,237,14,42,81,195,44,52,19,63,82,130,51,12,56,94,248,PG
1999,26,38,780,80,219,6,26,74,193,111,139,34,47,81,37,27,8,49,76,277,SF
1999,40,6,34,4,8,0,0,4,8,2,2,3,3,6,0,0,2,2,2,10,C
1999,36,25,403,11,33,0,0,11,33,7,10,36,47,83,15,13,18,13,49,29,C
1999,23,50,1805,231,617,100,323,131,294,79,105,14,139,153,299,95,1,143,91,641,PG
1999,30,30,1020,97,218,0,2,97,216,48,85,147,213,360,33,24,60,46,126,242,C
1999,25,50,1154,124,248,0,0,124,248,107,159,158,191,349,23,63,7,41,108,355,PF
1999,32,2,15,1,5,0,0,1,5,0,0,1,0,1,0,0,0,1,1,2,PG
1999,27,1,6,0,2,0,0,0,2,1,2,0,0,0,0,0,0,0,0,1,SF
1999,30,7,46,5,17,0,0,5,17,4,7,3,11,14,1,3,2,4,9,14,C
1999,30,2,17,0,2,0,0,0,2,0,0,1,1,2,1,2,1,2,4,0,C
1999,30,5,29,5,15,0,0,5,15,4,7,2,10,12,0,1,1,2,5,14,C
1999,23,2,4,0,1,0,0,0,1,3,4,0,0,0,1,0,0,0,0,3,PG
1999,29,8,62,6,13,0,0,6,13,3,4,6,13,19,2,2,1,6,10,15,SF
1999,28,48,1044,147,347,63,144,84,203,89,107,36,107,143,80,37,28,63,101,446,SF
1999,25,50,1374,269,555,1,5,268,550,120,188,85,121,206,66,30,8,75,118,659,SF
1999,36,42,1216,187,447,0,2,187,445,130,155,109,241,350,67,28,28,86,134,504,C
1999,35,20,92,7,16,0,0,7,16,0,0,3,5,8,5,4,0,6,10,14,SG
1999,34,3,12,0,1,0,0,0,1,0,2,0,1,1,0,0,0,0,6,0,PF
1999,33,29,815,73,170,17,47,56,123,37,47,14,88,102,172,32,1,63,53,200,PG
1999,23,48,1135,119,260,0,1,119,259,81,117,142,219,361,33,26,36,48,162,319,C
1999,20,3,15,5,10,1,4,4,6,2,2,2,2,4,1,0,0,1,3,13,SF
2000,25,61,1578,274,646,3,23,271,623,146,193,101,190,291,98,59,28,106,147,697,SG
2000,25,46,1205,223,515,2,21,221,494,115,151,77,162,239,72,53,16,87,116,563,SG
2000,25,15,373,51,131,1,2,50,129,31,42,24,28,52,26,6,12,19,31,134,SG
2000,23,82,3223,594,1277,29,96,565,1181,446,551,218,607,825,271,89,87,249,244,1663,SF
2000,26,29,329,28,98,9,35,19,63,17,22,8,34,42,58,24,2,28,39,82,PG
2000,24,82,3070,642,1411,172,407,470,1004,353,398,83,276,359,308,110,19,183,187,1809,SG
2000,23,27,361,27,95,3,14,24,81,3,4,5,18,23,70,12,0,29,29,60,PG
2000,29,80,1684,306,700,1,6,305,694,223,291,62,204,266,95,35,37,139,161,836,C
2000,25,64,2201,377,860,55,178,322,682,271,309,80,178,258,220,90,11,167,149,1080,SG
2000,29,82,2593,434,986,85,220,349,766,196,253,55,170,225,420,139,8,130,230,1149,PG
2000,32,72,2094,306,782,132,397,174,385,37,76,83,256,339,123,94,16,95,118,781,SG
2000,26,82,2700,368,778,79,225,289,553,194,253,91,293,384,239,96,32,194,182,1009,SF
2000,25,73,1007,161,364,1,6,160,358,116,147,90,190,280,65,29,25,80,180,439,C
2000,32,82,1548,169,416,88,233,81,183,88,114,17,116,133,208,59,9,85,143,514,PG
2000,32,27,583,83,186,13,29,70,157,22,25,2,45,47,78,7,1,40,34,201,PG
2000,31,82,2590,484,1119,137,403,347,716,225,247,65,205,270,501,169,9,248,137,1330,PG
2000,25,82,1626,314,741,57,163,257,578,97,133,20,106,126,306,52,3,142,137,782,PG
2000,31,59,692,83,175,0,2,83,173,37,55,42,74,116,53,27,11,38,69,203,SG
2000,30,59,1173,151,352,1,4,150,348,94,137,64,218,282,74,17,38,107,128,397,C
2000,30,49,377,29,96,0,0,29,96,23,32,23,51,74,11,16,15,24,62,81,PF
2000,20,59,484,56,181,18,63,38,118,24,36,8,32,40,88,14,2,42,60,154,PG
2000,24,46,449,58,140,2,10,56,130,45,65,26,46,72,30,13,4,24,55,163,SG
2000,28,79,2849,514,1129,2,8,512,1121,281,412,227,378,605,148,47,66,213,288,1311,C
2000,36,20,620,106,222,6,26,100,196,71,110,71,138,209,63,14,4,44,48,289,PF
2000,32,72,1139,196,435,59,144,137,291,66,76,13,86,99,133,31,4,66,80,517,PG
2000,28,80,2726,327,707,164,399,163,308,127,157,50,322,372,291,103,31,142,228,945,SG
2000,26,16,159,15,33,7,18,8,15,4,5,0,12,12,33,2,0,13,23,41,PG
2000,26,8,85,9,18,3,9,6,9,1,2,0,8,8,17,2,0,6,14,22,PG
2000,26,8,74,6,15,4,9,2,6,3,3,0,4,4,16,0,0,7,9,19,PG
2000,30,62,1281,161,346,66,154,95,192,107,116,38,121,159,150,75,7,85,104,495,SG
2000,23,82,1505,219,459,1,8,218,451,102,151,152,258,410,63,47,70,67,249,541,C
2000,19,24,130,23,70,2,12,21,58,16,24,4,17,21,3,1,5,7,18,64,SF
2000,35,3,8,1,3,0,0,1,3,0,0,0,1,1,0,0,1,0,1,2,C
2000,21,48,862,145,350,31,89,114,261,49,82,21,67,88,54,31,22,74,122,370,SG
2000,26,1,3,0,3,0,0,0,3,0,0,1,1,2,0,0,0,0,1,0,PF
2000,27,82,1691,271,561,35,93,236,468,156,190,16,126,142,272,76,5,107,204,733,PG
2000,21,82,3155,459,1031,77,212,382,819,195,250,73,233,306,665,132,15,247,171,1190,PG
2000,23,13,305,34,101,7,41,27,60,37,44,8,26,34,39,10,2,24,27,112,SG
2000,32,73,2459,327,837,101,301,226,536,67,95,55,215,270,489,146,22,143,122,822,PG
2000,31,38,446,44,89,0,2,44,87,19,33,52,61,113,10,15,7,28,78,107,PF
2000,35,80,1731,157,358,17,51,140,307,79,87,25,110,135,299,65,4,59,119,410,PG
2000,26,13,118,7,13,0,0,7,13,15,24,13,18,31,5,2,6,10,25,29,PF
2000,26,11,113,7,13,0,0,7,13,12,20,12,18,30,5,2,6,8,24,26,PF
2000,23,11,143,16,46,0,0,16,46,10,14,15,17,32,7,3,14,6,23,42,C
2000,27,17,167,28,63,0,3,28,60,6,11,14,26,40,10,6,3,6,9,62,SF
2000,22,46,423,49,115,0,1,49,114,24,38,22,63,85,14,14,9,21,46,122,SF
2000,28,69,878,72,194,27,58,45,136,25,43,27,69,96,34,23,15,19,118,196,SF
2000,28,42,311,26,73,1,2,25,71,6,12,14,22,36,16,9,5,5,37,59,SF
2000,28,27,567,46,121,26,56,20,65,19,31,13,47,60,18,14,10,14,81,137,SF
2000,24,52,589,46,117,1,9,45,108,38,53,75,39,114,20,39,13,14,95,131,SF
2000,26,11,20,2,2,0,0,2,2,1,2,0,2,2,1,1,0,1,0,5,SG
2000,23,26,261,56,116,8,20,48,96,18,23,12,14,26,48,12,1,17,23,138,PG
2000,23,1,8,3,4,0,0,3,4,0,0,1,0,1,3,0,0,0,0,6,PG
2000,23,25,253,53,112,8,20,45,92,18,23,11,14,25,45,12,1,17,23,132,PG
2000,27,77,1901,266,555,1,5,265,550,114,149,160,337,497,60,71,190,74,260,647,C
2000,23,8,61,4,21,0,0,4,21,0,0,12,10,22,0,1,0,3,13,8,C
2000,20,81,2999,630,1306,0,2,630,1304,367,536,348,462,810,155,66,132,228,259,1627,PF
2000,29,71,2587,486,1042,53,132,433,910,187,208,44,194,238,629,134,30,184,158,1212,PG
2000,31,63,1096,148,328,2,10,146,318,36,52,35,132,167,66,20,18,45,114,334,PF
2000,31,30,602,82,176,1,3,81,173,25,31,11,66,77,41,8,10,28,53,190,PF
2000,31,33,494,66,152,1,7,65,145,11,21,24,66,90,25,12,8,17,61,144,PF
2000,31,38,673,93,258,67,187,26,71,11,16,9,45,54,86,24,5,39,62,264,PG
2000,25,6,45,4,14,0,7,4,7,2,2,3,4,7,3,0,0,3,8,10,SG
2000,30,80,2302,322,671,0,1,322,670,120,159,216,384,600,145,65,61,100,264,764,PF
2000,31,59,1625,157,435,3,6,154,429,62,84,23,121,144,202,61,15,105,120,379,PG
2000,27,37,289,29,70,2,13,27,57,11,18,3,24,27,49,9,1,31,35,71,PG
2000,21,66,2524,554,1183,46,144,508,1039,331,403,108,308,416,323,106,62,182,220,1485,SG
2000,34,75,1712,174,346,0,0,174,346,76,94,126,226,352,61,31,31,87,250,424,PF
2000,23,48,923,111,233,10,26,101,207,43,63,56,118,174,55,38,20,36,148,275,SG
2000,31,58,657,55,156,18,83,37,73,2,7,30,61,91,33,25,16,13,50,130,SF
2000,22,34,386,62,151,7,29,55,122,16,22,10,38,48,21,10,8,9,44,147,SG
2000,32,56,1024,139,340,79,177,60,163,25,30,13,125,138,63,19,13,36,85,382,PF
2000,29,74,1336,165,419,82,232,83,187,39,50,65,191,256,72,67,44,38,173,451,SF
2000,26,71,2159,323,675,0,2,323,673,206,345,189,293,482,119,62,20,170,269,852,PF
2000,38,20,242,12,24,0,0,12,24,3,3,33,48,81,9,8,8,4,30,27,C
2000,25,59,1548,226,471,1,2,225,469,148,221,174,287,461,49,43,116,72,204,601,C
2000,31,78,2538,370,829,0,6,370,823,247,358,168,422,590,129,56,150,127,269,987,C
2000,38,21,221,28,64,0,0,28,64,11,14,8,24,32,7,3,6,9,42,67,SF
2000,25,7,74,11,33,1,8,10,25,16,19,5,8,13,3,0,1,5,12,39,SG
2000,25,50,1092,185,463,31,93,154,370,91,106,36,124,160,81,30,14,112,101,492,SF
2000,24,79,1859,201,509,3,23,198,486,93,124,48,151,199,378,93,5,173,167,498,PG
2000,23,82,3126,788,1696,95,236,693,1460,436,551,150,326,476,322,110,92,178,263,2107,SF
2000,30,81,2899,545,1170,26,90,519,1080,390,445,69,232,301,729,102,8,267,255,1506,PG
2000,25,65,1581,216,402,0,4,216,398,135,208,102,287,389,26,33,124,71,175,567,C
2000,31,25,185,20,37,0,0,20,37,26,38,11,36,47,2,2,16,10,42,66,C
2000,30,69,2064,447,1002,44,134,403,868,209,248,172,290,462,90,56,24,125,165,1147,SF
2000,22,16,185,15,45,2,9,13,36,5,6,1,10,11,20,7,0,16,22,37,PG
2000,32,53,957,124,320,41,123,83,197,59,78,10,70,80,62,22,1,38,70,348,SG
2000,28,67,1309,120,273,18,54,102,219,9,21,23,115,138,80,44,14,46,158,267,SG
2000,31,56,601,53,127,6,26,47,101,8,8,46,85,131,27,15,10,20,73,120,PF
2000,31,26,224,22,62,1,10,21,52,2,2,15,28,43,10,5,4,9,31,47,PF
2000,31,6,30,0,2,0,0,0,2,0,0,4,5,9,1,0,0,0,3,0,PF
2000,31,24,347,31,63,5,16,26,47,6,6,27,52,79,16,10,6,11,39,73,PF
2000,32,71,1675,146,357,37,104,109,253,47,59,17,130,147,285,36,4,105,240,376,PG
2000,29,73,2264,311,764,99,275,212,489,182,216,63,222,285,321,102,43,144,167,903,SG
2000,24,81,1850,286,528,1,8,285,520,121,176,162,343,505,71,45,114,125,231,694,C
2000,23,57,820,96,197,0,3,96,194,46,78,65,114,179,25,13,73,34,80,238,C
2000,32,74,2347,446,979,51,141,395,838,296,377,124,508,632,175,34,130,173,195,1239,PF
2000,31,80,1924,276,607,8,39,268,568,85,104,30,142,172,290,58,11,103,178,645,PG
2000,32,3,9,1,2,0,0,1,2,0,0,1,1,2,0,0,0,0,1,2,C
2000,37,54,941,88,247,10,44,78,203,33,39,40,125,165,60,36,5,29,99,219,SF
2000,24,55,668,91,229,7,27,84,202,63,81,51,48,99,33,17,16,37,83,252,PF
2000,24,81,1885,288,653,63,174,225,479,196,231,135,381,516,89,44,60,121,203,835,PF
2000,30,69,937,106,251,33,80,73,171,80,93,17,58,75,128,27,5,54,104,325,PG
2000,38,22,398,76,177,0,0,76,177,32,39,45,62,107,21,13,8,27,74,184,PF
2000,23,75,1793,265,655,49,151,216,504,127,169,57,127,184,247,91,13,132,174,706,PG
2000,27,4,50,6,11,0,0,6,11,0,0,4,4,8,0,2,0,4,10,12,PF
2000,27,24,259,23,57,0,1,23,56,18,25,14,28,42,14,11,4,17,51,64,SF
2000,35,67,1095,194,454,95,242,99,212,24,32,11,89,100,89,32,9,40,66,507,SG
2000,31,82,1611,182,379,1,5,181,374,141,168,21,83,104,87,33,5,73,209,506,SG
2000,24,21,495,70,173,0,0,70,173,27,51,48,86,134,19,8,15,29,75,167,C
2000,24,68,1195,163,344,22,66,141,278,72,101,16,70,86,177,55,5,58,73,420,SG
2000,28,32,474,67,157,0,3,67,154,45,56,26,55,81,17,17,3,33,56,179,SF
2000,28,26,443,63,148,0,3,63,145,42,52,22,51,73,16,13,2,31,49,168,SF
2000,28,6,31,4,9,0,0,4,9,3,4,4,4,8,1,4,1,2,7,11,SF
2000,31,79,2479,313,712,0,0,313,712,284,371,235,461,696,105,38,100,121,267,910,C
2000,20,82,1523,182,433,25,111,157,322,97,153,48,117,165,309,97,19,140,201,486,PG
2000,27,5,22,2,6,0,0,2,6,0,0,3,6,9,2,1,1,3,2,4,PF
2000,30,74,2127,302,602,0,0,302,602,139,203,256,473,729,64,52,94,91,203,743,C
2000,31,54,701,80,220,31,103,49,117,26,38,15,85,100,70,38,5,44,72,217,PG
2000,29,79,1817,217,464,82,167,135,297,67,77,17,117,134,141,24,3,70,109,583,PG
2000,26,23,464,56,137,0,2,56,135,31,47,31,53,84,38,25,4,40,52,143,SF
2000,20,48,570,94,187,0,4,94,183,39,51,29,54,83,62,30,8,46,39,227,SG
2000,30,58,941,130,330,64,165,66,165,72,108,31,98,129,65,44,22,50,127,396,SG
2000,26,82,1831,225,443,0,0,225,443,94,160,156,283,439,58,63,66,108,275,544,C
2000,33,67,1211,153,325,8,24,145,301,35,39,9,98,107,160,36,0,48,81,349,PG
2000,26,46,682,120,279,9,40,111,239,47,59,36,52,88,55,35,5,32,58,296,PG
2000,24,8,95,17,46,3,12,14,34,3,5,14,12,26,5,1,1,6,10,40,SG
2000,24,82,3103,554,1270,119,291,435,979,269,324,78,201,279,208,116,45,165,226,1496,SG
2000,31,82,2374,384,764,7,26,377,738,230,333,174,482,656,244,103,103,190,251,1005,C
2000,22,81,1335,242,535,1,2,241,533,80,95,89,245,334,63,29,34,65,224,565,C
2000,33,20,309,45,90,5,16,40,74,25,28,13,16,29,34,17,0,24,26,120,PG
2000,25,72,1293,158,413,59,163,99,250,45,53,23,80,103,162,41,1,66,79,420,PG
2000,34,47,459,23,67,0,0,23,67,9,27,63,73,136,5,7,21,18,95,55,C
2000,23,74,2875,628,1281,1,11,627,1270,459,603,262,656,918,234,66,165,242,210,1716,PF
2000,27,82,2096,282,675,60,163,222,512,84,102,23,147,170,347,59,9,132,223,708,PG
2000,24,39,351,41,88,0,0,41,88,43,64,34,58,92,8,9,4,26,61,125,PF
2000,36,79,2217,195,457,74,186,121,271,126,149,48,201,249,193,73,9,130,156,590,SF
2000,31,19,391,38,106,13,37,25,69,25,32,6,41,47,28,12,2,19,34,114,SF
2000,39,42,564,66,159,37,100,29,59,9,13,13,43,56,14,13,0,20,45,178,SG
2000,39,18,324,47,101,23,65,24,36,6,9,7,27,34,6,6,0,7,23,123,SG
2000,39,24,240,19,58,14,35,5,23,3,4,6,16,22,8,7,0,13,22,55,SG
2000,29,58,1309,209,464,3,21,206,443,66,95,98,192,290,59,32,25,52,133,487,PF
2000,32,30,269,19,43,0,0,19,43,15,21,29,38,67,13,10,8,13,67,53,C
2000,24,31,373,38,72,0,0,38,72,15,30,40,68,108,21,8,21,21,84,91,C
2000,37,62,2035,361,775,0,2,361,773,207,283,140,464,604,58,36,84,142,196,929,C
2000,30,74,1199,127,312,8,44,119,268,203,265,118,177,295,74,66,16,82,167,465,PF
2000,25,81,2241,181,423,3,3,178,420,94,133,264,491,755,68,43,38,59,206,459,C
2000,33,63,1326,189,380,33,75,156,305,52,57,55,183,238,67,22,24,55,181,463,PF
2000,26,82,3464,748,1636,99,247,649,1389,260,317,122,396,518,438,109,32,196,171,1855,SF
2000,25,78,1803,167,483,52,166,115,317,105,145,22,121,143,216,80,3,75,150,491,PG
2000,23,55,856,140,265,0,0,140,265,139,189,141,225,366,29,20,5,67,180,419,PF
2000,31,60,718,91,224,3,15,88,209,18,28,16,91,107,41,10,18,28,105,203,PF
2000,23,19,86,13,23,0,1,13,22,17,25,12,20,32,5,5,1,2,18,43,C
2000,30,82,1473,206,498,59,181,147,317,63,78,63,135,198,138,52,26,87,203,534,SF
2000,24,76,1654,193,380,0,0,193,380,34,90,174,250,424,42,26,136,71,218,420,C
2000,22,77,2776,497,1117,107,310,390,807,287,365,152,257,409,507,118,29,306,231,1388,PG
2000,25,41,399,51,122,0,0,51,122,32,53,36,74,110,5,9,8,27,46,134,C
2000,29,75,1026,184,352,0,2,184,350,115,163,98,136,234,33,32,20,40,91,483,PF
2000,23,81,3243,759,1526,30,81,729,1445,309,404,223,733,956,401,120,126,268,205,1857,PF
2000,33,56,604,48,108,0,0,48,108,18,26,41,99,140,19,8,40,21,94,114,C
2000,25,3,23,2,10,0,1,2,9,0,0,0,1,1,2,0,0,1,0,4,SG
2000,23,82,1479,258,585,79,197,179,388,80,111,44,166,210,58,31,19,85,197,675,SF
2000,32,85,1811,365,802,18,70,347,732,266,373,154,348,502,71,82,23,169,246,1014,PF
2000,32,45,1041,210,462,7,23,203,439,171,245,91,206,297,40,48,10,105,142,598,PF
2000,32,40,770,155,340,11,47,144,293,95,128,63,142,205,31,34,13,64,104,416,PF
2000,30,65,1406,260,589,0,4,260,585,109,140,154,233,387,39,29,22,91,194,629,C
2000,22,49,345,56,144,16,47,40,97,27,41,29,46,75,12,10,4,21,54,155,SF
2000,31,76,2355,396,956,20,78,376,878,181,255,82,201,283,210,139,41,89,211,993,SF
2000,35,50,782,133,305,0,1,133,304,67,86,72,137,209,42,12,16,55,83,333,PF
2000,21,30,446,66,171,12,45,54,126,51,70,15,23,38,27,15,4,28,28,195,SG
2000,27,63,1322,173,352,1,2,172,350,112,166,121,223,344,64,32,28,84,166,459,PF
2000,34,3,24,6,14,0,0,6,14,0,0,0,3,3,1,1,0,2,3,12,PG
2000,34,76,2688,266,599,0,4,266,595,80,111,167,424,591,188,55,60,61,192,612,PF
2000,27,21,124,15,37,0,0,15,37,19,29,11,14,25,5,5,3,4,22,49,SF
2000,36,82,1929,173,387,1,4,172,383,66,95,160,326,486,80,53,18,53,127,413,PF
2000,25,72,1927,175,413,16,57,159,356,119,158,128,244,372,177,116,15,93,222,485,SG
2000,30,54,1767,310,645,1,8,309,637,117,151,141,284,425,124,80,31,106,152,738,PF
2000,26,35,792,71,128,0,1,71,127,35,78,85,87,172,42,29,29,29,102,177,SF
2000,21,71,1373,254,605,28,77,226,528,103,133,38,91,129,108,28,6,84,142,639,SG
2000,24,22,273,35,79,0,0,35,79,12,23,31,59,90,15,4,14,28,25,82,C
2000,32,56,372,42,97,0,0,42,97,33,56,34,67,101,10,8,3,21,55,117,PF
2000,28,60,2253,378,798,33,102,345,696,226,286,91,256,347,315,94,38,153,164,1015,SG
2000,33,52,1672,246,638,94,256,152,382,110,133,25,125,150,385,49,4,119,112,696,PG
2000,36,80,2042,212,531,33,106,179,425,100,147,96,241,337,270,85,39,132,164,557,PG
2000,23,4,63,4,17,2,2,2,15,6,7,5,7,12,8,5,1,1,7,16,SF
2000,19,50,854,121,264,8,34,113,230,78,111,47,112,159,38,25,9,65,130,328,PF
2000,26,82,2677,420,830,0,2,420,828,236,298,196,367,563,97,36,58,217,287,1076,PF
2000,29,77,1510,198,463,38,115,160,348,79,99,53,134,187,100,65,6,42,98,513,SG
2000,29,19,137,17,30,0,0,17,30,7,12,8,25,33,5,1,6,12,20,41,PF
2000,33,61,1622,159,375,55,141,104,234,107,119,31,144,175,134,74,15,100,146,480,SG
2000,27,12,36,3,13,1,5,2,8,1,2,0,7,7,13,0,0,3,2,8,PG
2000,27,82,2775,429,930,1,10,428,920,224,334,265,306,571,77,81,54,139,233,1083,PF
2000,24,61,1107,129,326,1,15,128,311,69,104,34,106,140,55,39,17,68,99,328,SF
2000,25,15,71,5,8,0,0,5,8,3,4,3,10,13,6,2,1,3,8,13,PF
2000,25,10,47,5,7,0,0,5,7,2,2,2,9,11,3,2,1,3,7,12,PF
2000,25,5,24,0,1,0,0,0,1,1,2,1,1,2,3,0,0,0,1,1,PF
2000,24,45,597,45,124,24,67,21,57,27,40,12,40,52,111,15,2,42,74,141,PG
2000,27,74,2776,696,1422,34,98,662,1324,480,604,97,393,490,385,103,43,240,190,1906,SF
2000,31,68,2155,318,656,0,1,318,655,179,259,220,405,625,52,64,27,124,243,815,PF
2000,27,31,845,89,230,32,94,57,136,69,76,7,103,110,85,40,2,43,66,279,SG
2000,23,2,4,0,3,0,0,0,3,0,0,0,1,1,0,0,0,0,0,0,PF
2000,36,77,2133,358,728,66,138,292,590,171,180,49,133,182,202,66,16,113,149,953,SG
2000,29,76,1685,159,363,29,94,130,269,89,113,133,228,361,118,84,80,73,189,436,PF
2000,28,82,3169,614,1271,106,243,508,1028,280,334,38,233,271,224,65,14,186,219,1614,SG
2000,26,82,2909,509,1108,0,7,509,1101,202,275,132,338,470,247,67,21,225,299,1220,PF
2000,23,62,1592,204,541,60,193,144,348,77,95,28,120,148,242,43,0,108,65,545,PG
2000,21,82,2324,459,1147,29,125,430,1022,279,377,113,236,349,205,115,28,195,191,1226,SG
2000,21,50,1018,192,461,11,51,181,410,106,142,52,107,159,75,54,12,95,94,501,SG
2000,21,32,1306,267,686,18,74,249,612,173,235,61,129,190,130,61,16,100,97,725,SG
2000,26,21,224,35,72,0,1,35,71,12,26,24,25,49,9,3,1,14,30,82,PF
2000,29,82,2919,379,892,168,389,211,503,117,154,35,215,250,327,129,22,145,216,1043,PG
2000,24,70,2853,729,1733,89,261,640,1472,442,620,71,196,267,328,144,5,230,162,1989,SG
2000,26,73,1034,140,346,13,46,127,300,76,98,50,103,153,172,48,7,58,114,369,PG
2000,32,81,1691,186,488,108,306,78,182,33,51,34,147,181,118,54,7,66,157,513,SG
2000,23,7,73,1,11,0,1,1,10,5,8,1,10,11,4,3,0,7,7,7,SG
2000,29,79,2767,507,1235,117,303,390,932,186,212,101,293,394,230,57,10,185,167,1317,SF
2000,34,81,2190,246,570,89,221,157,349,79,98,63,233,296,650,76,10,174,111,660,PG
2000,24,52,681,108,212,9,24,99,188,30,41,25,46,71,32,30,3,33,113,255,PG
2000,24,3,18,5,9,0,0,5,9,0,2,0,1,1,2,1,0,2,1,10,PG
2000,24,49,663,103,203,9,24,94,179,30,39,25,45,70,30,29,3,31,112,245,PG
2000,23,4,23,5,14,0,0,5,14,1,3,3,1,4,2,0,3,2,1,11,SF
2000,23,43,1556,356,756,2,7,354,749,127,208,172,187,359,90,30,15,113,115,841,SF
2000,23,12,74,7,20,0,0,7,20,4,18,16,5,21,4,2,1,4,17,18,PF
2000,25,56,637,62,164,2,11,60,153,28,39,21,30,51,72,33,4,32,58,154,PG
2000,25,38,423,36,103,1,6,35,97,19,24,15,24,39,59,23,2,24,41,92,PG
2000,25,18,214,26,61,1,5,25,56,9,15,6,6,12,13,10,2,8,17,62,PG
2000,34,82,2571,402,850,1,9,401,841,114,155,33,125,158,491,76,18,140,150,919,PG
2000,24,5,37,3,9,0,0,3,9,0,0,3,4,7,0,1,0,3,5,6,PF
2000,32,80,2129,144,279,0,1,144,278,95,157,233,415,648,44,81,127,80,298,383,C
2000,33,6,113,16,28,1,1,15,27,7,7,0,16,16,24,2,0,7,6,40,PG
2000,30,70,2281,282,652,58,174,224,478,128,167,87,293,380,175,42,7,94,205,750,PF
2000,24,56,662,66,201,39,118,27,83,17,23,17,45,62,94,30,5,28,46,188,PG
2000,23,55,612,80,208,41,114,39,94,32,48,12,43,55,96,18,1,40,34,233,PG
2000,23,13,196,25,54,11,23,14,31,7,9,0,16,16,39,6,0,15,13,68,PG
2000,23,42,416,55,154,30,91,25,63,25,39,12,27,39,57,12,1,25,21,165,PG
2000,28,72,2807,478,1119,128,341,350,778,362,419,81,262,343,305,192,49,160,176,1446,SG
2000,20,33,138,22,58,2,4,20,54,11,18,16,22,38,5,6,5,14,10,57,SF
2000,29,40,330,44,104,2,3,42,101,14,19,41,62,103,19,3,6,13,50,104,PF
2000,32,36,243,17,53,0,1,17,52,7,13,16,25,41,32,12,2,19,29,41,PG
2000,29,62,604,53,130,0,1,53,129,29,36,45,91,136,34,17,13,46,90,135,C
2000,30,82,2492,484,1160,2,6,482,1154,493,635,231,494,725,138,100,96,291,371,1463,C
2000,34,32,268,32,74,16,31,16,43,9,11,3,16,19,12,4,0,7,14,89,PG
2000,37,72,1310,146,354,0,9,146,345,29,41,58,167,225,69,67,47,51,161,321,SF
2000,22,22,132,13,32,0,0,13,32,8,12,12,22,34,1,4,3,10,20,34,PF
2000,22,6,41,4,10,0,0,4,10,2,2,0,7,7,1,1,1,3,8,10,PF
2000,22,16,91,9,22,0,0,9,22,6,10,12,15,27,0,3,2,7,12,24,PF
2000,26,67,2616,350,855,56,166,294,689,203,245,96,387,483,678,134,28,226,148,959,PG
2000,27,62,1060,139,277,0,0,139,277,49,66,84,166,250,49,34,15,41,132,327,SF
2000,25,62,1896,305,698,96,240,209,458,101,127,46,179,225,142,79,19,56,120,807,SG
2000,38,7,31,4,11,0,0,4,11,3,3,0,6,6,2,1,0,2,7,11,C
2000,24,65,1754,230,558,2,10,228,548,140,184,38,155,193,458,107,21,157,185,602,PG
2000,25,63,410,46,118,0,0,46,118,17,28,46,83,129,23,6,23,26,88,109,C
2000,31,56,1784,297,728,44,168,253,560,192,265,75,198,273,265,77,28,146,112,830,SF
2000,31,24,868,148,388,18,78,130,310,118,155,37,93,130,124,44,19,75,51,432,SF
2000,31,32,916,149,340,26,90,123,250,74,110,38,105,143,141,33,9,71,61,398,SF
2000,30,82,2443,379,801,7,24,372,777,237,292,175,378,553,186,83,45,186,326,1002,C
2000,23,81,2435,392,879,60,183,332,696,162,236,170,471,641,97,42,180,96,292,1006,C
2000,33,19,244,28,64,0,0,28,64,3,7,16,44,60,3,8,6,5,31,59,C
2000,27,10,38,1,6,0,0,1,6,4,5,0,5,5,2,4,1,2,8,6,SF
2000,27,7,32,0,5,0,0,0,5,3,4,0,5,5,1,4,1,2,7,3,SF
2000,27,3,6,1,1,0,0,1,1,1,1,0,0,0,1,0,0,0,1,3,SF
2000,23,10,145,15,40,8,19,7,21,11,11,4,11,15,11,5,0,6,16,49,SG
2000,26,4,129,15,43,2,14,13,29,5,7,1,9,10,11,7,0,7,9,37,PG
2000,33,23,284,28,78,7,21,21,57,14,18,4,19,23,24,4,1,6,33,77,SG
2000,26,53,1434,228,560,89,228,139,332,84,106,37,116,153,136,41,15,80,127,629,SG
2000,22,74,896,111,298,23,63,88,235,38,52,46,67,113,40,24,15,46,158,283,SG
2000,20,82,1575,275,566,40,120,235,446,84,123,127,209,336,70,62,36,78,163,674,SF
2000,24,79,1081,155,373,19,55,136,318,52,62,25,105,130,170,49,13,92,129,381,PG
2000,33,42,920,74,167,0,4,74,163,55,71,86,148,234,43,45,10,49,108,203,PF
2000,31,72,1417,186,399,0,0,186,399,80,97,100,223,323,77,22,42,136,221,452,C
2000,25,65,781,111,261,3,18,108,243,67,109,59,65,124,44,32,17,53,94,292,SG
2000,22,8,146,19,39,4,8,15,31,6,8,2,10,12,17,3,0,9,17,48,PG
2000,29,75,2416,297,644,15,36,282,608,113,183,216,366,582,136,119,38,120,231,722,SF
2000,24,56,528,89,161,0,0,89,161,28,54,48,98,146,13,11,37,26,94,206,C
2000,29,23,333,37,122,21,64,16,58,19,20,7,32,39,24,18,1,19,45,114,SF
2000,30,16,143,18,49,2,6,16,43,4,6,6,17,23,8,2,1,8,24,42,PF
2000,20,77,1370,224,469,2,11,222,458,196,261,123,180,303,61,24,26,138,169,646,SF
2000,34,69,2308,170,422,110,304,60,118,56,69,27,306,333,206,89,17,62,156,506,SG
2000,36,82,2947,752,1476,2,8,750,1468,589,739,169,610,779,304,79,71,231,229,2095,PF
2000,28,51,1175,114,318,62,174,52,144,37,45,10,54,64,138,32,3,63,42,327,PG
2000,33,72,1217,149,339,1,4,148,335,34,52,50,158,208,73,62,29,55,183,333,PF
2000,22,74,2881,569,1317,66,233,503,1084,436,536,61,179,240,622,112,15,270,195,1640,PG
2000,21,51,1260,222,471,4,22,218,449,72,85,105,227,332,69,38,53,51,113,520,SF
2000,24,5,12,2,6,0,1,2,5,4,4,0,2,2,0,1,1,3,3,8,PF
2000,27,6,39,3,11,0,3,3,8,5,6,0,1,1,0,2,0,3,7,11,SF
2000,26,64,2071,331,840,49,138,282,702,199,255,189,448,637,167,68,68,123,180,910,PF
2000,28,71,893,133,350,38,124,95,226,98,119,7,37,44,122,28,2,62,89,402,PG
2000,27,76,2828,515,1158,112,278,403,880,186,239,64,317,381,298,79,14,180,215,1328,SF
2000,33,82,3133,317,661,0,1,317,660,314,421,145,554,699,367,74,29,160,220,948,SF
2000,32,10,109,16,36,0,0,16,36,14,16,7,20,27,3,2,5,9,13,46,PF
2000,34,47,989,169,490,67,223,102,267,108,148,15,64,79,75,38,9,53,83,513,SG
2000,25,61,879,78,230,34,110,44,120,39,54,33,77,110,70,24,23,67,83,229,PF
2000,32,78,2118,266,638,107,283,159,355,148,181,72,213,285,246,48,26,134,180,787,SF
2000,22,58,746,102,177,0,0,102,177,45,91,54,125,179,24,15,46,45,127,249,C
2000,25,81,2698,614,1211,0,2,614,1209,323,516,234,451,685,159,69,139,230,316,1551,PF
2000,20,79,2462,459,1018,18,65,441,953,277,392,188,313,501,263,90,151,160,201,1213,SF
2000,27,66,1048,64,154,0,0,64,154,29,56,106,124,230,36,26,117,38,205,157,C
2000,25,25,597,80,186,7,21,73,165,13,17,18,54,72,89,15,2,27,55,180,PG
2000,33,32,634,43,108,10,23,33,85,43,56,29,106,135,35,29,13,19,81,139,SF
2000,27,82,1952,244,593,44,121,200,472,121,146,47,199,246,240,108,18,113,194,653,SG
2000,24,44,860,131,332,2,13,129,319,54,70,41,97,138,52,16,5,59,84,318,SF
2000,23,68,2377,460,1080,15,48,445,1032,213,270,64,186,250,158,75,23,151,151,1148,SG
2000,23,37,1408,272,612,15,39,257,573,119,151,29,123,152,104,33,15,87,75,678,SG
2000,23,31,969,188,468,0,9,188,459,94,119,35,63,98,54,42,8,64,76,470,SG
2000,23,82,2093,339,755,10,49,329,706,226,292,85,195,280,476,84,17,166,194,914,PG
2000,28,35,476,52,97,0,0,52,97,26,51,49,115,164,16,11,10,19,68,130,PF
2000,23,55,961,135,293,0,2,135,291,153,195,113,180,293,45,23,35,48,111,423,C
2000,29,51,1088,137,233,0,0,137,233,49,73,87,174,261,68,42,80,74,132,323,C
2000,34,81,2987,466,1041,165,404,301,637,373,406,50,189,239,187,85,25,129,126,1470,SG
2000,30,20,649,123,292,8,30,115,262,68,84,46,77,123,47,18,4,25,60,322,SF
2000,32,82,1842,214,488,95,242,119,246,25,34,50,340,390,85,38,24,46,242,548,PF
2000,36,66,1227,168,376,10,23,158,353,81,92,28,110,138,111,27,14,44,116,427,SF
2000,24,81,2496,437,1016,104,292,333,724,299,353,59,229,288,208,87,32,186,171,1277,SG
2000,22,28,190,21,54,0,0,21,54,12,22,16,34,50,2,4,12,18,29,54,C
2000,28,51,332,17,55,0,0,17,55,6,12,18,54,72,7,6,9,22,81,40,C
2000,24,29,488,87,140,0,0,87,140,54,68,44,68,112,17,9,31,23,104,228,C
2000,29,79,2748,652,1184,0,4,652,1180,414,582,215,538,753,123,40,294,217,308,1718,C
2000,36,47,582,80,187,45,110,35,77,37,41,14,62,76,37,28,9,28,60,242,SG
2000,31,40,693,79,205,16,42,63,163,51,80,15,62,77,108,47,5,58,67,225,PG
2000,28,30,267,41,90,0,0,41,90,23,38,24,44,68,9,0,12,16,52,105,C
2000,26,74,2365,460,1019,51,139,409,880,204,268,127,296,423,132,105,36,184,208,1175,SF
2000,28,80,1831,290,670,113,263,177,407,120,141,63,208,271,72,45,24,84,185,813,SF
2000,33,82,2984,322,573,0,0,322,573,298,421,304,853,1157,105,27,269,174,248,942,C
2000,25,56,1532,173,363,60,149,113,214,75,85,34,87,121,272,37,3,102,122,481,PG
2000,24,73,2317,364,915,94,281,270,634,151,191,82,193,275,121,75,31,102,205,973,SG
2000,23,82,1723,206,433,0,2,206,431,59,103,135,244,379,93,21,85,71,262,471,C
2000,36,82,1763,278,623,72,190,206,433,192,229,39,115,154,65,53,11,89,207,820,SF
2000,26,30,502,69,159,12,29,57,130,57,73,16,52,68,94,23,1,30,32,207,PG
2000,21,82,2938,515,1118,116,306,399,812,289,348,102,430,532,203,63,68,141,256,1435,PF
2000,21,70,859,108,222,0,1,108,221,57,98,97,132,229,18,11,55,47,127,273,C
2000,27,79,3163,956,1665,0,1,956,1664,432,824,336,742,1078,299,36,239,223,255,2344,C
2000,36,80,2431,234,560,14,41,220,519,66,85,117,423,540,253,102,45,154,294,548,PF
2000,20,76,2767,449,1024,59,164,390,860,302,420,159,436,595,317,91,95,258,291,1259,SF
2000,37,44,1049,193,421,0,2,193,419,69,112,65,209,274,61,41,70,73,88,455,C
2000,27,40,290,22,49,0,0,22,49,28,37,4,27,31,46,10,0,10,27,72,PG
2000,24,80,2493,330,756,0,0,330,756,123,189,194,462,656,38,35,140,177,304,783,C
2000,26,81,1606,124,267,0,1,124,266,119,187,172,310,482,18,20,172,79,196,367,C
2000,28,82,2326,204,339,0,3,204,336,82,162,202,323,525,245,113,148,133,203,490,PF
2000,30,48,432,61,154,10,28,51,126,20,21,14,19,33,53,10,0,20,46,152,PG
2000,30,46,919,112,258,9,27,103,231,38,64,63,129,192,59,26,16,61,119,271,PF
2000,30,16,386,38,100,2,7,36,93,25,42,36,73,109,38,7,5,24,47,103,SF
2000,30,29,665,96,230,4,11,92,219,63,78,7,35,42,168,31,3,76,44,259,PG
2000,23,47,432,44,140,13,44,31,96,19,27,24,64,88,25,14,8,22,55,120,PF
2000,21,53,394,43,98,0,2,43,96,22,37,17,34,51,48,20,0,44,32,108,PG
2000,24,16,185,24,57,1,14,23,43,8,11,5,22,27,10,8,4,11,13,57,SG
2000,27,56,808,72,145,0,1,72,144,24,37,55,128,183,35,29,45,28,115,168,C
2000,24,5,20,3,4,0,0,3,4,0,0,1,1,2,1,1,0,1,4,6,PF
2000,24,81,2097,354,661,12,27,342,634,222,321,218,216,434,126,94,40,144,190,942,SF
2000,31,82,3425,747,1666,177,520,570,1146,311,423,100,429,529,732,153,18,224,178,1982,PG
2000,30,82,2073,316,725,85,255,231,470,87,109,58,174,232,195,62,10,85,171,804,SG
2000,34,67,1012,59,168,0,0,59,168,50,105,88,174,262,65,14,42,78,126,168,C
2000,38,81,1620,184,441,89,218,95,223,80,97,64,225,289,68,31,33,63,136,537,PF
2000,30,60,803,128,294,11,39,117,255,50,62,13,48,61,139,39,1,60,47,317,PG
2000,35,37,340,37,123,24,95,13,28,4,8,6,47,53,22,5,2,12,56,102,SF
2000,28,79,2056,280,654,106,250,174,404,61,77,44,223,267,146,40,19,60,119,727,SG
2000,30,28,825,152,335,30,91,122,244,47,65,17,54,71,79,41,8,48,72,381,SG
2000,29,75,1712,238,573,93,243,145,330,85,100,74,148,222,81,44,13,57,140,654,SF
2000,22,73,2583,486,1099,96,280,390,819,359,450,83,313,396,221,152,62,178,237,1427,SF
2000,34,82,2749,388,860,86,263,302,597,160,223,114,399,513,406,117,41,208,208,1022,SF
2000,24,76,1336,149,283,0,0,149,283,114,159,168,236,404,43,55,59,50,213,412,C
2000,35,82,1819,203,398,1,2,202,396,28,90,166,287,453,37,30,84,70,260,435,C
2000,36,68,1613,207,463,90,207,117,256,137,170,24,167,191,221,50,9,100,79,641,PG
2000,23,81,2052,230,536,82,220,148,316,120,150,85,232,317,146,98,33,95,207,662,SF
2000,24,79,1797,307,615,0,1,307,614,109,160,182,317,499,77,41,29,145,239,723,C
2000,31,41,424,41,119,25,68,16,51,34,39,8,29,37,69,17,1,47,63,141,PG
2000,22,33,225,21,59,3,17,18,42,4,10,2,24,26,25,7,4,19,26,49,SG
2000,23,3,24,2,7,0,0,2,7,3,6,2,6,8,1,2,1,5,5,7,C
2000,26,57,1795,247,491,0,0,247,491,182,236,140,295,435,36,32,171,108,185,676,PF
2000,32,7,28,3,7,1,4,2,3,0,0,0,4,4,5,0,0,0,1,7,PG
2000,26,69,1773,252,562,0,4,252,558,107,165,126,264,390,82,33,38,119,245,611,C
2000,27,3,48,3,12,0,3,3,9,5,5,2,2,4,13,2,0,6,8,11,PG
2000,26,38,498,60,112,0,0,60,112,24,34,31,71,102,11,24,31,23,118,144,PF
2000,26,21,165,16,34,0,0,16,34,3,6,5,20,25,1,5,12,11,45,35,PF
2000,26,17,333,44,78,0,0,44,78,21,28,26,51,77,10,19,19,12,73,109,PF
2000,31,34,602,53,127,1,7,52,120,43,56,29,88,117,18,19,5,20,81,150,PF
2000,26,1,8,0,3,0,0,0,3,0,0,1,0,1,0,2,0,2,0,0,SF
2000,32,80,2530,421,980,84,229,337,751,346,396,56,271,327,176,47,12,114,179,1272,SF
2000,34,74,2397,447,1049,93,241,354,808,298,340,37,176,213,185,110,13,154,191,1285,SG
2000,28,60,2084,449,1072,56,180,393,892,204,260,63,195,258,219,41,6,168,132,1158,SG
2000,29,5,51,5,16,0,1,5,15,0,3,6,9,15,3,1,1,2,15,10,C
2000,23,1,25,2,6,0,2,2,4,1,1,0,0,0,0,0,0,0,0,5,SG
2000,33,80,2839,530,1142,120,324,410,818,298,381,105,254,359,224,90,61,166,239,1478,SF
2000,34,80,2557,528,1031,0,2,528,1029,371,511,193,577,770,142,97,183,164,247,1427,C
2000,23,67,1112,212,386,0,4,212,382,47,64,54,130,184,32,48,25,39,67,471,SF
2000,27,81,2909,690,1461,86,237,604,1224,227,283,107,378,485,193,78,41,223,212,1693,SF
2000,38,12,389,12,31,0,1,12,30,10,14,48,123,171,14,2,1,19,41,34,PF
2000,28,53,1101,170,324,1,14,169,310,81,137,98,177,275,42,14,34,63,77,422,C
2000,28,82,2286,428,881,115,262,313,619,159,249,138,309,447,170,94,47,163,290,1130,PF
2000,26,40,355,35,88,0,1,35,87,19,41,33,47,80,9,2,38,10,36,89,PF
2000,30,71,1001,122,283,0,0,122,283,65,89,82,166,248,68,29,52,70,169,309,C
2000,27,80,2978,563,1196,77,196,486,1000,254,307,42,345,387,320,84,49,188,234,1457,SF
2000,25,74,1341,176,385,1,3,175,382,143,198,133,202,335,47,35,52,99,232,496,PF
2000,23,71,975,58,138,0,0,58,138,43,88,117,133,250,44,26,26,59,170,159,PF
2000,29,82,2900,408,914,106,268,302,646,237,316,99,328,427,158,128,23,101,255,1159,SF
2000,35,66,1688,302,598,7,19,295,579,167,198,97,416,513,118,43,78,97,184,778,C
2000,35,45,303,25,69,0,0,25,69,21,28,20,45,65,26,8,14,18,67,71,C
2000,37,77,1662,187,433,21,52,166,381,179,215,79,253,332,197,37,17,100,182,574,SF
2000,31,66,1263,125,333,71,189,54,144,48,57,16,90,106,69,28,9,30,104,369,SF
2000,29,82,2392,371,780,10,35,361,745,177,218,119,233,352,197,76,19,110,197,929,SF
2000,33,74,1249,123,322,18,58,105,264,41,54,45,171,216,201,35,14,75,105,305,SG
2000,27,69,1651,111,274,0,1,111,273,65,120,124,248,372,100,22,22,128,217,287,PF
2000,23,33,775,68,134,0,0,68,134,43,65,63,138,201,11,16,44,37,75,179,PF
2000,24,78,1975,289,623,1,1,288,622,195,258,186,298,484,88,45,85,119,302,774,C
2000,27,46,1145,108,192,0,1,108,191,73,101,121,210,331,56,27,23,45,127,289,SF
2000,30,82,2689,420,900,96,241,324,659,289,340,123,190,313,209,71,31,117,214,1225,SG
2000,33,79,1852,431,890,0,1,431,889,156,211,94,307,401,85,20,100,108,249,1018,C
2000,26,82,2866,257,597,11,45,246,552,126,177,42,219,261,624,140,8,162,243,651,PG
2000,32,26,149,15,33,0,0,15,33,20,30,15,24,39,3,6,8,9,32,50,C
2000,29,82,3276,568,1305,44,127,524,1178,344,397,49,300,349,332,109,22,226,184,1524,SF
2000,24,25,198,17,51,0,1,17,50,18,27,15,30,45,5,4,11,17,47,52,PF
2000,25,82,3148,619,1447,83,288,536,1159,618,758,118,197,315,365,103,36,311,188,1939,SG
2000,34,37,1190,203,542,59,171,144,371,50,59,10,91,101,181,42,4,67,102,515,SG
2000,34,33,1108,192,508,56,161,136,347,45,54,10,81,91,170,37,3,64,93,485,SG
2000,34,4,82,11,34,3,10,8,24,5,5,0,10,10,11,5,1,3,9,30,SG
2000,23,30,202,29,79,0,6,29,73,17,36,21,26,47,3,10,11,22,44,75,C
2000,27,13,181,19,51,0,8,19,43,3,4,13,23,36,11,7,3,6,9,41,SF
2000,24,42,389,20,53,0,0,20,53,18,32,33,61,94,6,5,19,17,81,58,C
2000,29,45,691,86,189,17,56,69,133,64,77,23,61,84,61,18,12,33,56,253,SG
2000,37,82,2432,363,725,43,121,320,604,221,257,45,170,215,703,143,15,179,192,990,PG
2000,22,74,1749,321,717,100,267,221,450,135,153,74,202,276,106,52,7,88,97,877,SF
2000,26,78,2372,386,894,80,212,306,682,122,145,61,182,243,405,77,1,149,173,974,PG
2000,26,68,2025,316,730,73,186,243,544,162,195,69,254,323,211,105,13,102,190,867,SG
2000,29,58,663,122,224,0,0,122,224,40,56,44,96,140,22,15,18,24,68,284,SF
2000,33,69,2188,327,762,1,21,326,741,214,305,73,186,259,519,94,18,187,147,869,PG
2000,31,20,148,21,48,1,4,20,44,11,14,11,33,44,4,5,2,12,15,54,PF
2000,19,14,61,12,31,0,0,12,31,2,2,5,7,12,2,2,2,4,16,26,C
2000,26,73,2216,356,815,122,332,234,483,175,251,50,238,288,284,91,19,148,201,1009,SG
2000,22,73,2171,342,669,28,78,314,591,133,161,89,183,272,201,58,23,83,175,845,SF
2000,29,18,114,16,34,0,0,16,34,5,8,16,16,32,4,3,9,11,13,37,C
2000,25,6,34,5,14,1,1,4,13,0,0,2,4,6,1,1,1,2,5,11,SF
2000,25,1,5,0,2,0,0,0,2,0,0,0,1,1,0,0,0,0,1,0,SF
2000,25,5,29,5,12,1,1,4,11,0,0,2,3,5,1,1,1,2,4,11,SF
2000,23,62,2227,458,988,1,8,457,980,143,201,96,304,400,101,51,48,169,217,1060,PF
2000,22,81,1888,249,600,46,157,203,443,113,140,24,142,166,346,90,10,156,133,657,PG
2000,26,7,46,8,18,0,3,8,15,1,1,1,4,5,6,1,0,5,2,17,SF
2000,26,3,19,5,10,0,1,5,9,1,1,0,2,2,2,0,0,1,0,11,SF
2000,26,4,27,3,8,0,2,3,6,0,0,1,2,3,4,1,0,4,2,6,SF
2000,24,55,477,49,107,0,1,49,106,16,41,37,38,75,9,12,14,14,106,114,C
2000,22,72,1797,212,531,32,122,180,409,138,209,147,290,437,113,54,22,112,167,594,PF
2000,27,80,1971,270,535,1,3,269,532,100,128,144,361,505,82,51,42,105,278,641,PF
2000,22,80,2093,347,753,63,182,284,571,188,243,100,232,332,113,59,31,129,227,945,SF
2000,37,51,777,125,243,0,3,125,240,29,48,56,110,166,33,26,9,59,136,279,PF
2000,22,44,447,58,122,0,4,58,118,41,68,50,65,115,20,25,25,27,79,157,PF
2000,25,11,301,70,142,0,2,70,140,11,21,20,32,52,22,8,3,25,28,151,SF
2000,23,17,90,14,38,0,6,14,32,5,8,13,20,33,5,3,1,8,14,33,PF
2000,23,7,25,2,10,0,2,2,8,0,0,2,8,10,1,2,0,1,4,4,PF
2000,23,10,65,12,28,0,4,12,24,5,8,11,12,23,4,1,1,7,10,29,PF
2000,23,3,41,1,6,0,0,1,6,2,6,1,2,3,5,0,0,3,4,4,PG
2000,28,79,2950,473,1213,133,401,340,812,196,240,34,277,311,714,68,11,221,148,1275,PG
2000,24,80,2782,559,1257,84,228,475,1029,333,393,200,476,676,158,64,60,245,258,1535,PF
2000,24,78,884,109,262,14,34,95,228,57,76,11,54,65,121,32,0,77,92,289,PG
2000,31,43,292,32,89,0,3,32,86,11,16,26,65,91,11,6,4,11,45,75,PF
2000,29,8,40,5,17,2,7,3,10,1,2,0,1,1,0,3,0,4,2,13,SG
2000,23,82,3003,648,1506,73,285,575,1221,311,445,199,453,652,305,117,32,259,263,1680,PF
2000,23,71,980,137,305,0,0,137,305,86,126,77,195,272,38,10,35,64,108,360,PF
2000,25,81,1959,168,334,0,0,168,334,54,114,211,454,665,67,72,130,67,162,390,PF
2000,25,60,798,155,332,0,3,155,329,82,102,42,93,135,22,10,14,63,103,392,SF
2000,25,81,2845,542,1045,8,50,534,995,233,331,129,437,566,142,87,107,157,216,1325,PF
2000,29,33,389,38,91,5,20,33,71,12,16,8,28,36,65,6,0,29,44,93,PG
2000,29,72,1986,189,447,102,264,87,183,48,58,22,206,228,300,95,16,102,176,528,PG
2000,29,78,1615,215,419,0,0,215,419,135,183,128,321,449,93,51,49,100,165,565,PF
2000,26,75,2880,748,1548,27,95,721,1453,311,414,189,598,787,345,120,128,218,264,1834,PF
2000,23,66,1162,236,480,20,53,216,427,88,129,78,104,182,97,69,12,97,153,580,SF
2000,36,7,57,6,19,0,0,6,19,2,2,5,14,19,1,2,2,1,13,14,C
2000,29,82,2760,407,955,88,248,319,707,214,275,39,186,225,463,109,11,159,186,1116,PG
2000,32,38,581,59,145,0,3,59,142,34,40,18,53,71,43,12,8,19,80,152,SG
2000,39,22,127,5,12,0,0,5,12,5,8,6,25,31,2,2,4,6,23,15,C
2000,23,80,1537,228,450,0,0,228,450,113,211,202,351,553,15,31,83,94,234,569,C
2000,28,82,1627,217,521,96,255,121,266,112,132,20,114,134,313,55,5,107,166,642,PG
2000,28,81,1545,235,450,0,3,235,447,146,201,159,250,409,58,41,92,80,234,616,PF
2000,25,55,779,114,287,16,55,98,232,48,65,27,58,85,126,34,11,47,78,292,PG
2000,27,68,1378,165,386,25,72,140,314,134,169,55,101,156,93,44,16,66,165,489,SF
2000,24,81,2760,363,973,145,505,218,468,128,170,22,208,230,589,117,8,296,140,999,PG
2000,26,82,2102,257,456,0,3,257,453,175,284,277,512,789,68,95,21,105,196,689,PF
2000,30,8,76,7,9,0,0,7,9,0,0,12,13,25,1,3,6,3,13,14,PF
2000,28,75,1501,263,538,2,5,261,533,123,166,96,154,250,106,46,17,109,187,651,SF
2000,31,68,1488,213,426,0,0,213,426,94,129,177,271,448,28,40,66,65,230,520,C
2000,24,43,517,84,225,24,81,60,144,33,51,12,40,52,78,18,0,40,39,225,PG
2000,29,76,1859,312,681,102,261,210,420,101,123,69,237,306,157,49,44,113,190,827,SF
2000,26,76,1707,311,622,0,0,311,622,163,212,122,168,290,82,38,19,110,192,785,SF
2000,37,79,1679,236,569,1,3,235,566,131,164,201,281,482,49,36,48,98,256,604,PF
2000,25,25,508,61,179,29,98,32,81,39,51,11,40,51,66,23,2,37,32,190,PG
2000,36,7,32,1,9,0,0,1,9,0,0,1,1,2,3,1,2,2,7,2,SG
2000,34,36,350,31,90,14,43,17,47,10,15,1,25,26,61,20,0,18,37,86,PG
2000,34,23,248,23,62,11,29,12,33,9,13,1,16,17,44,11,0,14,23,66,PG
2000,34,13,102,8,28,3,14,5,14,1,2,0,9,9,17,9,0,4,14,20,PG
2000,20,72,2238,309,759,60,191,249,568,188,279,62,246,308,202,119,39,166,159,866,SF
2000,24,75,1205,180,361,1,3,179,358,87,135,117,188,305,21,29,40,66,203,448,C
2000,23,25,137,13,39,0,0,13,39,28,36,13,22,35,5,2,1,9,18,54,C
2001,31,41,486,120,246,4,14,116,232,22,29,5,20,25,76,9,1,26,50,266,PG
2001,26,29,420,43,111,4,10,39,101,21,36,14,45,59,22,14,13,34,54,111,SG
2001,24,81,3241,604,1280,12,64,592,1216,443,531,175,560,735,250,90,77,231,238,1663,SF
2001,27,26,227,18,56,4,16,14,40,12,18,0,25,25,36,16,0,25,29,52,PG
2001,23,65,1382,239,573,17,46,222,527,123,150,42,101,143,62,45,5,75,139,618,PG
2001,23,38,472,62,178,3,10,59,168,33,45,20,43,63,21,16,3,21,76,160,PG
2001,23,27,910,177,395,14,36,163,359,90,105,22,58,80,41,29,2,54,63,458,PG
2001,25,82,3129,628,1309,202,467,426,842,348,392,101,327,428,374,124,20,204,192,1806,SG
2001,24,37,288,30,84,8,30,22,54,9,13,4,27,31,68,13,0,20,27,77,PG
2001,30,82,1710,237,592,0,7,237,585,176,279,77,191,268,74,28,29,124,175,650,C
2001,26,82,2859,413,993,101,253,312,740,342,402,75,288,363,301,120,14,165,188,1269,SG
2001,30,33,849,88,227,11,33,77,194,59,71,16,57,73,134,44,2,52,62,246,PG
2001,33,21,169,14,57,10,39,4,18,0,0,3,22,25,13,10,4,7,13,38,SG
2001,27,82,2396,263,590,46,170,217,420,138,188,72,261,333,189,82,40,131,202,710,SG
2001,33,58,856,97,253,65,159,32,94,23,35,21,40,61,82,40,3,43,63,282,PG
2001,32,75,2767,413,1002,143,403,270,599,220,249,94,249,343,524,135,13,200,155,1189,PG
2001,26,81,2363,380,952,121,339,259,613,90,130,28,145,173,330,67,5,149,184,971,PG
2001,32,66,1182,127,266,0,4,127,262,57,87,60,99,159,98,48,21,48,105,311,SG
2001,31,52,845,96,270,6,24,90,246,28,40,50,172,222,58,20,23,54,94,226,C
2001,21,55,463,55,144,16,59,39,85,28,36,5,24,29,75,13,4,45,48,154,PG
2001,20,35,259,17,65,0,1,17,64,13,28,22,34,56,10,9,16,21,44,47,C
2001,29,76,2129,347,822,1,16,346,806,232,321,179,251,430,90,38,73,158,264,927,PF
2001,22,8,38,8,22,3,8,5,14,0,0,0,3,3,6,2,0,5,2,19,PG
2001,33,60,1079,183,412,44,105,139,307,68,80,6,88,94,110,30,2,60,63,478,PG
2001,29,67,1778,198,401,109,229,89,172,84,103,33,178,211,225,80,14,86,126,589,SG
2001,31,62,1010,103,255,46,132,57,123,64,73,16,78,94,130,28,6,53,66,316,SG
2001,24,40,845,108,201,0,3,108,198,44,69,73,160,233,16,27,60,37,126,260,C
2001,24,5,30,2,7,1,3,1,4,0,0,0,1,1,0,1,0,2,1,5,SG
2001,20,59,574,66,186,11,41,55,145,50,68,14,60,74,32,7,28,42,73,193,SF
2001,22,65,857,115,302,21,81,94,221,56,83,38,62,100,69,28,16,63,128,307,PG
2001,32,49,446,71,147,5,13,66,134,31,39,20,61,81,22,6,6,28,75,178,SF
2001,28,77,2457,347,788,37,97,310,691,187,226,38,184,222,473,110,11,127,246,918,PG
2001,22,82,3190,525,1157,108,285,417,872,143,188,47,257,304,685,107,12,248,148,1301,PG
2001,24,77,1790,248,587,73,194,175,393,144,171,32,126,158,260,51,11,111,178,713,SG
2001,33,69,2352,317,801,73,225,244,576,53,76,71,201,272,462,163,20,128,134,760,PG
2001,32,68,1305,130,294,2,8,128,286,51,83,181,219,400,59,42,22,73,165,313,PF
2001,32,30,387,23,47,0,0,23,47,8,15,35,50,85,8,13,5,18,75,54,PF
2001,32,38,918,107,247,2,8,105,239,43,68,146,169,315,51,29,17,55,90,259,PF
2001,25,64,1098,101,200,0,0,101,200,46,66,97,134,231,32,39,76,62,183,248,C
2001,36,3,34,0,2,0,1,0,1,0,0,0,3,3,5,2,0,4,3,0,PG
2001,27,6,19,2,4,0,0,2,4,4,4,3,4,7,0,0,2,1,4,8,PF
2001,24,55,933,120,252,0,0,120,252,53,78,77,169,246,42,29,111,53,146,293,C
2001,24,40,640,74,168,0,0,74,168,33,45,53,121,174,23,17,81,36,91,181,C
2001,24,15,293,46,84,0,0,46,84,20,33,24,48,72,19,12,30,17,55,112,C
2001,23,44,375,53,114,1,5,52,109,33,40,30,47,77,4,10,21,11,45,140,SF
2001,29,82,2685,211,581,103,307,108,274,98,161,45,200,245,132,83,53,74,269,623,SF
2001,25,57,696,80,144,4,11,76,133,27,44,62,51,113,30,37,12,24,95,191,SF
2001,27,3,19,0,2,0,0,0,2,0,0,1,1,2,7,0,0,1,0,0,PG
2001,24,10,149,25,63,1,8,24,55,14,17,4,7,11,32,5,0,9,9,65,PG
2001,28,82,2001,219,447,1,6,218,441,140,178,160,448,608,38,36,228,88,256,579,C
2001,21,74,2906,578,1215,0,2,578,1213,334,472,285,461,746,240,71,118,219,243,1490,PF
2001,30,78,2821,511,1134,33,91,478,1043,195,224,60,238,298,583,161,21,155,138,1250,PG
2001,32,26,339,40,95,0,3,40,92,22,34,8,46,54,11,9,7,8,37,102,SF
2001,32,6,74,9,20,0,2,9,18,6,10,3,15,18,5,3,1,2,10,24,SF
2001,32,20,265,31,75,0,1,31,74,16,24,5,31,36,6,6,6,6,27,78,SF
2001,32,7,155,16,44,12,32,4,12,4,5,0,11,11,12,4,0,7,10,48,PG
2001,31,80,2811,249,561,0,4,249,557,178,209,257,485,742,127,78,92,108,260,676,C
2001,32,54,1238,100,237,0,3,100,234,23,40,23,76,99,154,62,10,56,132,223,PG
2001,28,22,208,18,54,2,14,16,40,8,15,5,16,21,31,8,1,17,21,46,PG
2001,28,7,142,10,35,2,11,8,24,4,9,2,7,9,24,7,1,9,16,26,PG
2001,28,15,66,8,19,0,3,8,16,4,6,3,9,12,7,1,0,8,5,20,PG
2001,22,68,2783,701,1510,61,200,640,1310,475,557,104,295,399,338,114,43,220,222,1938,SG
2001,35,18,101,8,20,0,0,8,20,3,5,4,17,21,3,1,2,5,29,19,PF
2001,24,37,820,84,192,2,7,82,185,59,81,60,97,157,49,33,9,27,118,229,SG
2001,32,57,737,76,164,32,77,44,87,9,12,20,74,94,39,21,10,25,83,193,SF
2001,23,47,573,104,241,16,38,88,203,24,29,16,58,74,17,17,6,29,68,248,SF
2001,33,61,1000,129,305,86,213,43,92,10,14,22,108,130,42,10,9,12,76,354,PF
2001,30,4,41,7,15,2,6,5,9,1,4,1,2,3,1,3,0,0,8,17,SF
2001,27,70,1460,179,367,0,0,179,367,142,211,135,218,353,53,38,25,77,184,500,PF
2001,26,63,2127,304,580,1,8,303,572,150,225,196,527,723,52,66,136,63,205,759,C
2001,32,78,2337,367,834,0,6,367,828,288,406,157,451,608,104,60,140,144,280,1022,PF
2001,23,15,126,10,31,0,5,10,26,11,18,8,15,23,3,7,2,9,27,31,PF
2001,26,35,309,53,112,17,37,36,75,46,60,11,33,44,11,4,3,19,45,169,SG
2001,25,72,1630,195,480,6,40,189,440,65,103,46,134,180,268,73,10,119,154,461,PG
2001,24,75,2979,762,1656,162,397,600,1259,384,502,176,240,416,291,114,82,167,205,2070,SF
2001,31,76,2709,537,1132,30,98,507,1034,277,323,46,244,290,580,88,8,220,214,1381,PG
2001,26,35,624,64,111,0,0,64,111,37,57,47,94,141,11,13,31,25,89,165,C
2001,32,31,384,32,85,0,0,32,85,12,25,23,60,83,5,8,18,23,67,76,C
2001,31,40,559,101,229,22,73,79,156,37,43,34,72,106,20,16,7,32,61,261,SF
2001,31,13,166,28,71,11,40,17,31,8,10,7,19,26,7,6,3,9,19,75,SF
2001,31,27,393,73,158,11,33,62,125,29,33,27,53,80,13,10,4,23,42,186,SF
2001,29,9,153,10,30,0,0,10,30,1,2,5,15,20,9,4,2,5,14,21,SG
2001,33,77,1859,135,335,32,106,103,229,60,71,24,178,202,355,59,15,156,242,362,PG
2001,33,51,1309,93,222,20,64,73,158,39,46,14,124,138,236,37,7,98,160,245,PG
2001,33,26,550,42,113,12,42,30,71,21,25,10,54,64,119,22,8,58,82,117,PG
2001,30,81,2939,311,788,94,250,217,538,280,312,95,260,355,289,183,45,154,224,996,SG
2001,25,81,1720,249,519,0,1,249,518,142,240,136,298,434,72,32,154,90,244,640,PF
2001,25,35,752,82,199,0,0,82,199,63,105,58,128,186,34,16,44,48,101,227,PF
2001,25,46,968,167,320,0,1,167,319,79,135,78,170,248,38,16,110,42,143,413,PF
2001,23,78,1268,160,400,5,17,155,383,97,137,26,106,132,207,49,1,139,153,422,PG
2001,29,6,32,1,8,0,0,1,8,0,0,3,2,5,2,1,0,2,4,2,C
2001,33,34,683,97,255,20,51,77,204,63,92,46,138,184,39,10,21,42,53,277,PF
2001,32,47,804,91,239,2,16,89,223,48,56,9,39,48,138,27,6,59,87,232,PG
2001,23,23,222,27,71,0,1,27,70,17,24,12,25,37,6,2,3,11,27,71,C
2001,25,13,44,6,24,1,5,5,19,2,4,2,4,6,10,1,0,2,6,15,PG
2001,25,3,14,0,5,0,1,0,4,0,0,0,3,3,3,0,0,2,0,0,PG
2001,25,10,30,6,19,1,4,5,15,2,4,2,1,3,7,1,0,0,6,15,PG
2001,38,15,117,9,38,0,5,9,33,2,4,3,10,13,4,2,0,3,18,20,SF
2001,25,47,901,122,270,6,22,116,248,68,83,28,82,110,37,21,16,62,117,318,PF
2001,20,61,1050,107,304,41,117,66,187,27,34,9,80,89,141,43,14,85,68,282,PG
2001,25,81,1874,276,701,70,207,206,494,200,231,123,264,387,92,36,50,136,180,822,PF
2001,31,31,264,22,65,4,7,18,58,17,19,13,15,28,34,6,0,19,32,65,PG
2001,24,66,1495,178,517,48,143,130,374,79,116,47,90,137,227,67,14,91,160,483,PG
2001,28,20,192,25,47,1,2,24,45,12,19,21,16,37,3,7,9,16,45,63,PF
2001,28,5,15,1,4,0,1,1,3,1,4,0,0,0,0,1,1,2,4,3,PF
2001,28,15,177,24,43,1,1,23,42,11,15,21,16,37,3,6,8,14,41,60,PF
2001,36,71,956,162,382,62,145,100,237,43,51,16,69,85,75,27,8,39,66,429,SG
2001,32,68,1485,145,319,4,9,141,310,62,73,21,100,121,132,27,3,61,173,356,SG
2001,25,43,1038,126,314,0,2,126,312,67,126,97,153,250,59,17,58,82,123,319,C
2001,25,79,2060,275,588,74,183,201,405,121,156,26,137,163,304,61,14,109,120,745,PG
2001,29,27,209,25,51,0,0,25,51,12,13,15,37,52,7,6,4,11,28,62,SF
2001,29,17,140,15,29,0,0,15,29,12,13,9,24,33,4,2,3,7,20,42,SF
2001,29,10,69,10,22,0,0,10,22,0,0,6,13,19,3,4,1,4,8,20,SF
2001,32,78,2729,375,866,0,1,375,865,319,423,274,513,787,106,22,151,135,230,1069,C
2001,21,82,3192,409,957,85,274,324,683,228,337,129,279,408,598,170,36,226,267,1131,PG
2001,31,81,2162,242,487,0,4,242,483,96,152,233,373,606,103,44,76,67,199,580,C
2001,32,62,1290,133,318,50,127,83,191,45,55,28,126,154,137,64,12,77,101,361,SG
2001,30,66,1692,196,433,78,171,118,262,54,62,28,111,139,110,35,1,81,121,524,PG
2001,30,51,1261,139,314,58,133,81,181,35,41,18,91,109,61,29,1,56,92,371,PG
2001,30,15,431,57,119,20,38,37,81,19,21,10,20,30,49,6,0,25,29,153,PG
2001,21,7,70,12,29,1,1,11,28,7,8,1,6,7,11,5,2,5,7,32,SG
2001,33,19,228,12,25,0,0,12,25,9,22,24,29,53,7,1,1,5,34,33,PF
2001,31,31,345,44,118,26,69,18,49,18,23,10,27,37,28,10,7,24,52,132,SG
2001,27,67,903,107,193,0,0,107,193,47,82,91,145,236,32,41,33,51,198,261,C
2001,34,65,922,106,234,1,13,105,221,41,44,12,70,82,126,26,3,34,78,254,PG
2001,34,29,396,30,90,1,9,29,81,16,16,4,27,31,62,6,0,15,36,77,PG
2001,34,36,526,76,144,0,4,76,140,25,28,8,43,51,64,20,3,19,42,177,PG
2001,27,82,2288,383,923,54,168,329,755,185,235,76,185,261,160,75,17,101,171,1005,SG
2001,25,33,207,36,83,2,10,34,73,12,21,12,26,38,21,4,6,12,22,86,SG
2001,25,70,2618,425,1020,86,230,339,790,206,270,70,159,229,233,62,27,162,207,1142,SG
2001,32,81,2420,364,755,4,14,360,741,242,350,207,466,673,231,87,93,192,242,974,C
2001,23,77,1398,220,527,0,3,220,524,50,59,70,203,273,65,37,41,59,239,490,C
2001,20,76,1237,148,362,28,80,120,282,125,179,8,81,89,177,41,11,94,107,449,PG
2001,34,59,1094,122,303,8,40,114,263,86,115,21,53,74,144,36,4,79,93,338,PG
2001,26,48,1305,124,327,40,105,84,222,14,19,12,57,69,185,32,3,68,99,302,PG
2001,35,53,613,29,73,0,0,29,73,14,36,64,119,183,18,14,29,26,111,72,C
2001,24,82,3174,702,1406,7,27,695,1379,409,662,259,738,997,245,70,192,242,247,1820,PF
2001,27,24,263,35,91,1,6,34,85,35,39,5,19,24,54,17,0,25,17,106,PG
2001,35,46,634,56,170,5,19,51,151,43,53,23,59,82,52,29,8,37,46,160,SG
2001,28,82,2426,265,675,107,269,158,406,104,126,23,174,197,295,99,12,102,218,741,SG
2001,25,33,281,32,81,0,0,32,81,37,53,31,47,78,9,5,5,14,48,101,PF
2001,25,29,273,32,77,0,0,32,77,37,53,31,45,76,9,5,5,14,46,101,PF
2001,25,4,8,0,4,0,0,0,4,0,0,0,2,2,0,0,0,0,2,0,PF
2001,21,50,936,115,311,28,84,87,227,56,72,21,60,81,145,48,2,54,99,314,PG
2001,37,68,1506,104,246,36,100,68,146,55,69,38,117,155,131,58,12,60,112,299,SG
2001,32,52,1229,147,339,55,129,92,210,60,84,17,153,170,81,23,25,51,80,409,SF
2001,30,82,1948,298,642,7,22,291,620,169,214,199,295,494,93,67,74,108,290,772,PF
2001,33,9,40,2,7,0,0,2,7,2,2,2,10,12,3,0,2,3,13,6,C
2001,25,74,1331,92,200,0,0,92,200,67,102,135,231,366,40,41,58,53,220,251,C
2001,38,79,2107,294,684,0,2,294,682,172,251,124,461,585,92,53,91,151,229,760,C
2001,26,6,149,8,23,0,0,8,23,6,12,12,44,56,5,8,3,7,15,22,C
2001,34,80,1688,178,375,70,156,108,219,22,30,55,168,223,71,28,21,50,169,448,SF
2001,27,82,3443,711,1552,91,263,620,1289,252,325,109,316,425,360,118,32,190,174,1765,SF
2001,26,20,709,77,187,25,63,52,124,50,62,5,54,59,87,39,2,29,50,229,PG
2001,22,72,1580,278,646,10,39,268,607,117,161,76,237,313,76,30,19,124,175,683,PF
2001,24,6,203,29,50,0,0,29,50,42,54,29,69,98,5,2,0,10,22,100,PF
2001,32,62,451,56,133,3,9,53,124,10,14,29,83,112,32,9,12,25,76,125,C
2001,24,71,1152,100,213,2,7,98,206,47,91,144,245,389,33,39,28,52,152,249,C
2001,31,82,2291,287,646,118,300,169,346,95,122,80,245,325,262,70,29,136,225,787,SF
2001,25,58,1457,156,375,0,0,156,375,30,68,156,249,405,48,31,156,79,136,342,C
2001,23,80,3194,550,1219,133,336,417,883,358,438,190,363,553,517,141,31,265,274,1591,PG
2001,26,10,77,10,35,0,0,10,35,8,8,7,11,18,1,3,2,3,10,28,C
2001,30,59,698,120,242,0,0,120,242,48,77,74,122,196,17,9,13,32,44,288,PF
2001,27,13,73,7,22,0,0,7,22,2,8,16,13,29,5,3,2,5,14,16,PF
2001,27,10,62,7,15,0,0,7,15,2,8,12,10,22,4,2,1,5,14,16,PF
2001,27,3,11,0,7,0,0,0,7,0,0,4,3,7,1,1,1,0,0,0,PF
2001,25,8,149,7,37,0,7,7,30,5,6,2,10,12,18,7,1,9,18,19,PG
2001,24,81,3202,704,1475,19,66,685,1409,357,467,219,702,921,401,111,145,230,204,1784,PF
2001,34,70,831,75,156,0,0,75,156,27,39,65,152,217,24,26,49,25,93,177,C
2001,24,76,1579,223,576,97,224,126,352,85,98,51,159,210,51,40,15,68,241,628,SF
2001,33,74,1670,329,733,28,92,301,641,156,228,99,292,391,61,52,27,119,185,842,PF
2001,31,35,542,88,224,0,2,88,222,37,54,50,89,139,14,12,8,25,73,213,C
2001,23,59,593,64,207,15,68,49,139,39,55,35,75,110,19,15,15,34,87,182,SF
2001,22,8,152,16,41,3,9,13,32,4,5,0,9,9,24,4,1,10,9,39,PG
2001,32,31,892,107,323,4,14,103,309,65,90,32,99,131,87,47,7,48,64,283,SG
2001,22,57,929,141,336,9,46,132,290,47,69,39,92,131,69,49,10,54,92,338,SG
2001,29,20,201,30,80,9,34,21,46,13,17,1,11,12,34,9,0,15,13,82,PG
2001,24,12,133,7,18,1,3,6,15,4,7,7,14,21,6,2,1,8,14,19,PF
2001,28,82,2771,484,1010,0,1,484,1009,282,354,217,501,718,101,60,71,170,293,1250,C
2001,35,4,17,5,7,0,0,5,7,0,0,0,0,0,1,0,0,0,1,10,PG
2001,35,77,2390,263,569,0,3,263,566,131,169,220,325,545,121,51,61,48,181,657,PF
2001,37,82,1411,144,324,0,6,144,318,79,111,107,206,313,39,30,8,45,119,367,PF
2001,26,44,377,33,97,9,26,24,71,18,24,27,60,87,27,18,5,18,45,93,SF
2001,31,57,1159,149,380,3,12,146,368,61,77,76,179,255,55,47,21,51,110,362,PF
2001,22,33,630,78,192,27,69,51,123,15,18,10,26,36,64,9,5,24,35,198,PG
2001,27,29,540,39,80,2,3,37,77,29,49,56,65,121,25,17,21,33,85,109,SF
2001,22,78,2519,547,1249,40,146,507,1103,277,319,75,163,238,224,75,10,201,203,1411,SF
2001,25,3,19,2,9,0,0,2,9,5,8,3,5,8,0,0,0,2,4,9,C
2001,33,7,30,3,10,0,0,3,10,1,2,2,2,4,1,0,0,3,8,7,PF
2001,29,4,112,15,36,2,8,13,28,7,11,5,13,18,15,6,1,3,6,39,SG
2001,34,77,2613,408,1042,189,517,219,525,145,181,26,178,204,483,90,6,189,155,1150,PG
2001,37,47,1139,127,271,19,72,108,199,34,48,46,120,166,113,39,25,62,70,307,PG
2001,24,56,1615,238,524,13,52,225,472,134,165,90,152,242,102,42,17,90,161,623,SG
2001,20,78,1892,241,543,1,7,240,536,103,157,119,262,381,130,63,18,148,223,586,PF
2001,27,74,1815,247,507,0,3,247,504,171,224,139,249,388,56,34,45,145,237,665,C
2001,27,44,1267,180,386,0,3,180,383,120,154,102,187,289,36,19,26,104,136,480,C
2001,27,30,548,67,121,0,0,67,121,51,70,37,62,99,20,15,19,41,101,185,C
2001,30,73,2071,265,624,46,132,219,492,107,139,71,217,288,135,74,16,64,127,683,SG
2001,22,1,10,1,1,0,0,1,1,0,0,0,0,0,1,0,0,2,0,2,PG
2001,30,12,72,13,28,0,0,13,28,5,6,5,9,14,4,1,6,3,10,31,PF
2001,20,18,65,8,14,0,0,8,14,6,16,6,14,20,2,3,1,7,15,22,PF
2001,34,59,681,56,137,17,46,39,91,54,63,17,63,80,72,33,9,19,45,183,SG
2001,28,10,76,3,9,2,4,1,5,0,0,2,3,5,13,2,0,6,13,8,PG
2001,28,73,1810,298,671,0,1,298,670,173,271,180,226,406,50,51,29,126,164,769,PF
2001,25,55,961,102,262,1,8,101,254,30,46,19,71,90,79,29,23,63,101,235,SF
2001,25,25,408,29,96,16,55,13,41,9,12,4,17,21,56,14,0,20,43,83,PG
2001,28,4,133,19,43,1,1,18,42,16,26,8,17,25,25,5,2,11,9,55,SF
2001,32,76,2363,278,587,0,1,278,586,172,273,239,448,687,48,37,27,127,242,728,PF
2001,28,74,2247,217,495,103,250,114,245,136,157,21,287,308,263,98,12,74,155,673,SG
2001,30,79,1587,147,380,54,156,93,224,59,83,93,203,296,128,54,54,79,210,407,PF
2001,22,50,550,104,247,19,55,85,192,24,35,5,37,42,52,13,0,35,58,251,PG
2001,29,78,2858,542,1208,96,252,446,956,279,307,20,263,283,173,52,10,161,190,1459,SG
2001,27,81,2974,583,1218,0,3,583,1215,296,383,171,401,572,224,75,37,242,292,1462,PF
2001,27,54,1981,392,827,0,0,392,827,197,256,121,258,379,154,46,21,169,186,981,PF
2001,27,27,993,191,391,0,3,191,388,99,127,50,143,193,70,29,16,73,106,481,PF
2001,24,75,1008,125,372,22,109,103,263,85,104,38,67,105,162,37,3,92,82,357,PG
2001,22,50,1846,308,805,14,75,294,730,193,252,76,200,276,223,96,29,152,147,823,SG
2001,30,82,2002,298,783,152,407,146,376,77,96,32,137,169,222,102,12,68,172,825,PG
2001,25,24,616,114,234,0,2,114,232,53,78,65,95,160,18,15,37,60,78,281,C
2001,25,71,2979,762,1813,98,306,664,1507,585,719,50,223,273,325,178,20,237,147,2207,SG
2001,27,79,1648,231,526,39,104,192,422,65,88,74,172,246,161,87,7,103,139,566,PG
2001,33,16,114,16,40,7,18,9,22,0,2,1,11,12,7,5,0,3,13,39,SG
2001,30,56,1690,239,632,26,80,213,552,139,169,53,171,224,163,53,10,130,139,643,SF
2001,30,17,550,77,217,16,38,61,179,73,85,17,62,79,50,19,4,48,42,243,SF
2001,30,39,1140,162,415,10,42,152,373,66,84,36,109,145,113,34,6,82,97,400,SF
2001,26,48,1410,237,508,5,23,232,485,154,192,119,242,361,59,34,27,93,138,633,C
2001,35,83,2588,244,583,70,207,174,376,73,93,63,242,305,661,84,7,175,139,631,PG
2001,35,54,1802,170,403,57,165,113,238,64,76,42,143,185,498,63,7,117,83,461,PG
2001,35,29,786,74,180,13,42,61,138,9,17,21,99,120,163,21,0,58,56,170,PG
2001,22,77,1660,243,572,52,155,191,417,97,135,41,167,208,140,86,14,130,166,635,SF
2001,25,14,59,9,18,0,0,9,18,2,3,3,3,6,4,3,0,0,19,20,PG
2001,24,30,197,16,52,1,3,15,49,12,14,15,20,35,8,2,5,8,27,45,SF
2001,24,82,3394,800,1812,62,205,738,1607,382,534,280,435,715,164,114,28,199,225,2044,SF
2001,26,53,511,53,152,1,5,52,147,23,33,10,34,44,78,23,6,34,62,130,PG
2001,26,25,279,26,71,0,3,26,68,12,17,3,20,23,34,17,5,20,41,64,PG
2001,26,28,232,27,81,1,2,26,79,11,16,7,14,21,44,6,1,14,21,66,PG
2001,35,55,1290,134,300,1,6,133,294,41,60,21,64,85,237,33,4,60,90,310,PG
2001,20,78,1313,146,390,41,127,105,263,64,87,56,122,178,64,43,30,93,134,397,SF
2001,33,82,1981,108,198,0,0,108,198,50,93,205,408,613,40,44,97,47,257,266,C
2001,31,65,2105,246,598,51,163,195,435,102,128,90,273,363,127,39,29,97,209,645,PF
2001,24,71,1415,170,416,84,231,86,185,37,52,16,108,124,224,36,1,76,58,461,PG
2001,29,63,2282,388,871,90,238,298,633,228,270,75,217,292,171,110,58,135,183,1094,SG
2001,21,65,866,122,275,20,60,102,215,40,53,63,126,189,32,30,15,39,68,304,SF
2001,30,45,638,60,153,1,6,59,147,41,55,83,137,220,31,19,8,21,95,162,PF
2001,27,4,16,1,5,0,0,1,5,0,2,2,0,2,1,0,1,2,1,2,C
2001,27,2,8,1,2,0,0,1,2,0,0,2,0,2,1,0,0,1,1,2,C
2001,27,2,8,0,3,0,0,0,3,0,2,0,0,0,0,0,1,1,0,0,C
2001,30,67,836,64,159,1,3,63,156,39,63,90,119,209,36,28,20,40,102,168,PF
2001,31,68,1083,168,413,4,11,164,402,101,131,63,196,259,65,45,23,99,184,441,PF
2001,35,55,650,67,159,33,77,34,82,14,15,6,29,35,57,16,1,21,30,181,PG
2001,38,22,243,32,69,0,1,32,68,8,16,8,37,45,15,14,8,6,36,72,SF
2001,27,77,3065,451,1097,69,232,382,865,328,403,91,403,494,753,166,23,286,171,1299,PG
2001,28,45,706,90,176,0,0,90,176,36,45,39,90,129,31,14,11,47,94,216,SF
2001,25,53,1457,139,371,1,10,138,361,54,66,23,145,168,311,101,4,91,155,333,PG
2001,25,6,93,2,15,0,0,2,15,5,6,1,6,7,25,6,1,7,17,9,PG
2001,25,47,1364,137,356,1,10,136,346,49,60,22,139,161,286,95,3,84,138,324,PG
2001,26,45,256,10,53,0,1,10,52,9,18,19,34,53,5,5,11,10,47,29,C
2001,32,65,1597,275,582,70,157,205,425,101,160,66,193,259,199,48,11,111,98,721,SF
2001,32,48,979,151,330,32,78,119,252,52,88,47,115,162,93,35,6,60,62,386,SF
2001,32,17,618,124,252,38,79,86,173,49,72,19,78,97,106,13,5,51,36,335,SF
2001,31,53,930,165,323,1,3,164,320,67,82,75,137,212,67,40,27,70,159,398,C
2001,31,25,733,112,228,3,10,109,218,103,122,43,110,153,57,31,19,67,83,330,PF
2001,24,78,2457,387,812,51,139,336,673,183,262,173,434,607,107,37,206,97,290,1008,C
2001,24,65,1116,135,313,51,124,84,189,68,76,12,77,89,81,38,9,52,114,389,SG
2001,23,33,241,37,99,0,1,37,98,16,29,13,28,41,4,7,1,8,16,90,SF
2001,27,80,2331,336,846,147,382,189,464,153,192,47,184,231,190,65,18,102,170,972,SG
2001,23,35,402,50,123,9,25,41,98,15,21,14,33,47,18,10,10,17,78,124,SF
2001,21,78,2720,426,887,123,285,303,602,176,213,143,398,541,125,91,45,129,191,1151,PF
2001,25,2,7,0,2,0,1,0,1,0,0,0,1,1,1,0,0,0,0,0,PG
2001,28,9,20,0,4,0,0,0,4,0,2,2,6,8,1,0,3,2,5,0,SF
2001,34,66,1507,140,319,4,15,136,304,112,157,76,198,274,83,72,15,62,160,396,PF
2001,32,25,301,18,54,0,0,18,54,13,17,26,40,66,7,3,9,22,51,49,C
2001,26,47,1108,142,326,6,29,136,297,90,123,30,130,160,73,41,18,56,110,380,SG
2001,26,23,457,69,152,13,23,56,129,19,33,25,49,74,34,21,12,27,46,170,PG
2001,23,38,468,50,117,11,34,39,83,19,24,5,27,32,45,19,0,27,54,130,PG
2001,30,82,2649,274,616,15,57,259,559,123,171,200,390,590,139,99,30,109,222,686,SF
2001,25,63,597,109,185,0,0,109,185,42,66,69,99,168,10,7,19,27,96,260,C
2001,31,8,76,10,20,2,2,8,18,9,12,7,11,18,4,5,1,10,9,31,SF
2001,25,70,641,55,113,1,1,54,112,26,37,74,78,152,24,8,8,27,111,137,PF
2001,21,69,1359,225,487,17,56,208,431,223,288,88,203,291,82,35,9,106,140,690,SF
2001,22,74,1095,122,271,0,2,122,269,95,145,103,192,295,27,18,78,61,139,339,C
2001,35,53,1306,87,259,57,181,30,78,36,44,20,146,166,88,53,15,35,98,267,SG
2001,37,81,2895,670,1345,2,5,668,1340,536,676,114,555,669,361,93,62,244,216,1878,PF
2001,29,55,1403,146,348,51,142,95,206,26,34,14,103,117,154,56,5,70,94,369,PG
2001,34,82,1305,247,500,7,28,240,472,102,140,66,148,214,92,47,29,96,219,603,PF
2001,23,67,2557,563,1277,110,335,453,942,362,458,53,152,205,506,79,5,197,150,1598,PG
2001,22,79,2857,557,1160,21,82,536,1078,234,289,220,628,848,160,132,108,129,211,1369,SF
2001,27,81,2326,427,849,41,128,386,721,205,273,172,394,566,133,85,78,128,196,1100,SF
2001,29,31,176,29,76,14,27,15,49,31,35,2,14,16,14,7,0,10,27,103,PG
2001,23,68,2272,346,777,1,11,345,766,121,192,137,365,502,131,78,113,138,281,814,PF
2001,28,76,2989,573,1388,103,289,470,1099,279,364,92,484,576,411,85,13,211,185,1528,SF
2001,34,80,3254,460,954,0,0,460,954,370,474,169,601,770,248,80,25,179,231,1290,PF
2001,23,78,1522,189,439,18,67,171,372,67,91,72,177,249,63,39,20,53,146,463,SF
2001,33,52,823,92,199,0,0,92,199,49,70,75,135,210,9,10,28,48,122,233,PF
2001,35,43,660,73,223,34,111,39,112,21,32,4,62,66,49,21,3,35,64,201,PG
2001,35,24,375,42,125,21,64,21,61,15,22,3,34,37,29,12,0,18,33,120,PG
2001,35,19,285,31,98,13,47,18,51,6,10,1,28,29,20,9,3,17,31,81,PG
2001,26,60,478,45,126,19,56,26,70,22,28,24,57,81,39,14,7,20,82,131,PF
2001,23,6,58,9,18,0,0,9,18,0,5,10,7,17,1,0,2,3,11,18,C
2001,33,76,2007,250,655,77,234,173,421,152,181,55,169,224,279,53,27,117,165,729,SF
2001,23,70,1143,138,264,0,0,138,264,41,93,92,159,251,57,18,49,75,141,317,C
2001,26,70,2555,577,1165,0,0,577,1165,304,434,240,605,845,146,43,102,162,220,1458,PF
2001,21,77,3087,788,1724,59,166,729,1558,430,587,192,388,580,352,116,118,198,160,2065,SG
2001,28,18,193,10,28,0,0,10,28,8,12,8,27,35,4,7,15,9,35,28,C
2001,26,81,2831,432,933,52,144,380,789,130,161,41,179,220,447,75,7,113,199,1046,PG
2001,34,66,987,60,136,4,20,56,116,21,27,49,127,176,74,48,13,47,136,145,SF
2001,28,76,2394,338,714,53,170,285,544,149,194,33,278,311,377,106,8,203,178,878,SG
2001,25,35,922,145,332,2,22,143,310,45,51,38,82,120,58,23,8,58,90,337,SF
2001,25,34,907,144,330,2,21,142,309,45,51,37,81,118,58,23,8,57,88,335,SF
2001,25,1,15,1,2,0,1,1,1,0,0,1,1,2,0,0,0,1,2,2,SF
2001,22,55,595,109,216,2,12,107,204,42,58,40,39,79,38,25,4,47,80,262,PG
2001,22,33,308,47,96,0,6,47,90,18,24,20,28,48,16,12,3,23,48,112,PG
2001,22,22,287,62,120,2,6,60,114,24,34,20,11,31,22,13,1,24,32,150,PG
2001,21,7,39,12,25,1,1,11,24,7,12,1,8,9,2,1,1,3,9,32,PF
2001,24,61,2535,500,1121,14,46,486,1075,188,228,72,164,236,201,78,27,129,148,1202,SG
2001,21,59,1166,173,391,0,1,173,390,100,126,106,174,280,16,20,53,80,156,446,C
2001,19,81,2133,318,630,1,19,317,611,124,238,127,350,477,99,51,125,147,191,761,SF
2001,24,82,2848,452,999,17,64,435,935,375,450,94,266,360,657,119,28,265,229,1296,PG
2001,29,4,11,1,2,0,0,1,2,0,0,0,2,2,0,0,0,1,1,2,PF
2001,29,2,6,1,2,0,0,1,2,0,0,0,2,2,0,0,0,1,0,2,PF
2001,24,57,1434,168,386,1,5,167,381,168,226,144,275,419,107,33,38,73,176,505,C
2001,20,82,2390,368,845,148,364,220,481,91,128,66,261,327,140,51,19,97,200,975,SF
2001,35,81,3181,517,1176,170,464,347,712,323,348,38,247,285,260,81,15,133,162,1527,SG
2001,31,15,493,71,191,7,25,64,166,31,36,24,69,93,18,9,5,20,43,180,SF
2001,33,14,113,11,34,3,17,8,17,0,0,4,17,21,5,3,1,10,20,25,PF
2001,37,82,983,118,289,9,43,109,246,40,55,28,95,123,57,26,10,36,117,285,SF
2001,25,79,3002,527,1214,90,252,437,962,394,474,83,314,397,195,84,26,165,169,1538,SG
2001,23,58,912,176,369,0,1,176,368,89,126,115,192,307,19,29,35,64,113,441,C
2001,23,30,196,41,88,0,0,41,88,14,28,18,37,55,2,6,7,9,40,96,C
2001,23,28,716,135,281,0,1,135,280,75,98,97,155,252,17,23,28,55,73,345,C
2001,22,24,135,12,30,0,1,12,29,11,26,12,30,42,3,3,4,18,29,35,C
2001,29,54,649,56,138,0,0,56,138,8,31,52,121,173,19,11,26,41,115,120,C
2001,29,42,568,50,121,0,0,50,121,7,26,43,101,144,15,8,23,37,100,107,C
2001,29,12,81,6,17,0,0,6,17,1,5,9,20,29,4,3,3,4,15,13,C
2001,25,81,1154,132,268,0,1,132,267,95,130,121,195,316,33,24,61,74,202,359,C
2001,24,73,989,123,277,0,3,123,274,73,90,49,125,174,25,11,9,67,163,319,SF
2001,30,13,306,73,141,0,1,73,140,31,55,35,66,101,12,4,31,28,24,177,C
2001,37,20,374,36,106,19,52,17,54,24,28,10,31,41,19,16,10,19,28,115,SF
2001,27,78,2225,391,925,61,165,330,760,155,211,104,236,340,124,83,27,141,173,998,SF
2001,29,51,588,94,248,36,103,58,145,33,42,22,59,81,23,12,7,26,53,257,SF
2001,29,13,135,17,55,7,23,10,32,9,10,4,18,22,9,4,1,6,8,50,SF
2001,29,38,453,77,193,29,80,48,113,24,32,18,41,59,14,8,6,20,45,207,SF
2001,34,75,2591,269,556,0,0,269,556,211,291,307,708,1015,76,29,203,144,204,749,C
2001,34,49,1716,169,354,0,0,169,354,107,154,188,505,693,54,20,137,92,139,445,C
2001,34,26,875,100,202,0,0,100,202,104,137,119,203,322,22,9,66,52,65,304,C
2001,25,3,10,1,4,0,0,1,4,2,2,1,1,2,0,0,0,0,3,4,C
2001,25,42,469,66,136,0,1,66,135,32,43,29,63,92,24,9,5,27,60,164,SF
2001,24,40,431,58,111,1,3,57,108,14,33,41,54,95,27,13,8,17,48,131,PF
2001,26,70,2387,386,792,89,219,297,573,231,258,46,177,223,509,72,5,205,158,1092,PG
2001,25,14,333,40,123,10,46,30,77,18,23,16,26,42,11,10,4,10,28,108,SG
2001,25,48,1223,149,407,39,134,110,273,67,83,35,96,131,65,41,16,55,127,404,SF
2001,24,73,1233,147,319,0,1,147,318,34,65,99,187,286,45,25,63,55,189,328,C
2001,26,27,184,21,55,4,9,17,46,8,16,13,22,35,6,2,4,7,18,54,SF
2001,37,82,2049,291,695,59,176,232,519,254,297,34,142,176,115,63,10,106,229,895,SG
2001,27,82,1654,184,413,25,89,159,324,151,194,44,154,198,283,69,2,107,84,544,PG
2001,22,82,3125,591,1247,151,390,440,857,451,538,119,635,754,173,79,101,156,245,1784,PF
2001,22,81,2641,404,868,0,5,404,863,233,388,249,545,794,98,49,228,161,280,1041,C
2001,28,74,2924,813,1422,0,2,813,1420,499,972,291,649,940,277,47,204,218,256,2125,C
2001,37,78,2767,305,786,11,49,294,737,127,152,142,599,741,264,76,48,139,258,748,PF
2001,21,76,2836,481,1046,80,253,401,793,262,386,110,482,592,392,74,122,264,236,1304,PF
2001,38,58,1545,283,568,0,1,283,567,123,198,124,307,431,72,70,88,81,141,689,C
2001,28,70,925,76,192,1,3,75,189,63,89,16,79,95,146,30,1,49,84,216,PG
2001,28,19,161,5,27,0,0,5,27,12,19,3,20,23,25,5,0,9,14,22,PG
2001,28,51,764,71,165,1,3,70,162,51,70,13,59,72,121,25,1,40,70,194,PG
2001,25,82,2127,308,708,0,0,308,708,85,156,168,357,525,46,30,108,169,250,701,C
2001,27,81,1491,139,281,1,2,138,279,84,151,164,251,415,22,22,142,63,215,363,C
2001,29,80,2534,226,368,1,2,225,366,129,225,211,408,619,225,105,137,141,241,582,PF
2001,31,21,475,52,139,11,36,41,103,10,16,4,35,39,72,8,0,31,37,125,PG
2001,31,7,144,15,44,1,4,14,40,7,11,3,12,15,19,4,0,13,15,38,PG
2001,31,2,15,2,2,0,0,2,2,0,0,0,0,0,0,1,0,3,2,4,PG
2001,31,12,316,35,93,10,32,25,61,3,5,1,23,24,53,3,0,15,20,83,PG
2001,31,45,793,88,230,3,20,85,210,19,40,84,121,205,55,32,12,39,93,198,PF
2001,19,30,221,18,37,0,0,18,37,9,12,24,43,67,2,7,10,11,40,45,C
2001,31,74,1260,181,426,12,31,169,395,105,137,30,107,137,293,65,1,135,114,479,PG
2001,24,27,127,18,43,5,9,13,34,15,20,19,20,39,5,6,3,10,21,56,PF
2001,22,58,1141,126,267,12,36,114,231,78,92,25,77,102,151,48,0,80,83,342,PG
2001,28,65,1054,134,274,0,6,134,268,31,44,71,158,229,46,25,36,41,122,299,C
2001,28,13,178,18,38,0,0,18,38,12,17,13,27,40,7,6,11,10,20,48,C
2001,28,52,876,116,236,0,6,116,230,19,27,58,131,189,39,19,25,31,102,251,C
2001,25,76,2059,370,749,2,36,368,713,246,361,183,199,382,161,103,45,155,176,988,SF
2001,32,79,3244,725,1591,102,272,623,1319,271,354,73,288,361,642,127,26,209,184,1823,PG
2001,31,75,2126,308,732,100,256,208,476,75,87,44,148,192,192,91,18,105,166,791,SG
2001,26,53,851,92,222,55,139,37,83,28,31,10,53,63,71,22,2,34,57,267,PG
2001,35,13,58,6,9,0,0,6,9,2,4,6,12,18,2,3,2,0,8,14,C
2001,39,64,999,86,226,38,110,48,116,32,38,32,136,168,41,33,18,19,61,242,PF
2001,31,49,499,65,140,1,5,64,135,16,22,9,37,46,79,22,1,38,29,147,PG
2001,31,6,39,5,11,0,1,5,10,0,0,1,3,4,5,3,0,6,1,10,PG
2001,31,43,460,60,129,1,4,59,125,16,22,8,34,42,74,19,1,32,28,137,PG
2001,29,44,958,128,292,34,84,94,208,24,30,11,119,130,64,27,11,40,62,314,SG
2001,23,80,1809,290,673,63,165,227,508,104,145,112,147,259,105,63,20,78,164,747,SG
2001,30,81,2144,291,672,120,297,171,375,158,181,54,187,241,96,46,19,76,123,860,SG
2001,23,82,3120,687,1513,147,384,540,1129,550,738,94,428,522,253,138,69,262,251,2071,SF
2001,35,64,2133,269,596,64,186,205,410,119,161,70,263,333,294,94,35,154,158,721,SF
2001,25,77,1658,185,395,0,2,185,393,128,171,173,292,465,47,48,97,66,206,498,C
2001,36,81,1619,206,415,0,1,206,414,17,65,157,221,378,31,27,77,78,241,429,C
2001,28,63,942,62,142,5,24,57,118,22,35,56,91,147,38,16,26,17,140,151,PF
2001,22,51,1147,173,445,0,5,173,440,94,141,89,100,189,61,45,6,59,111,440,SF
2001,37,80,1678,197,440,87,205,110,235,92,116,24,177,201,251,52,11,104,88,573,PG
2001,24,82,2255,243,590,65,217,178,373,115,141,125,306,431,163,93,40,102,226,666,SF
2001,22,26,169,17,54,3,11,14,43,22,27,8,17,25,5,4,2,17,12,59,SG
2001,25,82,1901,248,521,0,0,248,521,115,158,206,289,495,64,52,23,105,228,611,C
2001,32,6,30,3,11,1,4,2,7,6,7,1,3,4,5,2,0,4,8,13,PG
2001,23,35,605,56,142,7,26,49,116,33,45,18,46,64,89,36,11,46,43,152,PG
2001,21,33,270,12,35,0,0,12,35,3,11,29,42,71,2,3,30,13,56,27,C
2001,27,50,1800,228,457,0,0,228,457,165,217,125,288,413,58,30,187,126,165,621,C
2001,33,43,403,38,114,13,39,25,75,14,18,13,37,50,39,6,1,27,30,103,PG
2001,21,6,35,5,19,0,3,5,16,3,6,3,1,4,1,1,0,1,2,13,SG
2001,27,75,1832,254,552,1,4,253,548,113,142,132,320,452,80,43,54,90,243,622,C
2001,27,65,764,82,145,0,0,82,145,46,75,84,158,242,21,23,54,48,190,210,PF
2001,32,6,39,2,5,0,0,2,5,6,8,5,3,8,1,2,1,1,4,10,PF
2001,33,75,2212,331,752,82,211,249,541,155,182,61,246,307,89,41,13,96,179,899,SF
2001,20,76,1358,232,525,50,151,182,374,99,158,105,152,257,62,42,7,64,98,613,SG
2001,35,37,1216,205,504,45,133,160,371,143,160,15,94,109,111,43,7,84,86,598,SG
2001,29,67,1206,201,472,34,92,167,380,71,83,44,112,156,111,27,7,98,105,507,SG
2001,24,3,13,0,2,0,1,0,1,0,0,0,1,1,1,0,0,2,3,0,SF
2001,34,82,2751,501,1186,90,249,411,937,253,357,105,229,334,237,87,82,186,258,1345,PF
2001,35,80,2371,400,823,0,1,400,822,351,470,208,483,691,116,80,197,122,212,1151,C
2001,24,67,1201,216,407,2,4,214,403,64,88,60,138,198,59,50,32,43,66,498,SF
2001,28,76,2813,684,1460,55,184,629,1276,251,306,124,402,526,252,86,62,219,191,1674,SF
2001,27,6,72,3,22,0,2,3,20,0,0,3,8,11,2,6,0,3,7,6,SF
2001,30,6,50,4,11,2,5,2,6,0,0,0,8,8,0,4,1,4,5,10,PG
2001,33,33,631,67,184,44,116,23,68,21,24,23,64,87,36,28,2,24,46,199,PG
2001,29,39,544,75,110,0,1,75,109,29,52,48,91,139,9,10,18,17,33,179,C
2001,29,82,2183,377,876,56,189,321,687,188,247,94,265,359,180,97,47,157,269,998,SF
2001,31,82,1553,169,395,1,2,168,393,107,143,91,212,303,77,34,64,73,197,446,C
2001,28,72,2943,567,1242,59,174,508,1068,285,344,37,322,359,435,65,43,211,230,1478,SF
2001,26,57,1219,160,368,3,17,157,351,114,160,95,213,308,48,59,40,74,148,437,PF
2001,24,45,879,40,90,0,0,40,90,39,77,101,161,262,39,30,38,46,131,119,PF
2001,30,78,2473,308,700,95,230,213,470,222,285,94,236,330,160,96,20,113,229,933,SF
2001,36,61,1299,247,516,1,15,246,501,121,156,51,280,331,91,40,62,85,137,616,C
2001,22,34,226,18,48,0,0,18,48,10,24,22,31,53,1,2,14,4,23,46,C
2001,23,29,150,9,28,0,1,9,27,2,2,3,12,15,41,11,1,6,21,20,PG
2001,23,5,34,0,7,0,0,0,7,0,0,1,0,1,5,2,0,3,3,0,PG
2001,23,24,116,9,21,0,1,9,20,2,2,2,12,14,36,9,1,3,18,20,PG
2001,24,54,581,64,134,0,0,64,134,42,61,35,67,102,11,17,21,47,101,170,C
2001,38,26,397,39,95,3,8,36,87,23,27,17,61,78,44,7,3,28,43,104,SF
2001,28,27,144,17,41,0,0,17,41,9,22,23,27,50,4,5,6,11,23,43,C
2001,34,80,1833,164,411,42,135,122,276,51,64,48,256,304,258,49,27,97,159,421,SG
2001,24,39,584,64,161,0,0,64,161,32,59,55,113,168,18,14,11,32,61,160,PF
2001,30,55,686,90,175,0,0,90,175,74,110,78,108,186,26,18,9,43,126,254,PF
2001,23,9,66,11,22,0,0,11,22,4,6,1,7,8,6,4,0,3,7,26,C
2001,25,69,1941,308,765,0,5,308,760,231,287,160,331,491,79,47,50,88,258,847,PF
2001,28,79,1610,106,218,0,1,106,217,89,154,172,390,562,101,57,37,62,156,301,PF
2001,24,17,180,19,59,3,18,16,41,10,16,10,12,22,10,5,3,7,8,51,SF
2001,31,81,2542,359,788,78,230,281,558,309,347,87,185,272,213,48,24,137,203,1105,SG
2001,32,6,78,8,23,0,2,8,21,1,2,2,1,3,10,7,0,9,12,17,SG
2001,27,50,1740,182,435,5,19,177,416,122,154,27,139,166,369,77,7,124,123,491,PG
2001,33,18,113,12,20,0,0,12,20,15,25,16,19,35,2,2,2,11,24,39,C
2001,30,77,3017,524,1219,41,135,483,1084,275,351,49,298,347,269,106,28,218,159,1364,SF
2001,26,80,3215,774,1927,166,473,608,1454,666,810,99,216,315,410,97,54,326,160,2380,SG
2001,35,75,2122,273,686,64,182,209,504,89,111,29,125,154,178,73,10,94,217,699,SG
2001,24,29,280,28,88,1,4,27,84,25,34,35,74,109,16,10,11,19,47,82,C
2001,19,40,293,31,91,1,12,30,79,26,38,9,19,28,18,10,2,28,29,89,SG
2001,25,26,123,11,34,0,0,11,34,11,18,16,13,29,2,4,3,5,19,33,C
2001,30,78,2504,245,611,91,242,154,369,175,207,65,219,284,168,93,14,90,182,756,SG
2001,38,82,2397,328,651,61,132,267,519,227,278,54,173,227,713,132,21,203,194,944,PG
2001,23,75,2905,559,1189,144,360,415,829,267,312,93,341,434,164,91,13,146,144,1529,SF
2001,27,82,2655,406,935,82,219,324,716,172,207,69,234,303,468,106,8,191,202,1066,PG
2001,27,50,830,81,267,30,95,51,172,68,79,18,110,128,95,44,2,48,88,260,PG
2001,27,28,421,40,131,16,47,24,84,24,28,9,43,52,29,22,1,21,46,120,PG
2001,27,22,409,41,136,14,48,27,88,44,51,9,67,76,66,22,1,27,42,140,PG
2001,30,55,719,103,239,1,2,102,237,45,70,54,107,161,24,16,22,34,72,252,SF
2001,30,46,517,82,185,0,1,82,184,37,59,43,77,120,17,12,19,24,58,201,SF
2001,30,9,202,21,54,1,1,20,53,8,11,11,30,41,7,4,3,10,14,51,SF
2001,34,54,1371,182,429,4,17,178,412,130,173,36,104,140,303,53,5,107,76,498,PG
2001,34,33,1020,141,331,4,16,137,315,115,147,25,80,105,231,43,4,83,55,401,PG
2001,34,21,351,41,98,0,1,41,97,15,26,11,24,35,72,10,1,24,21,97,PG
2001,32,28,491,45,117,0,1,45,116,28,37,34,74,108,7,14,1,22,30,118,PF
2001,20,11,120,20,41,0,4,20,37,3,5,4,19,23,2,2,4,3,21,43,C
2001,27,53,1684,202,518,47,172,155,346,135,189,54,173,227,242,54,8,160,127,586,SG
2001,21,80,1312,153,339,0,4,153,335,85,141,109,175,284,28,62,82,64,160,391,PF
2001,23,82,2856,469,920,26,77,443,843,181,208,133,314,447,260,59,33,138,226,1145,SF
2001,30,55,777,98,186,0,0,98,186,20,47,65,148,213,33,10,30,57,125,216,C
2001,27,43,598,39,99,0,0,39,99,25,33,37,85,122,31,7,19,38,95,103,C
2001,24,69,1972,390,797,0,4,390,793,119,162,109,269,378,104,28,38,125,208,899,SF
2001,23,82,3089,596,1367,124,314,472,1053,303,358,42,227,269,403,104,12,239,204,1619,SG
2001,27,5,56,6,19,1,3,5,16,0,0,4,5,9,0,3,0,6,6,13,SF
2001,23,74,1820,206,465,25,92,181,373,91,126,122,295,417,77,40,43,116,178,528,PF
2001,28,77,2125,314,614,1,3,313,611,171,210,172,343,515,63,61,69,99,287,800,PF
2001,23,76,2086,326,758,107,260,219,498,195,253,79,234,313,138,78,45,114,194,954,PF
2001,38,49,647,59,131,0,0,59,131,20,24,50,95,145,29,12,7,32,108,138,PF
2001,23,70,1212,161,324,0,2,161,322,80,141,124,176,300,63,49,76,98,204,402,C
2001,26,33,319,57,130,0,1,57,129,19,36,39,53,92,10,13,8,22,52,133,PF
2001,21,57,947,101,215,0,0,101,215,54,91,83,159,242,19,10,55,66,137,256,C
2001,21,74,1245,138,335,28,86,110,249,87,112,49,161,210,69,52,24,55,139,391,SF
2001,29,71,2688,460,1112,135,358,325,754,204,249,44,197,241,600,61,18,165,109,1259,PG
2001,25,49,1733,308,708,65,170,243,538,150,186,78,269,347,82,40,20,103,150,831,SF
2001,27,22,411,46,110,0,6,46,104,30,50,15,22,37,66,23,3,37,44,122,PG
2001,25,82,1620,170,393,30,78,140,315,128,164,18,132,150,323,48,3,129,145,498,PG
2001,32,51,549,80,169,0,0,80,169,8,10,51,122,173,23,21,7,26,74,168,PF
2001,32,37,392,55,121,0,0,55,121,4,6,35,88,123,16,15,5,18,61,114,PF
2001,32,14,157,25,48,0,0,25,48,4,4,16,34,50,7,6,2,8,13,54,PF
2001,23,16,143,11,25,0,0,11,25,8,14,12,22,34,5,5,6,12,38,30,C
2001,24,81,3396,711,1720,221,603,490,1117,249,348,151,568,719,445,138,49,301,251,1892,PF
2001,24,61,963,121,252,1,3,120,249,78,124,67,176,243,29,10,41,68,103,321,PF
2001,26,80,2760,215,439,1,4,214,435,80,238,303,749,1052,123,107,186,117,192,511,C
2001,26,40,527,100,236,2,15,98,221,35,45,25,58,83,23,13,16,36,72,237,SF
2001,26,77,2940,590,1178,52,162,538,1016,245,320,147,455,602,212,90,135,158,206,1477,PF
2001,30,61,1492,155,373,67,175,88,198,56,70,32,127,159,273,70,10,112,132,433,PG
2001,30,82,2774,347,692,0,0,347,692,230,291,223,573,796,103,85,105,112,171,924,PF
2001,27,70,2836,786,1635,2,28,784,1607,324,461,179,598,777,294,93,118,195,226,1898,PF
2001,24,75,1995,387,726,17,50,370,676,159,240,120,247,367,208,94,20,169,203,950,SF
2001,30,82,3106,523,1239,97,258,426,981,271,339,64,160,224,361,128,16,171,220,1414,SG
2001,33,15,171,11,38,0,2,11,36,6,7,4,11,15,14,3,4,4,21,28,SG
2001,24,68,1609,203,408,0,1,203,407,177,312,178,343,521,20,32,111,136,211,583,C
2001,29,59,1532,182,470,93,248,89,222,101,113,12,94,106,248,55,3,103,150,558,PG
2001,29,82,2336,297,650,0,2,297,648,244,310,211,379,590,88,59,113,132,319,838,PF
2001,26,82,2394,330,767,33,108,297,659,109,145,50,162,212,407,123,26,103,171,802,SG
2001,28,81,1745,162,448,46,139,116,309,165,231,64,143,207,112,64,13,76,179,535,SF
2001,25,77,2290,281,690,98,311,183,379,60,76,19,166,185,416,94,9,160,114,720,PG
2001,27,59,1182,136,294,0,3,136,291,100,135,133,249,382,45,57,20,63,124,372,PF
2001,27,33,804,88,201,0,2,88,199,65,90,98,180,278,32,39,10,47,81,241,PF
2001,27,26,378,48,93,0,1,48,92,35,45,35,69,104,13,18,10,16,43,131,PF
2001,29,82,1211,162,364,1,13,161,351,85,133,86,157,243,79,29,16,85,136,410,SF
2001,32,66,1272,171,361,1,4,170,357,60,70,97,267,364,35,48,32,41,178,403,C
2001,25,69,1238,161,368,61,133,100,235,84,96,34,98,132,190,31,4,82,83,467,PG
2001,30,72,1583,202,513,98,248,104,265,97,126,31,214,245,97,30,28,73,153,599,SF
2001,27,69,1686,325,647,0,2,325,645,151,237,110,211,321,61,50,21,110,185,801,SF
2001,27,42,886,153,325,0,2,153,323,84,130,57,96,153,33,15,13,65,98,390,SF
2001,27,27,800,172,322,0,0,172,322,67,107,53,115,168,28,35,8,45,87,411,SF
2001,38,78,1830,304,690,1,6,303,684,113,147,177,355,532,50,57,52,87,216,722,C
2001,38,35,771,124,269,0,2,124,267,61,81,68,155,223,21,19,21,40,78,309,C
2001,38,43,1059,180,421,1,4,179,417,52,66,109,200,309,29,38,31,47,138,413,C
2001,37,1,9,3,3,0,0,3,3,0,0,0,0,0,2,0,0,0,1,6,SG
2001,27,34,305,25,79,0,2,25,77,25,34,12,34,46,3,6,18,12,38,75,PF
2001,21,76,2363,327,815,43,148,284,667,210,280,59,235,294,228,152,45,159,254,907,SF
2001,25,71,1988,363,811,0,2,363,809,155,216,180,355,535,87,42,63,125,232,881,C
2001,23,5,38,8,19,0,2,8,17,8,10,1,6,7,0,0,0,1,8,24,C
2002,27,24,441,55,147,1,2,54,145,24,33,41,43,84,24,20,10,27,56,135,SG
2002,27,20,417,55,145,1,2,54,143,24,32,39,39,78,22,18,9,24,51,135,SG
2002,27,4,24,0,2,0,0,0,2,0,1,2,4,6,2,2,1,3,5,0,SG
2002,25,77,2980,598,1297,21,70,577,1227,419,523,198,498,696,239,98,81,250,214,1636,PF
2002,24,56,1325,223,474,5,18,218,456,98,121,43,105,148,86,35,7,60,113,549,SG
2002,32,15,97,18,51,0,2,18,49,4,8,7,22,29,6,0,1,5,6,40,C
2002,23,12,161,22,51,0,1,22,50,8,10,15,23,38,5,3,8,2,16,52,PF
2002,26,69,2525,530,1148,229,528,301,620,214,245,81,231,312,271,88,18,159,157,1503,SG
2002,25,50,600,66,191,27,71,39,120,18,29,10,62,72,143,32,2,40,42,177,PG
2002,31,54,586,54,166,0,0,54,166,67,105,52,57,109,29,7,10,55,64,175,PF
2002,23,24,262,25,74,0,4,25,70,22,28,38,38,76,7,7,28,13,35,72,C
2002,27,70,1860,247,612,85,228,162,384,178,208,47,142,189,216,68,8,87,113,757,SG
2002,31,76,2430,312,716,9,33,303,683,98,132,57,218,275,403,141,10,119,210,731,PG
2002,34,15,219,21,76,13,48,8,28,5,9,1,32,33,14,6,6,14,17,60,SG
2002,28,82,1596,149,373,39,141,110,232,74,107,57,192,249,76,48,15,97,134,411,SG
2002,34,60,1514,183,475,48,163,135,312,60,91,22,110,132,282,77,5,94,114,474,PG
2002,34,36,961,113,287,29,90,84,197,47,70,16,72,88,203,49,4,58,72,302,PG
2002,34,24,553,70,188,19,73,51,115,13,21,6,38,44,79,28,1,36,42,172,PG
2002,20,47,1155,174,384,39,113,135,271,124,160,41,91,132,174,69,11,97,115,511,PG
2002,21,35,196,27,85,5,17,22,68,5,10,10,6,16,8,7,1,8,26,64,SG
2002,33,82,2730,347,828,139,398,208,430,182,205,83,236,319,453,157,10,175,166,1015,PG
2002,22,37,371,49,111,0,2,49,109,13,18,12,28,40,70,11,1,23,30,111,PG
2002,22,17,96,13,29,0,0,13,29,4,6,3,9,12,21,6,0,12,12,30,PG
2002,22,20,275,36,82,0,2,36,80,9,12,9,19,28,49,5,1,11,18,81,PG
2002,27,79,2285,368,790,138,336,230,454,83,120,31,127,158,263,72,11,128,177,957,PG
2002,33,77,1319,140,328,0,3,140,325,77,101,59,166,225,103,56,12,54,115,357,SG
2002,32,21,307,36,92,0,3,36,89,4,4,11,60,71,13,9,5,11,36,76,C
2002,22,28,258,26,90,6,35,20,55,13,19,4,20,24,36,7,0,19,17,71,PG
2002,21,50,638,72,178,0,1,72,177,41,70,55,107,162,23,17,24,46,108,185,C
2002,30,55,1710,315,649,1,8,314,641,143,226,168,182,350,72,22,36,127,197,774,C
2002,23,19,228,24,68,1,7,23,61,9,10,5,13,18,34,17,1,12,29,58,PG
2002,34,29,582,74,192,24,71,50,121,21,27,1,56,57,78,14,2,33,37,193,PG
2002,30,81,3040,401,790,164,387,237,403,198,234,58,383,441,426,147,37,165,182,1164,SG
2002,32,82,1985,255,522,121,258,134,264,108,116,42,192,234,274,94,20,111,134,739,SG
2002,26,27,408,53,132,4,12,49,120,29,37,32,64,96,22,10,5,32,94,139,C
2002,25,74,1819,211,390,0,2,211,388,88,130,184,297,481,35,60,67,51,219,510,C
2002,23,78,3097,412,961,103,276,309,685,198,283,180,238,418,216,121,81,155,215,1125,SF
2002,22,7,44,3,11,0,6,3,5,2,2,2,3,5,2,0,0,5,3,8,SG
2002,22,5,42,3,11,0,6,3,5,2,2,2,2,4,2,0,0,5,3,8,SG
2002,25,74,890,103,240,12,44,91,196,36,48,31,80,111,71,21,4,48,109,254,SG
2002,21,78,1647,198,460,45,125,153,335,140,181,64,180,244,62,19,49,96,147,581,SF
2002,29,74,1747,228,518,21,59,207,459,104,116,20,131,151,324,89,7,99,173,581,PG
2002,29,44,954,116,264,13,34,103,230,57,65,10,60,70,175,57,6,59,101,302,PG
2002,29,30,793,112,254,8,25,104,229,47,51,10,71,81,149,32,1,40,72,279,PG
2002,23,80,2659,446,985,51,138,395,847,155,193,37,185,222,403,87,15,134,133,1098,PG
2002,25,82,2355,348,823,124,315,224,508,207,234,35,191,226,450,66,17,138,169,1027,PG
2002,34,35,599,50,146,15,42,35,104,4,8,8,44,52,114,24,4,37,20,119,PG
2002,33,72,1426,115,251,0,1,115,250,29,45,149,219,368,44,49,26,52,176,259,PF
2002,26,44,415,32,76,0,0,32,76,30,37,26,59,85,10,16,19,23,59,94,C
2002,25,15,279,35,82,0,0,35,82,23,24,20,34,54,16,6,13,16,47,93,C
2002,23,33,245,13,32,0,0,13,32,13,25,21,34,55,4,3,16,14,38,39,C
2002,24,52,585,61,174,1,5,60,169,39,47,38,72,110,11,18,15,11,64,162,PF
2002,30,59,1699,155,398,56,148,99,250,46,96,42,120,162,88,62,25,66,116,412,SF
2002,26,75,1686,147,307,1,12,146,295,69,92,134,165,299,52,75,41,41,171,364,SF
2002,28,3,29,5,7,0,1,5,6,0,0,0,1,1,1,2,0,0,3,10,SG
2002,25,68,761,110,275,13,42,97,233,47,61,27,27,54,145,20,2,44,44,280,PG
2002,22,26,118,13,25,0,2,13,23,4,8,7,17,24,3,0,6,6,10,30,PF
2002,29,53,757,78,163,0,1,78,162,59,64,53,123,176,20,28,64,25,128,215,C
2002,22,80,3020,532,1010,0,0,532,1010,389,524,396,529,925,191,80,163,173,254,1453,PF
2002,31,32,962,155,365,4,23,151,342,83,84,17,76,93,264,52,6,43,49,397,PG
2002,21,13,43,2,5,0,1,2,4,0,0,2,6,8,9,2,0,3,3,4,SG
2002,22,22,160,14,29,0,0,14,29,15,25,16,12,28,6,0,7,6,28,43,C
2002,33,18,92,10,27,0,0,10,27,1,2,10,23,33,6,2,4,5,12,21,SF
2002,22,17,67,8,21,0,1,8,20,7,8,2,2,4,2,1,1,9,11,23,SF
2002,33,7,65,3,20,1,12,2,8,0,0,0,9,9,2,3,1,4,4,7,PG
2002,22,3,21,1,6,0,0,1,6,1,4,1,5,6,0,0,1,3,4,3,C
2002,20,29,245,23,70,5,27,18,43,12,20,11,39,50,15,18,7,7,18,63,SF
2002,19,57,817,94,243,0,1,94,242,70,99,63,135,198,43,16,26,43,105,258,PF
2002,32,80,2563,250,527,0,0,250,527,169,197,273,513,786,107,59,78,85,222,669,C
2002,33,1,6,0,1,0,0,0,1,0,0,0,0,0,2,0,1,0,1,0,PG
2002,22,40,403,49,115,4,12,45,103,21,28,12,30,42,70,19,3,40,26,123,SG
2002,29,59,520,45,113,6,11,39,102,29,41,23,45,68,114,25,2,47,51,125,PG
2002,23,80,3063,749,1597,33,132,716,1465,488,589,112,329,441,438,118,35,223,228,2019,SG
2002,36,30,206,25,55,0,0,25,55,6,8,25,19,44,10,7,2,6,38,56,PF
2002,25,44,885,104,198,5,16,99,182,40,58,67,106,173,48,31,19,27,124,253,SG
2002,33,66,684,44,118,21,60,23,58,2,4,29,87,116,32,21,8,15,53,111,SF
2002,33,60,630,42,112,19,54,23,58,2,4,27,81,108,29,20,8,14,46,105,SF
2002,24,63,1769,258,593,17,70,241,523,58,80,52,220,272,71,42,12,63,110,591,SG
2002,34,31,350,39,115,16,57,23,58,11,12,10,37,47,16,2,2,12,29,105,PF
2002,31,11,90,10,23,1,3,9,20,8,12,6,8,14,5,0,1,5,10,29,SG
2002,28,23,283,36,72,0,1,36,71,27,43,24,26,50,12,4,5,19,39,99,PF
2002,27,29,1007,130,290,0,1,130,289,62,99,89,233,322,33,34,50,42,107,322,C
2002,33,77,2156,384,794,0,2,384,792,306,384,133,397,530,102,60,137,138,264,1074,PF
2002,24,8,43,6,13,3,7,3,6,2,2,2,4,6,2,1,0,0,5,17,PF
2002,26,46,1050,89,260,1,19,88,241,19,36,19,98,117,214,50,3,72,85,198,PG
2002,25,60,2385,559,1307,121,313,438,994,245,307,138,175,313,239,94,43,154,191,1484,SG
2002,32,74,2605,554,1197,71,204,483,993,282,328,54,258,312,493,90,12,177,208,1461,PG
2002,27,75,1917,190,326,0,1,190,325,113,194,176,349,525,29,40,95,53,208,493,C
2002,19,71,1389,151,304,0,0,151,304,134,222,114,229,343,54,28,93,99,179,436,C
2002,30,68,1631,224,466,0,4,224,462,46,67,57,183,240,110,34,21,70,156,494,SG
2002,34,69,1576,97,296,33,120,64,176,58,71,18,136,154,351,56,5,123,177,285,PG
2002,31,81,2798,338,735,90,256,248,479,206,242,74,300,374,340,160,25,164,209,972,SG
2002,26,81,2185,380,775,0,5,380,770,155,230,182,421,603,88,58,122,140,258,915,C
2002,23,67,1528,181,452,4,33,177,419,114,136,46,114,160,198,95,6,95,145,480,PG
2002,24,32,153,30,68,2,8,28,60,8,9,1,7,8,25,7,0,27,9,70,PG
2002,34,58,2080,331,735,28,83,303,652,185,227,167,342,509,98,42,51,119,158,875,PF
2002,33,47,693,56,146,4,20,52,126,33,37,12,43,55,107,13,4,31,59,149,PG
2002,24,25,365,41,95,0,1,41,94,24,32,31,51,82,9,6,4,13,40,106,C
2002,23,70,1440,158,343,0,1,158,342,134,181,138,158,296,58,29,22,56,234,450,C
2002,23,77,1407,117,278,1,2,116,276,115,164,132,169,301,81,29,47,72,173,350,C
2002,26,7,131,21,45,0,1,21,44,11,15,9,16,25,5,2,5,10,21,53,PF
2002,21,23,481,89,187,26,58,63,129,10,13,5,29,34,55,18,5,32,18,214,PG
2002,22,21,156,26,68,15,39,11,29,12,13,2,9,11,26,5,0,10,10,79,PG
2002,22,6,27,3,12,0,4,3,8,4,5,0,1,1,2,1,0,1,2,10,PG
2002,22,15,129,23,56,15,35,8,21,8,8,2,8,10,24,4,0,9,8,69,PG
2002,26,76,1286,185,448,49,145,136,303,97,114,74,220,294,77,26,29,67,106,516,PF
2002,32,41,802,98,208,31,69,67,139,57,66,16,59,75,141,19,1,51,77,284,PG
2002,25,58,501,78,187,12,46,66,141,24,32,14,38,52,60,18,5,36,53,192,PG
2002,37,56,886,141,347,45,131,96,216,33,37,23,58,81,61,22,6,41,50,360,SG
2002,19,72,1150,189,377,0,0,189,377,105,160,111,161,272,25,16,53,69,173,483,C
2002,33,82,1912,125,276,7,26,118,250,72,91,15,153,168,127,47,10,60,207,329,SG
2002,20,34,177,22,50,0,0,22,50,7,18,25,43,68,5,6,13,14,30,51,C
2002,26,73,1740,209,480,0,0,209,480,136,211,167,220,387,87,17,167,156,235,554,C
2002,26,82,2175,269,612,57,196,212,416,158,210,23,153,176,228,48,12,70,104,753,SG
2002,33,77,2978,410,963,0,1,410,962,293,358,254,486,740,155,54,83,159,225,1113,PF
2002,22,82,3318,559,1341,170,478,389,863,196,338,93,256,349,698,172,47,246,241,1484,PG
2002,32,78,2447,296,580,0,0,296,580,150,212,262,426,688,96,62,83,62,193,742,C
2002,33,28,774,70,198,29,85,41,113,16,18,19,55,74,68,27,5,52,68,185,PG
2002,31,51,1231,146,326,57,126,89,200,16,21,7,70,77,107,28,3,44,58,365,SG
2002,22,82,1954,376,781,11,35,365,746,196,248,63,180,243,178,69,23,148,145,959,SF
2002,28,61,633,67,149,0,0,67,149,28,50,74,89,163,22,23,24,34,130,162,C
2002,35,2,6,1,4,0,0,1,4,0,0,0,0,0,2,0,0,0,0,2,PG
2002,28,63,1447,226,588,67,214,159,374,78,97,58,145,203,132,53,10,59,98,597,SG
2002,28,41,877,166,416,47,147,119,269,56,67,38,86,124,81,31,4,40,60,435,SG
2002,28,22,570,60,172,20,67,40,105,22,30,20,59,79,51,22,6,19,38,162,SG
2002,26,32,299,41,120,1,11,40,109,18,24,14,42,56,35,10,4,16,13,101,SG
2002,26,25,249,30,94,0,7,30,87,13,18,12,33,45,31,8,4,13,12,73,SG
2002,26,7,50,11,26,1,4,10,22,5,6,2,9,11,4,2,0,3,1,28,SG
2002,26,4,124,15,48,8,21,7,27,5,6,3,9,12,9,3,1,8,12,43,SG
2002,20,18,109,12,29,0,0,12,29,1,5,5,12,17,5,1,10,12,19,25,C
2002,33,80,2420,338,716,3,13,335,703,209,340,205,466,671,297,79,94,158,229,888,C
2002,24,42,705,78,187,0,0,78,187,38,46,47,121,168,25,15,11,37,98,194,C
2002,21,14,155,22,57,4,14,18,43,10,12,0,3,3,12,4,3,10,20,58,PG
2002,27,61,774,78,182,31,73,47,109,23,29,14,58,72,101,32,2,33,49,210,PG
2002,26,64,1174,191,414,0,2,191,412,55,73,75,144,219,51,20,31,51,109,437,C
2002,36,43,327,20,50,0,2,20,48,8,15,27,53,80,13,3,14,14,42,48,C
2002,25,82,3329,764,1504,1,10,763,1494,560,701,268,774,1042,307,61,203,263,217,2089,PF
2002,29,39,609,59,175,14,58,45,117,39,49,9,40,49,100,24,3,53,55,171,PG
2002,26,29,152,13,39,0,0,13,39,28,40,12,22,34,3,2,6,10,16,54,PF
2002,31,66,1684,189,452,38,124,151,328,53,84,107,180,287,56,30,37,73,196,469,SF
2002,26,31,299,21,50,0,0,21,50,20,33,35,63,98,9,10,9,16,60,62,C
2002,23,10,45,9,19,0,3,9,16,3,4,3,1,4,4,0,0,2,9,21,SG
2002,39,65,901,148,333,0,1,148,332,94,134,60,203,263,35,22,45,65,129,390,C
2002,35,50,799,76,177,43,99,33,78,34,36,15,75,90,48,16,9,22,70,229,SF
2002,28,69,2754,569,1228,76,224,493,1004,210,251,90,270,360,230,65,25,117,144,1424,SF
2002,27,70,1974,274,666,144,349,130,317,94,111,15,131,146,181,66,9,62,121,786,PG
2002,23,76,1963,371,848,7,41,364,807,189,283,128,299,427,120,49,24,131,186,938,PF
2002,26,6,75,3,14,1,5,2,9,4,6,0,5,5,4,0,0,4,6,11,SG
2002,20,53,452,61,118,0,0,61,118,42,57,32,75,107,7,6,7,32,99,164,PF
2002,20,8,39,1,12,0,3,1,9,4,4,1,5,6,6,2,0,3,1,6,SG
2002,25,77,2216,309,722,1,4,308,718,245,308,290,609,899,127,44,17,160,255,864,PF
2002,33,6,24,2,9,0,4,2,5,3,4,0,8,8,1,0,0,0,4,7,PF
2002,25,82,1786,177,394,2,15,175,379,111,182,206,350,556,70,71,38,79,232,467,C
2002,20,28,320,42,104,7,23,35,81,17,20,25,37,62,10,9,11,21,22,108,PF
2002,25,22,343,25,64,0,0,25,64,24,31,32,32,64,17,11,1,13,39,74,SF
2002,32,82,2289,255,605,65,208,190,397,70,85,90,299,389,283,67,21,132,244,645,SF
2002,26,79,1485,171,385,0,0,171,385,37,93,150,234,384,41,36,168,76,179,379,C
2002,24,57,2343,420,1007,68,210,352,797,326,422,102,299,401,362,71,25,221,172,1234,PG
2002,31,56,722,115,245,0,3,115,242,34,56,76,122,198,32,11,18,33,65,264,PF
2002,25,81,3175,659,1401,37,116,622,1285,359,448,243,738,981,422,96,126,229,184,1714,PF
2002,35,34,183,18,55,0,0,18,55,0,3,16,41,57,5,7,10,10,32,36,C
2002,35,29,152,14,40,0,0,14,40,0,3,13,34,47,4,5,9,7,26,28,C
2002,35,5,31,4,15,0,0,4,15,0,0,3,7,10,1,2,1,3,6,8,C
2002,25,80,2406,327,767,169,396,158,371,61,73,77,261,338,99,61,28,68,230,884,PF
2002,21,82,3007,551,1064,1,5,550,1059,338,477,238,492,730,223,41,169,224,195,1441,C
2002,34,54,809,131,293,1,8,130,285,82,117,71,135,206,25,17,11,58,109,345,PF
2002,32,4,36,1,8,0,0,1,8,1,2,3,3,6,0,0,2,2,2,3,C
2002,24,82,1759,215,523,66,178,149,345,85,126,78,225,303,111,71,42,66,190,581,SF
2002,23,23,384,39,92,7,22,32,70,31,39,7,21,28,49,11,3,34,38,116,PG
2002,33,65,1410,162,422,6,44,156,378,42,62,29,155,184,100,44,8,55,140,372,SG
2002,23,55,1156,192,456,30,91,162,365,78,103,36,133,169,84,45,14,76,89,492,SG
2002,25,9,50,2,10,0,0,2,10,1,2,1,4,5,5,1,2,3,10,5,SF
2002,29,72,2256,286,610,0,2,286,608,101,119,168,407,575,137,48,31,122,236,673,PF
2002,36,76,2210,264,515,0,0,264,515,80,111,159,322,481,104,57,49,51,118,608,C
2002,27,58,1383,179,359,16,54,163,305,41,49,68,161,229,106,75,12,42,142,415,SG
2002,19,73,1896,244,666,90,273,154,393,64,86,117,299,416,53,17,134,47,117,642,PF
2002,32,44,1129,127,301,3,9,124,292,28,37,59,162,221,77,39,30,61,116,285,PF
2002,23,45,607,88,244,46,123,42,121,22,27,12,32,44,81,10,7,37,23,244,PG
2002,28,70,1208,120,211,1,7,119,204,62,123,91,111,202,73,25,37,83,175,303,SF
2002,23,63,2203,472,1084,16,42,456,1042,300,337,73,143,216,171,38,14,132,136,1260,SG
2002,23,9,98,10,19,0,1,10,18,0,1,6,12,18,5,4,0,2,10,20,SF
2002,26,54,848,103,245,0,0,103,245,118,181,110,143,253,14,21,18,60,104,324,PF
2002,30,80,2462,389,931,23,83,366,848,158,195,98,252,350,324,122,32,189,184,959,SG
2002,35,68,1601,226,620,123,354,103,266,77,97,14,110,124,278,57,10,111,109,652,PG
2002,35,54,1276,179,494,95,279,84,215,65,78,13,84,97,201,40,8,73,84,518,PG
2002,35,14,325,47,126,28,75,19,51,12,19,1,26,27,77,17,2,38,25,134,PG
2002,25,81,2541,386,838,21,69,365,769,165,222,203,370,573,107,70,5,127,201,958,SF
2002,21,44,1313,230,484,1,3,229,481,115,144,96,180,276,54,41,21,78,166,576,PF
2002,28,77,1563,237,450,0,2,237,448,122,172,125,224,349,37,30,36,95,250,596,PF
2002,31,74,1553,249,537,44,118,205,419,133,158,49,158,207,116,53,6,61,99,675,SG
2002,23,10,92,10,19,0,2,10,17,6,6,4,9,13,12,7,1,8,16,26,PG
2002,31,5,47,4,12,0,0,4,12,1,2,5,4,9,5,1,3,3,8,9,PF
2002,21,47,841,108,217,0,0,108,217,54,90,80,147,227,37,21,24,33,115,270,PF
2002,21,18,162,14,26,0,0,14,26,10,22,12,34,46,5,4,5,8,27,38,PF
2002,21,29,679,94,191,0,0,94,191,44,68,68,113,181,32,17,19,25,88,232,PF
2002,22,78,2237,267,628,60,165,207,463,87,114,65,190,255,172,55,44,101,184,681,SG
2002,22,15,77,11,39,0,3,11,36,4,8,5,15,20,5,0,1,3,9,26,PF
2002,22,62,1266,109,221,0,0,109,221,97,160,143,179,322,29,21,91,50,158,315,C
2002,29,26,422,59,116,1,1,58,115,24,45,31,66,97,11,11,15,21,40,143,PF
2002,26,12,70,15,31,2,4,13,27,4,7,1,2,3,4,6,2,8,4,36,SF
2002,29,14,512,83,195,0,2,83,193,69,80,29,96,125,64,8,4,37,40,235,SF
2002,33,26,810,71,182,0,1,71,181,67,103,79,195,274,23,17,13,48,102,209,PF
2002,29,79,1408,121,291,24,92,97,199,79,94,18,192,210,136,61,5,32,87,345,SG
2002,31,81,2140,183,460,76,203,107,257,108,138,130,349,479,232,77,89,88,208,550,PF
2002,23,64,1230,209,524,54,157,155,367,42,49,17,93,110,123,43,5,80,98,514,PG
2002,30,77,2914,568,1301,136,346,432,955,295,339,37,215,252,190,54,10,170,182,1567,SG
2002,28,81,2635,462,1005,0,2,462,1003,261,343,223,389,612,169,46,47,152,265,1185,PF
2002,28,53,1659,270,585,0,1,270,584,144,191,138,252,390,93,28,30,78,170,684,PF
2002,28,28,976,192,420,0,1,192,419,117,152,85,137,222,76,18,17,74,95,501,PF
2002,25,81,1854,354,815,66,187,288,628,176,201,30,115,145,255,57,6,163,119,950,PG
2002,23,73,2049,343,810,18,93,325,717,191,259,83,162,245,316,113,23,171,150,895,SG
2002,31,82,1616,187,490,79,208,108,282,20,40,18,103,121,129,66,19,55,120,473,PG
2002,20,53,516,67,147,0,0,67,147,55,94,40,57,97,5,5,43,16,81,189,C
2002,26,62,1329,241,567,0,5,241,562,208,276,136,198,334,70,17,84,94,187,690,C
2002,26,60,2622,665,1669,78,268,587,1401,475,585,44,225,269,331,168,13,237,102,1883,SG
2002,28,81,1750,334,754,79,219,255,535,149,184,82,169,251,164,73,11,93,145,896,PG
2002,34,9,144,15,37,7,20,8,17,2,4,1,16,17,8,5,0,8,13,39,SG
2002,25,24,280,20,42,1,2,19,40,16,24,3,24,27,57,9,1,14,24,57,SG
2002,31,55,1825,238,538,38,81,200,457,75,87,54,236,290,140,42,14,106,145,589,SF
2002,27,39,495,60,164,0,1,60,163,66,80,48,80,128,14,11,6,30,69,186,C
2002,27,17,169,22,65,0,0,22,65,40,48,17,26,43,7,5,3,12,25,84,C
2002,27,22,326,38,99,0,1,38,98,26,32,31,54,85,7,6,3,18,44,102,C
2002,36,82,2367,260,592,79,195,181,397,87,110,56,253,309,605,74,1,150,162,686,PG
2002,23,23,227,34,91,9,36,25,55,12,17,3,23,26,11,15,3,23,29,89,SF
2002,26,56,949,134,273,0,0,134,273,30,60,89,143,232,24,25,86,74,174,298,C
2002,26,15,119,15,43,8,21,7,22,4,7,2,12,14,19,6,1,13,17,42,PG
2002,25,9,41,5,13,0,0,5,13,2,6,5,2,7,1,0,1,3,5,12,SF
2002,25,82,3033,614,1375,68,210,546,1165,323,440,211,345,556,161,70,45,161,187,1619,SF
2002,25,25,176,22,43,0,0,22,43,10,15,24,15,39,6,5,1,6,23,54,PF
2002,21,79,1917,270,591,13,56,257,535,189,265,85,208,293,140,64,48,107,211,742,SF
2002,27,34,366,37,90,4,12,33,78,16,25,10,19,29,48,31,1,20,30,94,SG
2002,36,68,1352,207,432,0,5,207,427,121,163,14,55,69,286,40,9,76,86,535,PG
2002,36,51,1200,186,383,0,5,186,378,109,146,14,50,64,258,35,8,67,69,481,PG
2002,36,17,152,21,49,0,0,21,49,12,17,0,5,5,28,5,1,9,17,54,PG
2002,21,72,1727,214,540,89,247,125,293,85,105,59,188,247,81,62,56,102,163,602,SF
2002,34,81,1660,89,193,0,1,89,192,30,66,142,324,466,27,37,82,52,219,208,C
2002,20,77,1916,251,584,38,130,213,454,41,53,75,182,257,179,59,20,71,114,581,SG
2002,20,48,1003,130,296,24,88,106,208,20,26,40,99,139,74,33,9,28,59,304,SG
2002,20,29,913,121,288,14,42,107,246,21,27,35,83,118,105,26,11,43,55,277,SG
2002,23,23,126,8,20,0,0,8,20,10,20,13,23,36,3,3,9,11,35,26,C
2002,25,67,1083,114,284,69,186,45,98,43,59,13,90,103,140,23,1,61,83,340,PG
2002,30,81,3156,517,1198,149,382,368,816,297,355,61,317,378,262,117,77,148,258,1480,SG
2002,22,81,2142,287,640,52,168,235,472,45,68,125,365,490,116,75,46,79,184,671,PF
2002,31,79,1920,222,508,4,11,218,497,106,130,233,345,578,127,50,19,88,209,554,PF
2002,38,60,2093,551,1324,10,53,541,1271,263,333,50,289,339,310,85,26,162,119,1375,SF
2002,32,75,1232,175,407,0,4,175,403,104,131,90,198,288,52,43,33,81,184,454,PF
2002,36,65,775,102,217,26,66,76,151,39,40,6,54,60,63,13,1,24,49,269,PG
2002,28,82,3056,445,1138,117,364,328,774,201,247,130,465,595,808,175,20,286,136,1208,PG
2002,20,82,2151,285,633,25,100,260,533,285,371,149,253,402,94,116,159,108,156,880,SF
2002,27,82,2601,438,940,98,242,340,698,128,172,68,207,275,216,130,31,109,108,1102,SG
2002,26,53,1151,141,334,2,8,139,326,87,115,11,98,109,302,79,7,111,135,371,PG
2002,27,49,429,41,113,0,0,41,113,16,21,48,56,104,8,11,10,27,95,98,C
2002,33,59,1494,211,504,53,171,158,333,109,153,43,175,218,210,48,17,113,91,584,SF
2002,32,57,1441,168,362,2,10,166,352,66,76,74,227,301,151,60,25,85,129,404,PF
2002,25,78,2455,421,920,104,268,317,652,105,151,176,403,579,89,55,213,94,281,1051,C
2002,25,51,1668,307,659,75,173,232,486,70,105,117,262,379,60,31,153,60,173,759,C
2002,25,27,787,114,261,29,95,85,166,35,46,59,141,200,29,24,60,34,108,292,C
2002,25,44,477,70,176,27,74,43,102,42,46,13,42,55,60,13,5,40,49,209,SG
2002,24,34,434,49,125,1,4,48,121,8,11,22,45,67,14,8,5,9,25,107,SF
2002,28,33,542,73,185,17,50,56,135,30,35,11,38,49,71,17,7,43,58,193,PG
2002,28,71,1665,315,769,89,240,226,529,94,120,38,145,183,130,59,25,91,105,813,SG
2002,24,36,490,64,143,3,18,61,125,13,20,10,33,43,36,23,9,32,89,144,SG
2002,22,71,2585,455,972,123,316,332,656,162,200,139,359,498,123,104,40,97,174,1195,SF
2002,26,13,176,15,54,1,8,14,46,10,11,9,16,25,26,9,2,2,11,41,PG
2002,29,63,989,120,244,0,0,120,244,45,85,107,144,251,41,22,28,63,180,285,PF
2002,35,66,1868,164,385,3,17,161,368,86,123,31,200,231,136,63,12,103,123,417,PF
2002,27,67,581,59,156,14,33,45,123,37,55,29,51,80,39,18,1,36,73,169,SG
2002,24,71,1458,222,520,63,141,159,379,48,63,14,108,122,246,49,0,96,120,555,PG
2002,31,45,893,73,198,1,6,72,192,25,40,70,116,186,54,40,14,41,75,172,SF
2002,26,62,1502,247,465,0,0,247,465,110,164,157,221,378,78,24,89,66,181,604,C
2002,31,12,159,14,49,7,28,7,21,5,7,2,12,14,4,5,1,7,17,40,SF
2002,26,59,650,66,146,0,2,66,144,35,54,89,73,162,44,16,13,22,104,167,PF
2002,22,63,1615,235,530,46,139,189,391,201,251,54,177,231,112,41,19,116,155,717,SG
2002,23,82,1549,228,414,0,1,228,413,243,333,153,308,461,31,27,86,118,201,699,C
2002,36,65,1180,99,289,79,235,20,54,23,39,28,148,176,90,48,15,35,104,300,SG
2002,38,80,3040,635,1399,9,25,626,1374,509,639,142,544,686,341,152,59,263,229,1788,PF
2002,35,41,552,71,149,1,7,70,142,22,33,25,83,108,30,21,21,25,80,165,PF
2002,24,82,3187,625,1413,71,248,554,1165,353,452,75,191,266,666,77,13,284,186,1674,PG
2002,23,81,3109,654,1395,48,122,606,1273,191,226,211,592,803,162,149,86,144,214,1547,SF
2002,26,21,319,38,88,0,0,38,88,20,34,19,56,75,8,5,10,19,40,96,C
2002,29,20,118,8,29,2,4,6,25,12,18,8,13,21,5,3,0,2,14,30,SF
2002,28,58,1750,343,661,13,42,330,619,160,226,158,285,443,101,50,67,124,150,859,SF
2002,30,3,22,0,10,0,2,0,8,1,2,0,1,1,3,2,0,1,4,1,PG
2002,24,73,2504,445,962,15,67,430,895,181,267,113,275,388,192,90,121,172,261,1086,PF
2002,29,40,1601,303,744,41,112,262,632,211,241,31,211,242,171,45,6,110,80,858,SF
2002,35,82,3143,316,626,1,1,315,625,154,221,124,522,646,346,57,22,130,187,787,PF
2002,24,75,2420,357,769,16,59,341,710,201,237,92,259,351,104,67,27,104,170,931,SF
2002,34,73,1247,159,349,1,1,158,348,84,117,100,224,324,26,30,31,65,174,403,PF
2002,27,56,718,80,180,39,99,41,81,13,19,32,96,128,41,18,7,22,83,212,PF
2002,28,27,153,20,49,0,0,20,49,12,26,16,20,36,4,6,10,14,23,52,C
2002,34,69,1830,206,576,60,222,146,354,132,163,67,184,251,204,58,19,144,175,604,SF
2002,24,21,104,12,21,0,0,12,21,2,8,8,17,25,7,0,5,8,14,26,C
2002,27,10,236,43,75,0,0,43,75,27,33,18,37,55,18,10,8,20,20,113,PF
2002,22,76,2912,715,1586,103,283,612,1303,415,555,150,447,597,400,119,73,189,139,1948,SG
2002,27,81,3030,463,1121,75,234,388,887,183,219,45,168,213,500,63,6,147,202,1184,PG
2002,35,41,784,52,122,5,12,47,110,10,14,48,79,127,45,41,4,22,90,119,SF
2002,29,48,1471,220,490,51,128,169,362,96,122,26,166,192,179,56,14,93,74,587,SG
2002,22,71,729,145,304,0,4,145,300,41,62,85,73,158,43,29,11,42,119,331,C
2002,25,53,1716,311,784,18,62,293,722,95,119,50,128,178,128,32,13,88,108,735,SG
2002,25,40,1503,286,717,17,57,269,660,84,108,44,111,155,118,30,10,79,86,673,SG
2002,25,13,213,25,67,1,5,24,62,11,11,6,17,23,10,2,3,9,22,62,SG
2002,22,74,1659,221,526,3,7,218,519,124,179,133,259,392,24,18,89,97,260,569,C
2002,20,82,2227,309,642,3,19,306,623,158,255,109,344,453,184,71,103,160,184,779,SF
2002,25,81,3023,474,1045,22,87,452,958,365,447,108,271,379,882,126,34,245,228,1335,PG
2002,25,76,2263,366,733,3,7,363,726,297,383,252,369,621,152,76,41,115,244,1032,C
2002,25,48,1391,208,452,2,4,206,448,190,253,176,225,401,101,52,29,74,156,608,C
2002,25,28,872,158,281,1,3,157,278,107,130,76,144,220,51,24,12,41,88,424,C
2002,21,63,2123,351,802,116,303,235,499,138,181,49,224,273,198,47,23,108,145,956,SF
2002,36,79,2889,414,913,180,443,234,470,296,325,23,196,219,253,88,10,120,143,1304,SG
2002,32,66,1237,178,427,48,127,130,300,85,107,51,139,190,72,31,13,56,120,489,SF
2002,38,74,726,98,227,10,35,88,192,38,49,18,64,82,45,12,4,26,79,244,SF
2002,26,74,3116,595,1358,149,377,446,981,267,314,63,237,300,187,109,37,180,189,1606,SG
2002,24,82,2168,329,713,0,1,329,712,137,222,242,409,651,33,63,61,118,252,795,C
2002,23,15,76,8,20,0,0,8,20,0,0,4,21,25,4,3,2,8,12,16,C
2002,30,49,655,53,132,0,1,53,131,10,31,36,104,140,16,12,23,25,92,116,C
2002,26,30,217,29,61,1,2,28,59,20,26,22,31,53,11,7,9,14,35,79,C
2002,23,68,1110,111,289,15,78,96,211,18,28,77,134,211,64,21,27,45,72,255,SF
2002,25,82,1371,169,384,1,13,168,371,57,76,81,187,268,50,20,19,70,174,396,C
2002,31,75,2455,447,866,1,3,446,863,283,431,182,450,632,87,27,186,182,258,1178,C
2002,21,82,1448,178,423,3,9,175,414,121,156,99,223,322,70,36,21,84,217,480,PF
2002,28,71,2312,430,986,101,238,329,748,215,263,81,291,372,157,70,43,141,148,1176,SF
2002,30,40,473,85,207,40,104,45,103,17,21,18,35,53,19,11,8,25,38,227,SF
2002,35,80,2907,321,641,0,0,321,641,278,364,254,609,863,83,29,190,156,242,920,C
2002,26,5,46,6,10,0,0,6,10,8,10,6,5,11,0,0,2,1,6,20,C
2002,26,79,1912,369,764,1,2,368,762,112,150,103,188,291,94,59,17,96,175,851,SF
2002,25,62,1357,150,300,0,2,150,298,100,148,149,193,342,38,56,30,40,156,400,PF
2002,27,82,2837,525,1088,156,343,369,745,260,293,50,204,254,634,53,4,229,164,1466,PG
2002,26,70,1498,183,421,13,47,170,374,64,93,105,213,318,91,61,22,49,164,443,SF
2002,25,82,2218,324,657,0,1,324,656,39,71,200,334,534,75,45,109,94,262,687,C
2002,27,42,1273,131,263,1,7,130,256,75,88,80,142,222,45,38,20,49,117,338,SF
2002,38,47,724,67,148,22,57,45,91,42,58,9,40,49,14,29,4,21,88,198,SF
2002,28,82,2249,251,631,36,134,215,497,127,169,73,173,246,403,81,4,156,130,665,PG
2002,23,76,2891,600,1258,139,350,461,908,440,516,120,635,755,186,83,77,145,222,1779,C
2002,23,72,2707,543,1133,1,14,542,1119,284,413,188,569,757,118,45,166,174,269,1371,PF
2002,29,67,2422,712,1229,0,1,712,1228,398,717,235,480,715,200,41,137,171,199,1822,C
2002,38,57,1383,97,263,1,6,96,257,21,28,72,271,343,114,49,11,87,175,216,PF
2002,22,29,999,151,360,16,84,135,276,61,93,31,145,176,171,23,36,97,91,379,SF
2002,39,61,1378,194,418,0,2,194,416,47,84,98,268,366,66,74,90,98,147,435,C
2002,23,20,139,17,46,2,13,15,33,6,9,0,8,8,21,3,0,11,16,42,PG
2002,29,81,1723,137,353,1,2,136,351,187,227,25,159,184,291,62,2,106,97,462,PG
2002,29,52,1146,97,253,1,2,96,251,109,130,18,110,128,193,36,1,80,64,304,PG
2002,29,29,577,40,100,0,0,40,100,78,97,7,49,56,98,26,1,26,33,158,PG
2002,26,80,2568,384,886,0,0,384,886,117,188,164,547,711,90,55,145,175,217,885,C
2002,28,74,1107,91,201,0,0,91,201,63,130,125,188,313,50,15,109,51,152,245,C
2002,30,83,1928,166,299,1,2,165,297,43,102,147,217,364,127,70,92,96,205,376,PF
2002,30,10,160,13,21,0,0,13,21,8,18,15,14,29,5,9,9,11,23,34,PF
2002,30,73,1768,153,278,1,2,152,276,35,84,132,203,335,122,61,83,85,182,342,PF
2002,32,18,130,14,44,7,27,7,17,4,7,1,11,12,13,3,1,12,10,39,PG
2002,20,36,221,22,41,0,0,22,41,11,18,27,52,79,4,4,2,14,36,55,C
2002,32,16,252,25,68,1,4,24,64,11,15,7,16,23,49,13,0,20,32,62,PG
2002,25,75,1295,188,395,49,113,139,282,75,102,111,174,285,82,43,13,69,140,500,PF
2002,23,41,518,52,135,12,34,40,101,36,51,8,42,50,54,21,3,24,38,152,PG
2002,23,28,272,30,79,1,7,29,72,18,23,3,20,23,29,9,1,16,23,79,SG
2002,19,77,2267,268,639,61,189,207,450,108,160,33,164,197,334,89,7,151,166,705,PG
2002,29,42,234,30,83,0,0,30,83,3,8,24,34,58,10,7,8,14,34,63,C
2002,26,75,1765,319,619,9,36,310,583,192,274,155,143,298,107,79,37,114,140,839,SF
2002,33,82,3301,737,1578,74,236,663,1342,267,335,80,316,396,737,131,26,209,179,1815,PG
2002,32,82,2060,288,684,111,283,177,401,50,58,37,169,206,177,61,11,76,137,737,SG
2002,27,3,12,1,2,0,0,1,2,3,4,0,2,2,2,2,0,0,0,5,PG
2002,32,2,48,5,10,0,0,5,10,1,2,0,4,4,7,3,0,7,6,11,PG
2002,30,78,2793,467,944,143,322,324,622,99,124,50,244,294,173,77,37,74,93,1176,SG
2002,24,63,1988,336,768,84,231,252,537,127,169,91,132,223,153,73,11,86,174,883,SF
2002,31,71,1718,207,471,111,238,96,233,101,113,43,141,184,112,41,12,64,110,626,SG
2002,24,82,3302,707,1598,210,520,497,1078,520,643,81,485,566,261,154,86,241,237,2144,SG
2002,36,62,1996,246,599,54,177,192,422,113,146,77,244,321,363,101,35,171,162,659,SF
2002,26,80,1881,197,358,0,0,197,358,115,166,188,377,565,53,70,76,68,202,509,C
2002,29,45,426,36,91,4,25,32,66,11,21,20,53,73,17,11,11,15,47,87,PF
2002,38,72,1294,136,321,59,142,77,179,68,83,12,152,164,205,45,16,85,89,399,PG
2002,25,73,2238,277,736,67,237,210,499,161,203,109,320,429,180,114,39,127,224,782,SF
2002,23,23,179,28,84,6,26,22,58,31,41,2,14,16,5,6,0,11,7,93,SG
2002,26,79,1343,137,301,0,0,137,301,89,120,167,180,347,30,37,18,63,174,363,C
2002,33,20,89,9,27,4,15,5,12,9,13,4,4,8,9,3,1,10,13,31,PG
2002,22,71,1128,76,142,0,1,76,141,38,90,78,205,283,21,20,118,43,199,190,C
2002,21,61,1230,146,354,66,157,80,197,49,72,45,185,230,81,56,24,72,119,407,PF
2002,20,41,238,48,107,0,0,48,107,18,27,31,38,69,13,7,4,15,29,114,PF
2002,28,3,82,10,20,0,0,10,20,6,11,5,11,16,1,1,8,7,8,26,C
2002,29,74,1179,189,374,0,0,189,374,135,175,84,206,290,38,28,73,84,192,513,C
2002,34,5,31,2,6,0,1,2,5,1,1,0,0,0,5,1,0,1,3,5,PG
2002,22,67,1417,294,609,88,198,206,411,91,115,77,147,224,91,42,7,57,96,767,SG
2002,28,68,714,90,190,0,0,90,190,44,68,65,111,176,27,20,44,54,180,224,PF
2002,34,20,606,65,167,18,64,47,103,24,30,5,42,47,31,12,3,24,34,172,SF
2002,21,80,2629,464,1090,82,246,382,844,141,210,124,216,340,236,106,31,160,195,1151,SG
2002,22,11,67,10,26,4,8,6,18,6,9,3,5,8,2,0,0,3,5,30,SG
2002,22,3,4,0,3,0,0,0,3,0,0,1,0,1,1,0,0,0,0,0,SG
2002,22,8,63,10,23,4,8,6,15,6,9,2,5,7,1,0,0,3,5,30,SG
2002,21,81,2152,400,926,133,349,267,577,143,187,113,221,334,128,78,21,102,142,1076,SG
2002,36,64,709,100,247,18,62,82,185,42,44,14,80,94,57,18,6,40,61,260,SG
2002,30,10,173,37,81,6,15,31,66,13,17,10,23,33,12,3,2,14,11,93,SG
2002,35,80,2855,454,1069,115,304,339,765,143,206,79,307,386,202,89,95,151,243,1166,PF
2002,36,78,2303,341,672,0,0,341,672,269,395,191,456,647,94,86,140,104,193,951,C
2002,25,29,653,112,247,2,5,110,242,36,48,24,54,78,37,23,11,36,35,262,SF
2002,29,66,2346,536,1147,58,178,478,969,236,282,70,336,406,168,97,41,174,173,1366,SF
2002,34,2,10,1,4,1,2,0,2,0,0,0,2,2,0,0,0,0,1,3,SG
2002,30,22,168,24,43,1,6,23,37,10,19,14,24,38,3,5,6,5,17,59,C
2002,30,77,1880,356,756,88,235,268,521,117,149,129,219,348,112,66,29,108,226,917,SF
2002,30,50,1254,249,534,49,140,200,394,82,99,95,146,241,72,50,17,66,148,629,SF
2002,30,27,626,107,222,39,95,68,127,35,50,34,73,107,40,16,12,42,78,288,SF
2002,32,61,728,81,194,0,0,81,194,21,29,32,92,124,25,12,21,20,114,183,C
2002,29,83,3153,663,1458,89,246,574,1212,281,335,43,330,373,355,78,45,201,251,1696,SF
2002,29,53,1937,387,871,52,146,335,725,156,186,29,220,249,197,45,29,105,148,982,SF
2002,29,30,1216,276,587,37,100,239,487,125,149,14,110,124,158,33,16,96,103,714,SF
2002,27,82,1725,293,633,1,12,292,621,185,257,172,320,492,61,70,42,140,208,772,PF
2002,25,15,169,7,26,0,0,7,26,2,8,23,28,51,5,5,8,11,23,16,PF
2002,31,66,1998,222,584,77,226,145,358,115,140,79,216,295,136,64,19,110,205,636,SG
2002,25,3,24,4,8,0,0,4,8,0,0,0,7,7,2,0,1,2,4,8,C
2002,22,7,36,3,14,0,0,3,14,4,5,3,4,7,2,3,0,2,3,10,SG
2002,20,36,560,73,199,7,27,66,172,36,46,17,35,52,108,31,1,53,43,189,PG
2002,23,28,290,23,67,3,10,20,57,11,15,12,39,51,21,9,2,24,39,60,PF
2002,29,21,252,37,75,0,0,37,75,8,20,53,50,103,8,3,6,15,49,82,C
2002,25,9,142,22,44,0,0,22,44,14,20,7,13,20,8,3,2,2,18,58,SF
2002,35,58,631,61,173,29,88,32,85,18,26,19,93,112,89,25,3,32,43,169,PG
2002,21,30,343,43,95,4,14,39,81,22,30,25,27,52,17,13,5,14,31,112,SF
2002,25,65,1107,88,162,0,0,88,162,48,79,93,188,281,17,24,61,42,130,224,PF
2002,31,8,47,7,15,0,0,7,15,7,10,5,4,9,1,1,1,1,3,21,PF
2002,31,4,10,2,2,0,0,2,2,1,1,0,2,2,0,0,0,1,1,5,PF
2002,31,4,37,5,13,0,0,5,13,6,9,5,2,7,1,1,1,0,2,16,PF
2002,26,60,1141,182,428,35,131,147,297,42,65,34,99,133,80,52,44,59,114,441,SG
2002,24,23,181,26,63,0,3,26,60,21,32,8,20,28,11,6,6,5,31,73,C
2002,24,12,71,6,21,0,1,6,20,6,12,2,12,14,6,2,4,2,12,18,C
2002,24,11,110,20,42,0,2,20,40,15,20,6,8,14,5,4,2,3,19,55,C
2002,26,72,1922,297,581,2,3,295,578,171,206,152,301,453,82,39,59,86,250,767,C
2002,21,14,100,10,26,0,0,10,26,11,17,10,21,31,3,5,1,3,12,31,C
2002,32,77,2211,310,682,116,246,194,436,159,181,45,148,193,151,54,15,108,158,895,SG
2002,28,61,2225,276,624,3,27,273,597,183,227,33,182,215,400,95,9,138,167,738,PG
2002,23,62,872,113,331,46,162,67,169,49,73,12,56,68,92,35,7,62,76,321,SG
2002,34,32,248,6,26,0,0,6,26,17,33,16,34,50,3,7,8,12,73,29,C
2002,31,81,3326,573,1419,145,403,428,1016,284,346,59,239,298,313,94,14,223,161,1575,SF
2002,27,76,2685,524,1319,86,300,438,1019,495,577,77,238,315,403,77,37,266,163,1629,SF
2002,36,66,929,114,310,29,95,85,215,33,41,15,53,68,70,33,0,52,126,290,SG
2002,25,67,884,117,249,1,2,116,247,50,104,100,170,270,16,24,44,52,103,285,C
2002,20,67,1134,143,371,2,25,141,346,37,53,44,87,131,116,29,24,68,82,325,SG
2002,26,11,93,8,23,0,0,8,23,6,11,12,13,25,3,4,3,4,22,22,C
2002,31,50,665,70,188,24,68,46,120,44,52,20,65,85,42,29,6,30,42,208,SG
2002,39,82,2566,401,775,25,78,376,697,275,321,59,204,263,674,152,24,208,209,1102,PG
2002,24,71,2649,547,1130,129,310,418,820,283,323,72,301,373,175,81,14,140,120,1506,SF
2002,28,75,2796,369,918,104,295,265,623,174,196,78,214,292,490,67,7,149,153,1016,PG
2002,28,79,1643,190,488,95,247,95,241,131,155,22,191,213,184,56,1,94,145,606,PG
2002,31,46,654,91,204,1,4,90,200,25,44,41,90,131,20,19,17,28,48,208,SF
2002,35,76,2294,316,714,8,26,308,688,154,201,49,183,232,463,82,11,159,114,794,PG
2002,21,22,88,16,40,0,1,16,39,0,2,7,14,21,3,3,3,4,16,32,C
2002,28,78,1780,250,590,42,133,208,457,236,328,89,167,256,275,88,17,133,160,778,PG
2002,22,68,1805,293,611,0,3,293,608,217,305,161,269,430,50,53,113,122,178,803,PF
2002,24,82,3117,609,1200,87,191,522,1009,226,272,120,271,391,257,66,21,181,188,1531,SF
2002,24,78,2967,524,1219,172,444,352,775,284,340,40,230,270,444,144,13,181,156,1504,SG
2002,23,47,618,81,151,0,0,81,151,41,74,55,126,181,6,17,35,26,76,203,C
2002,24,72,2484,396,829,0,16,396,813,223,336,158,358,516,137,85,66,143,195,1015,PF
2002,29,82,2771,463,938,1,6,462,932,216,265,214,533,747,87,71,79,153,341,1143,C
2002,24,74,1987,316,753,95,291,221,462,142,179,64,236,300,105,65,32,127,200,869,SF
2002,23,80,2442,289,760,42,175,247,585,131,186,78,220,298,647,138,40,270,248,751,PG
2002,25,65,1075,135,341,37,126,98,215,82,105,47,75,122,40,25,9,49,64,389,SG
2002,24,61,678,87,204,1,1,86,203,53,84,67,120,187,37,24,37,45,127,228,PF
2002,27,64,1140,193,381,0,2,193,379,92,144,104,166,270,60,21,27,58,160,478,PF
2002,22,12,77,7,23,0,1,7,22,4,7,3,9,12,12,8,4,11,8,18,SG
2002,22,67,1582,190,400,0,1,190,399,111,159,130,244,374,23,23,69,78,193,491,C
2002,22,80,1970,290,687,63,171,227,516,167,230,63,300,363,163,57,31,81,184,810,SF
2002,30,45,1739,372,912,85,252,287,660,136,174,19,150,169,365,30,7,116,69,965,PG
2002,30,27,757,129,314,34,98,95,216,65,77,9,76,85,113,14,4,40,35,357,SG
2002,26,81,2465,471,1089,101,293,370,796,156,195,137,472,609,164,63,42,146,221,1199,SF
2002,22,1,6,2,3,0,0,2,3,1,1,0,1,1,0,0,0,1,3,5,C
2002,26,82,1856,206,438,24,54,182,384,104,126,18,150,168,349,65,2,112,183,540,PG
2002,24,59,900,107,193,0,0,107,193,82,109,103,147,250,18,11,23,48,139,296,C
2002,25,81,3406,666,1689,222,645,444,1044,240,324,150,564,714,407,122,38,251,237,1794,PF
2002,25,69,1655,187,365,0,0,187,365,86,129,129,352,481,64,28,88,53,170,460,PF
2002,27,80,2921,255,480,0,3,255,477,99,234,318,721,1039,115,138,278,70,178,609,C
2002,19,54,430,75,175,0,7,75,168,23,46,49,40,89,27,19,6,22,46,173,SF
2002,27,46,490,93,214,5,13,88,201,40,46,27,58,85,29,11,9,29,60,231,SF
2002,27,79,2963,603,1287,114,317,489,970,201,274,136,509,645,152,101,101,131,212,1521,PF
2002,31,63,1058,113,303,53,164,60,139,47,58,15,112,127,203,68,14,75,100,326,PG
2002,22,64,964,96,212,16,44,80,168,23,36,31,52,83,125,60,5,51,93,231,PG
2002,31,56,1728,189,452,0,0,189,452,116,146,149,311,460,60,37,48,47,132,494,PF
2002,28,54,2071,532,1075,5,19,527,1056,253,338,150,396,546,258,90,76,158,181,1322,PF
2002,25,74,2348,487,1039,66,172,421,867,215,290,121,323,444,204,113,25,191,208,1255,SG
2002,31,67,2487,364,910,85,256,279,654,138,188,44,99,143,236,74,15,119,147,951,SG
2002,25,71,1346,150,279,0,0,150,279,83,154,159,285,444,17,25,75,65,163,383,C
2002,21,16,129,21,60,2,9,19,51,12,14,2,16,18,12,9,2,14,6,56,SF
2002,30,82,2171,274,656,131,323,143,333,154,175,11,141,152,314,72,6,85,182,833,PG
2002,30,82,1546,231,439,0,2,231,437,130,186,115,224,339,77,29,76,79,212,592,PF
2002,27,82,2927,403,971,62,193,341,778,103,140,58,223,281,468,135,26,150,191,971,PG
2002,29,74,1747,144,385,24,86,120,299,160,219,58,163,221,109,77,8,95,179,472,SF
2002,26,65,2236,376,985,127,430,249,555,80,101,22,173,195,519,111,7,214,102,959,PG
2002,28,68,1641,190,388,0,0,190,388,138,204,165,221,386,75,78,25,68,153,518,PF
2002,30,68,1284,198,362,0,4,198,358,88,134,80,155,235,96,49,17,86,134,484,SF
2002,33,41,737,86,217,0,2,86,215,30,41,82,127,209,13,17,33,35,98,202,PF
2002,26,50,603,81,193,28,75,53,118,31,39,16,47,63,83,21,2,35,35,221,SG
2002,31,48,1117,166,396,78,183,88,213,40,51,37,125,162,69,18,10,53,106,450,SF
2002,28,78,1701,411,806,1,5,410,801,240,298,117,202,319,94,49,26,137,226,1063,SF
2002,39,52,865,125,284,0,1,125,283,65,87,105,194,299,14,25,23,41,98,315,PF
2002,23,60,516,33,96,0,2,33,94,44,60,46,76,122,22,17,34,36,60,110,C
2002,22,55,1642,269,636,53,170,216,466,136,204,73,198,271,127,141,39,118,217,727,SF
2002,22,27,823,152,351,36,91,116,260,81,129,40,91,131,77,75,23,69,108,421,SF
2002,22,28,819,117,285,17,79,100,206,55,75,33,107,140,50,66,16,49,109,306,SF
2002,26,43,1251,223,486,0,2,223,484,70,123,130,275,405,44,30,23,72,126,516,C
2002,24,55,600,109,248,48,116,61,132,42,57,19,92,111,22,11,18,25,84,308,C
2003,28,14,204,27,58,0,1,27,57,3,6,14,26,40,21,6,3,7,26,57,SG
2003,26,81,3087,566,1183,21,60,545,1123,455,541,175,502,677,242,87,38,212,240,1608,PF
2003,25,66,1360,193,505,19,57,174,448,118,146,39,79,118,79,31,6,68,125,523,PG
2003,24,80,2318,335,790,0,4,335,786,97,121,134,291,425,54,37,78,128,234,767,PF
2003,27,76,2880,598,1363,201,533,397,830,316,345,94,287,381,334,103,14,198,220,1713,SG
2003,27,47,1683,351,803,123,311,228,492,178,195,45,173,218,164,57,11,117,149,1003,SG
2003,27,29,1197,247,560,78,222,169,338,138,150,49,114,163,170,46,3,81,71,710,SG
2003,26,47,980,139,335,51,130,88,205,37,54,21,86,107,192,38,15,86,120,366,PG
2003,32,50,474,37,118,0,0,37,118,25,52,26,51,77,21,14,7,34,50,99,C
2003,24,59,907,114,285,0,1,114,284,77,140,109,165,274,32,30,60,60,90,305,C
2003,28,76,2556,355,832,116,331,239,501,231,269,53,211,264,325,90,16,128,141,1057,PG
2003,32,61,1135,163,382,1,7,162,375,45,57,31,101,132,198,58,5,75,106,372,PG
2003,32,38,689,102,232,0,5,102,227,29,35,17,70,87,121,40,1,33,63,233,PG
2003,32,23,446,61,150,1,2,60,148,16,22,14,31,45,77,18,4,42,43,139,PG
2003,29,82,1731,248,537,52,140,196,397,139,190,64,190,254,87,73,20,114,177,687,SF
2003,22,12,72,6,20,0,0,6,20,7,18,6,11,17,3,0,3,7,9,19,PF
2003,21,82,2866,509,1180,109,313,400,867,370,468,97,289,386,514,124,17,290,260,1497,PG
2003,22,17,69,9,27,1,6,8,21,5,6,0,4,4,2,3,1,5,8,24,SG
2003,34,82,2350,263,643,78,232,185,411,165,188,91,204,295,323,135,13,160,167,769,PG
2003,23,44,287,50,109,3,7,47,102,18,22,11,15,26,53,12,1,30,28,121,PG
2003,28,65,1398,168,465,86,242,82,223,40,49,21,75,96,175,27,4,77,108,462,PG
2003,34,70,862,79,192,0,7,79,185,54,72,26,93,119,69,27,9,40,80,212,SG
2003,22,10,76,8,26,0,0,8,26,3,4,7,13,20,4,3,3,5,11,19,C
2003,31,52,942,99,207,0,4,99,203,72,107,90,108,198,29,22,30,61,146,270,C
2003,31,75,2480,264,577,118,293,146,284,128,161,48,253,301,384,113,15,142,199,774,SG
2003,33,80,1473,191,424,87,214,104,210,86,100,33,147,180,206,63,14,81,104,555,SG
2003,27,16,106,15,25,0,0,15,25,10,12,4,19,23,0,4,11,6,16,40,PF
2003,27,12,46,4,17,1,3,3,14,0,2,2,8,10,4,0,0,6,14,9,C
2003,25,75,1248,197,467,18,81,179,386,69,88,82,175,257,52,42,16,69,120,481,PF
2003,26,67,1683,199,369,1,5,198,364,88,118,148,285,433,49,33,81,48,197,487,C
2003,24,78,2383,275,569,86,216,189,353,120,145,128,217,345,105,102,88,68,207,756,SF
2003,24,55,682,96,206,0,2,96,204,70,103,65,100,165,16,9,22,46,135,262,C
2003,26,75,1173,93,211,21,51,72,160,23,34,47,98,145,57,52,8,43,134,230,SG
2003,22,46,819,112,254,19,53,93,201,60,84,42,91,133,42,8,56,42,86,303,SF
2003,24,9,152,13,43,2,13,11,30,12,16,10,21,31,10,1,2,6,20,40,SG
2003,30,72,1807,231,583,36,109,195,474,105,123,26,121,147,255,44,7,106,174,603,PG
2003,24,55,1835,329,700,56,137,273,563,161,187,34,113,147,285,72,8,127,93,875,PG
2003,26,74,2327,366,870,149,380,217,490,318,362,38,235,273,287,63,15,134,136,1199,PG
2003,34,50,836,65,134,0,0,65,134,20,35,68,137,205,50,33,19,43,121,150,C
2003,27,81,1403,150,347,0,0,150,347,101,139,111,197,308,56,42,68,103,187,401,C
2003,27,54,885,105,267,0,0,105,267,71,99,62,121,183,35,22,51,70,112,281,C
2003,27,27,518,45,80,0,0,45,80,30,40,49,76,125,21,20,17,33,75,120,C
2003,26,47,575,52,119,0,2,52,117,34,47,32,77,109,12,11,33,22,74,138,C
2003,21,81,2049,331,618,0,1,331,617,148,192,202,407,609,106,59,50,103,224,810,PF
2003,24,2,5,0,1,0,0,0,1,0,0,1,0,1,1,1,0,0,0,0,C
2003,31,82,2566,223,479,101,229,122,250,36,89,59,180,239,113,66,42,72,195,583,SF
2003,27,62,996,97,197,2,7,95,190,27,41,78,79,157,54,65,29,43,82,223,SG
2003,26,68,1321,199,464,29,77,170,387,173,200,35,53,88,221,38,4,73,75,600,PG
2003,23,67,1314,151,314,1,6,150,308,35,67,162,247,409,67,16,32,76,125,338,PF
2003,30,81,1731,201,375,0,1,201,374,141,175,151,325,476,54,65,170,67,242,543,C
2003,23,62,2454,451,899,0,1,451,898,244,356,283,420,703,157,71,158,161,204,1146,PF
2003,22,64,1503,171,464,101,286,70,178,85,111,18,127,145,164,38,3,59,80,528,PG
2003,22,10,80,9,17,0,2,9,15,4,9,5,4,9,18,2,1,6,11,22,PG
2003,23,22,111,15,38,0,1,15,37,12,20,13,10,23,4,2,4,7,16,42,C
2003,23,5,115,11,35,0,2,11,33,6,8,3,12,15,3,1,0,6,14,28,PF
2003,24,10,93,12,35,0,1,12,34,6,8,8,10,18,7,4,1,9,14,30,SG
2003,24,7,22,5,10,0,0,5,10,2,2,4,3,7,2,0,0,5,3,12,SG
2003,24,3,71,7,25,0,1,7,24,4,6,4,7,11,5,4,1,4,11,18,SG
2003,21,51,666,61,171,3,39,58,132,20,32,45,95,140,20,34,13,23,68,145,SF
2003,20,80,1773,224,502,0,3,224,499,145,217,128,298,426,58,50,80,110,159,593,C
2003,33,78,2609,319,601,0,3,319,598,194,232,243,458,701,147,67,80,98,203,832,PF
2003,34,32,262,16,43,0,0,16,43,9,12,3,23,26,35,17,2,17,36,41,PG
2003,23,15,168,27,59,0,1,27,58,11,14,8,22,30,39,13,0,22,9,65,PG
2003,30,17,196,23,50,4,6,19,44,10,12,4,15,19,36,10,3,17,20,60,PG
2003,24,82,3401,868,1924,124,324,744,1600,601,713,106,458,564,481,181,67,288,218,2461,SG
2003,37,16,100,5,19,0,0,5,19,3,4,8,12,20,4,1,1,7,18,13,PF
2003,37,11,77,5,17,0,0,5,17,2,2,7,9,16,1,1,1,5,12,12,PF
2003,37,3,14,0,1,0,0,0,1,1,2,1,1,2,2,0,0,2,4,1,PF
2003,37,2,9,0,1,0,0,0,1,0,0,0,2,2,1,0,0,0,2,0,PF
2003,26,75,1514,185,398,15,55,170,343,65,81,72,144,216,96,72,16,62,203,450,SG
2003,29,62,783,113,296,1,7,112,289,40,58,57,89,146,23,19,25,47,99,267,C
2003,22,78,2858,429,1032,34,107,395,925,309,375,135,262,397,213,137,31,192,230,1201,SF
2003,23,72,1514,207,572,50,171,157,401,76,104,29,157,186,93,21,43,77,105,540,SG
2003,29,51,894,113,248,0,0,113,248,69,106,68,108,176,38,19,15,56,122,295,PF
2003,28,29,616,93,227,2,5,91,222,33,50,75,133,208,47,20,40,27,69,221,C
2003,34,56,869,117,295,0,1,117,294,109,136,47,134,181,51,33,39,50,129,343,C
2003,34,41,685,101,247,0,1,101,246,93,115,34,108,142,42,24,31,42,102,295,C
2003,34,15,184,16,48,0,0,16,48,16,21,13,26,39,9,9,8,8,27,48,C
2003,25,5,15,1,4,0,1,1,3,2,2,3,2,5,1,0,0,1,0,4,PF
2003,27,49,912,83,233,0,8,83,225,33,50,12,71,83,203,45,5,81,70,199,PG
2003,26,43,1471,355,760,45,131,310,629,129,160,59,129,188,143,48,41,74,121,884,SG
2003,33,78,2700,546,1162,59,163,487,999,385,447,57,285,342,450,88,14,177,216,1536,PG
2003,28,73,1247,133,256,0,4,133,252,66,124,132,296,428,20,38,85,56,176,332,C
2003,20,75,1827,257,484,0,0,257,484,177,291,169,345,514,76,37,106,135,220,691,C
2003,31,81,2351,325,651,10,25,315,626,40,69,73,211,284,163,65,13,108,225,700,SG
2003,35,12,106,6,20,1,6,5,14,2,3,3,2,5,16,8,1,6,17,15,PG
2003,32,80,2710,267,557,73,185,194,372,141,174,61,281,342,376,180,37,144,186,748,SG
2003,27,80,1780,226,451,0,4,226,447,84,128,138,313,451,80,38,150,94,227,536,C
2003,24,30,471,67,145,0,11,67,134,39,57,22,34,56,75,22,7,35,43,173,PG
2003,25,12,55,6,23,1,1,5,22,3,4,1,7,8,10,2,0,14,6,16,PG
2003,35,64,1742,223,498,22,67,201,431,134,171,151,299,450,87,53,69,96,171,602,C
2003,34,35,691,56,168,7,32,49,136,35,42,11,48,59,72,17,4,28,60,154,PG
2003,34,21,516,34,119,7,25,27,94,27,34,10,38,48,56,11,4,18,43,102,PG
2003,34,14,175,22,49,0,7,22,42,8,8,1,10,11,16,6,0,10,17,52,PG
2003,25,13,104,17,36,0,0,17,36,2,2,12,17,29,1,2,1,2,10,36,C
2003,24,22,421,38,86,0,1,38,85,44,62,32,28,60,14,5,6,19,70,120,C
2003,24,81,1900,140,338,0,4,140,334,180,236,136,232,368,87,47,44,85,252,460,C
2003,27,5,38,8,13,1,3,7,10,7,8,3,4,7,1,2,3,2,7,24,PF
2003,22,80,1992,334,808,86,242,248,566,104,129,21,164,185,334,77,25,134,126,858,PG
2003,27,49,633,86,209,27,69,59,140,53,65,40,115,155,56,6,13,28,48,252,PF
2003,33,12,180,14,41,4,13,10,28,9,15,1,14,15,29,3,0,9,16,41,PG
2003,20,81,1571,335,573,0,0,335,573,179,287,116,237,353,37,18,62,137,226,849,C
2003,34,78,1555,92,229,16,54,76,175,36,45,16,111,127,104,44,4,43,163,236,SF
2003,27,82,1978,259,522,0,2,259,520,155,222,248,295,543,58,27,154,112,242,673,C
2003,27,67,872,84,186,18,59,66,127,65,76,11,61,72,85,33,9,32,43,251,SG
2003,34,53,1894,261,641,0,0,261,641,216,280,130,307,437,131,23,62,118,150,738,C
2003,23,50,1889,332,798,99,283,233,515,93,131,56,130,186,320,91,22,140,148,856,PG
2003,33,78,2282,237,438,0,0,237,438,105,166,233,331,564,94,51,70,71,189,579,C
2003,34,24,340,32,88,7,29,25,59,17,22,5,38,43,36,12,2,25,28,88,SG
2003,32,43,328,31,79,12,36,19,43,5,6,6,30,36,29,5,0,11,23,79,SG
2003,23,79,3131,602,1470,74,204,528,1266,348,465,97,293,390,436,125,36,277,180,1626,SG
2003,29,77,1327,149,279,0,0,149,279,67,104,142,197,339,52,39,36,84,258,365,C
2003,29,67,1873,233,560,120,304,113,256,68,87,41,191,232,146,72,10,69,124,654,PG
2003,24,50,515,70,170,22,61,48,109,21,26,9,34,43,85,14,2,53,66,183,PG
2003,27,6,87,10,24,4,11,6,13,5,5,1,5,6,8,5,1,6,16,29,SG
2003,21,80,943,54,154,0,0,54,154,11,30,63,152,215,43,33,81,56,148,119,PF
2003,34,80,2384,305,655,6,25,299,630,179,251,157,417,574,274,83,105,152,239,795,C
2003,24,42,647,104,271,25,84,79,187,37,46,13,59,72,40,26,3,42,54,270,PG
2003,25,75,1041,146,343,0,0,146,343,36,46,65,154,219,42,16,16,49,150,328,C
2003,22,55,969,128,329,50,139,78,190,44,57,9,63,72,89,24,6,60,93,350,SG
2003,28,13,79,8,27,3,7,5,20,0,0,4,9,13,11,2,0,3,2,19,PG
2003,27,82,1984,325,789,30,85,295,704,91,115,111,209,320,86,48,38,65,180,771,C
2003,37,3,11,0,1,0,0,0,1,0,0,2,0,2,0,0,0,0,3,0,C
2003,26,81,3181,714,1392,6,22,708,1370,450,634,259,784,1043,316,55,237,248,231,1884,PF
2003,22,82,1305,168,417,52,150,116,267,78,100,66,148,214,106,53,19,86,120,466,SF
2003,30,82,2243,262,628,131,337,131,291,89,105,24,162,186,444,71,9,149,222,744,PG
2003,32,55,784,100,262,27,107,73,155,50,66,44,113,157,15,15,15,31,88,277,PF
2003,24,52,802,92,186,0,0,92,186,52,74,64,110,174,15,10,32,50,95,236,C
2003,27,17,135,7,19,0,0,7,19,3,4,10,19,29,6,10,7,6,35,17,C
2003,22,67,1365,66,140,0,0,66,140,80,154,167,278,445,34,38,11,52,173,212,PF
2003,36,64,601,44,124,21,60,23,64,10,13,20,55,75,21,7,9,27,55,119,SF
2003,29,69,2642,507,1193,119,322,388,871,198,230,107,295,402,205,76,21,114,105,1331,SF
2003,28,82,2829,339,775,85,212,254,563,100,125,40,199,239,298,93,15,94,195,863,PG
2003,24,38,809,178,383,1,6,177,377,88,134,80,136,216,48,14,17,57,89,445,PF
2003,21,11,31,3,9,0,0,3,9,1,3,0,6,6,1,0,0,2,7,7,PF
2003,21,17,86,10,35,0,3,10,32,4,6,4,7,11,11,4,0,10,6,24,SG
2003,26,17,223,20,54,0,1,20,53,19,29,28,45,73,12,9,0,15,43,59,PF
2003,34,29,539,47,122,1,4,46,118,26,32,30,72,102,13,1,9,30,82,121,C
2003,26,77,802,64,178,0,2,64,176,34,63,118,161,279,51,28,21,34,103,162,C
2003,26,37,573,56,128,2,9,54,119,50,59,41,62,103,23,25,2,20,63,164,SF
2003,33,76,2181,262,621,105,280,157,341,52,69,64,259,323,253,69,14,121,215,681,SF
2003,27,82,1787,185,345,0,1,185,344,70,104,176,314,490,37,40,205,73,214,440,C
2003,25,81,3318,571,1312,85,240,486,1072,476,595,159,340,499,502,141,41,299,251,1703,PG
2003,32,27,229,32,72,0,0,32,72,10,17,17,38,55,8,1,11,6,25,74,PF
2003,24,49,760,70,145,0,1,70,144,29,56,66,131,197,9,22,52,27,125,169,C
2003,26,82,3321,743,1481,20,71,723,1410,377,502,244,858,1102,495,113,129,229,199,1883,PF
2003,26,81,2584,312,744,161,407,151,337,83,100,72,234,306,121,62,20,77,255,868,PF
2003,22,82,2948,569,1116,1,10,568,1106,416,565,192,528,720,229,34,148,213,220,1555,PF
2003,25,71,1613,180,461,49,132,131,329,83,105,91,195,286,92,56,38,65,180,492,SF
2003,34,82,2068,286,677,19,59,267,618,123,161,51,197,248,156,78,15,108,176,714,SG
2003,25,69,1431,174,397,51,148,123,249,126,171,47,114,161,138,96,17,100,170,525,SG
2003,25,49,1187,207,478,46,130,161,348,88,107,18,90,108,70,22,6,94,104,548,SG
2003,25,27,961,143,325,39,119,104,206,62,76,18,112,130,67,30,2,51,55,387,SF
2003,24,76,1890,277,648,56,158,221,490,127,162,62,220,282,141,71,15,108,146,737,SG
2003,31,15,85,9,25,3,9,6,16,4,7,0,6,6,4,3,0,6,6,25,PG
2003,31,10,51,5,18,2,8,3,10,0,2,0,3,3,3,3,0,2,5,12,PG
2003,31,5,34,4,7,1,1,3,6,4,5,0,3,3,1,0,0,4,1,13,PG
2003,21,51,1329,255,576,14,46,241,530,92,132,105,190,295,63,38,22,105,121,616,SF
2003,21,19,544,100,201,0,2,100,199,59,80,58,102,160,20,15,13,45,51,259,PF
2003,30,82,2641,344,676,0,0,344,676,158,205,241,596,837,104,63,47,129,300,846,C
2003,37,5,85,13,25,0,0,13,25,0,0,2,6,8,7,3,0,1,5,26,PF
2003,28,74,1373,146,337,6,24,140,313,27,32,88,176,264,105,77,6,47,157,325,SG
2003,20,77,1890,271,678,64,192,207,486,58,94,138,323,461,86,52,111,76,136,664,PF
2003,33,27,447,60,132,0,1,60,131,9,9,25,75,100,31,14,5,31,35,129,PF
2003,24,2,9,0,4,0,1,0,3,0,0,0,0,0,2,1,0,1,0,0,PG
2003,22,39,441,66,153,3,12,63,141,26,38,21,32,53,9,7,18,21,55,161,PF
2003,29,75,926,71,159,0,3,71,156,38,79,73,80,153,38,16,19,65,127,180,SG
2003,24,82,2640,570,1286,32,119,538,1167,440,528,88,230,318,208,64,13,200,249,1612,SG
2003,27,3,12,2,5,0,0,2,5,2,2,1,3,4,0,1,0,1,2,6,C
2003,31,58,1777,256,573,26,73,230,500,77,97,66,192,258,235,66,26,145,150,615,SG
2003,36,10,127,18,49,11,31,7,18,2,4,1,14,15,24,9,0,11,8,49,PG
2003,26,78,2557,521,1020,66,160,455,860,262,331,190,324,514,133,73,17,160,217,1370,SF
2003,22,19,111,11,37,5,14,6,23,3,4,1,7,8,12,2,1,2,8,30,SG
2003,22,13,37,4,17,1,3,3,14,2,2,0,2,2,2,1,1,2,2,11,SG
2003,22,6,74,7,20,4,11,3,9,1,2,1,5,6,10,1,0,0,6,19,SG
2003,22,82,2467,389,896,13,46,376,850,211,274,159,352,511,125,71,33,163,280,1002,SF
2003,22,82,2003,169,467,7,28,162,439,73,112,44,206,250,277,80,15,157,250,418,PG
2003,29,74,1850,225,443,0,0,225,443,123,150,165,311,476,62,12,23,90,231,573,PF
2003,32,77,1973,298,721,47,136,251,585,152,189,63,169,232,155,53,8,71,95,795,SG
2003,32,4,32,2,5,0,0,2,5,0,0,1,5,6,0,1,4,3,7,4,PF
2003,22,77,1613,246,551,1,7,245,544,118,176,125,284,409,100,48,27,123,203,611,SF
2003,23,82,1999,144,392,13,40,131,352,41,55,37,218,255,151,45,61,83,197,342,SG
2003,23,12,57,2,17,0,3,2,14,2,4,0,7,7,3,0,5,7,10,6,SF
2003,29,58,685,57,148,10,24,47,124,10,20,16,62,78,47,29,6,29,57,134,SG
2003,23,81,1930,173,339,0,0,173,339,155,245,192,212,404,29,32,119,65,225,501,C
2003,30,82,1494,153,327,0,2,153,325,88,138,156,242,398,41,33,32,61,168,394,C
2003,20,80,2258,321,619,0,3,321,616,197,341,208,283,491,149,127,65,181,295,839,C
2003,30,29,843,151,307,1,4,150,303,118,144,40,166,206,122,28,13,84,46,421,SF
2003,34,56,1351,129,306,0,0,129,306,54,80,126,265,391,41,46,26,68,172,312,PF
2003,34,32,855,85,197,0,0,85,197,33,45,70,197,267,32,31,19,52,104,203,PF
2003,34,24,496,44,109,0,0,44,109,21,35,56,68,124,9,15,7,16,68,109,PF
2003,30,63,784,49,126,5,21,44,105,41,50,11,126,137,70,40,5,25,59,144,SG
2003,32,80,2343,184,476,51,177,133,299,103,134,181,333,514,233,96,61,112,247,522,PF
2003,24,55,1025,172,444,36,120,136,324,31,36,17,84,101,87,44,1,46,73,411,SG
2003,31,82,3108,652,1465,178,450,474,1015,363,395,26,205,231,220,54,7,178,191,1845,SG
2003,29,77,2730,567,1261,2,4,565,1257,282,351,181,404,585,234,77,27,189,239,1418,PF
2003,26,79,2600,409,956,97,266,312,690,208,231,42,141,183,452,60,7,182,160,1123,PG
2003,27,7,76,9,25,0,0,9,25,5,8,9,14,23,5,1,3,3,13,23,C
2003,24,67,2137,346,741,29,79,317,662,136,186,67,241,308,205,86,24,136,149,857,PG
2003,23,48,444,35,120,0,0,35,120,23,39,34,65,99,11,9,18,23,75,93,PF
2003,23,35,322,23,85,0,0,23,85,18,28,30,39,69,7,4,16,21,57,64,PF
2003,23,13,122,12,35,0,0,12,35,5,11,4,26,30,4,5,2,2,18,29,PF
2003,32,29,673,106,302,34,107,72,195,34,47,15,44,59,71,35,5,57,50,280,PG
2003,21,33,447,56,103,0,0,56,103,18,44,38,55,93,6,9,36,15,56,130,C
2003,27,81,2432,495,1122,0,5,495,1117,400,512,240,371,611,127,56,152,210,274,1390,C
2003,27,82,3485,804,1940,84,303,720,1637,570,736,68,276,344,454,225,13,286,149,2262,SG
2003,29,59,1676,340,732,89,235,251,497,126,149,57,162,219,182,71,3,106,126,895,PG
2003,26,53,559,40,110,1,10,39,100,40,55,19,38,57,74,19,6,34,51,121,SG
2003,26,24,286,21,68,1,9,20,59,23,27,10,15,25,39,9,3,19,24,66,SG
2003,26,29,273,19,42,0,1,19,41,17,28,9,23,32,35,10,3,15,27,55,SG
2003,32,63,1309,204,462,32,71,172,391,47,55,84,178,262,118,31,4,80,132,487,SF
2003,28,77,1041,153,349,1,1,152,348,114,149,86,139,225,37,24,30,59,137,421,C
2003,37,82,1467,147,369,27,95,120,274,61,80,34,142,176,375,48,3,152,90,382,PG
2003,24,80,2254,356,818,95,297,261,521,139,183,66,220,286,183,125,30,176,202,946,SG
2003,21,72,1147,122,327,52,165,70,162,72,105,29,54,83,73,35,6,55,90,368,SF
2003,27,51,766,111,232,0,0,111,232,54,92,78,138,216,27,12,82,75,166,276,C
2003,27,78,1722,218,585,67,228,151,357,104,142,26,123,149,246,64,5,108,176,607,PG
2003,26,82,3226,691,1471,65,209,626,1262,375,475,195,383,578,156,76,45,177,197,1822,SF
2003,24,66,1379,179,446,53,166,126,280,79,105,35,125,160,193,97,11,103,125,490,SF
2003,22,51,666,75,194,18,54,57,140,29,43,16,43,59,22,19,16,45,56,197,SF
2003,22,80,2879,456,911,6,24,450,887,324,436,150,364,514,201,80,44,156,216,1242,SF
2003,21,20,292,30,63,3,6,27,57,16,29,26,32,58,16,8,5,21,28,79,SF
2003,28,66,842,103,231,13,35,90,196,51,74,13,65,78,86,37,5,41,93,270,PG
2003,37,48,430,63,150,0,2,63,148,30,39,10,21,31,64,15,1,29,26,156,PG
2003,35,69,1170,61,135,0,0,61,135,30,44,117,177,294,24,34,63,34,178,152,C
2003,21,82,2255,316,796,75,205,241,591,96,124,57,207,264,210,62,19,108,143,803,SG
2003,24,16,156,15,37,0,0,15,37,2,6,4,28,32,0,1,12,6,20,32,C
2003,26,49,709,80,210,44,121,36,89,20,27,11,59,70,80,18,4,23,42,224,PG
2003,31,47,1789,291,688,98,241,193,447,189,230,35,191,226,173,64,31,85,137,869,SG
2003,23,19,115,9,24,2,7,7,17,3,4,4,5,9,5,6,1,6,13,23,SG
2003,23,80,2204,308,710,111,314,197,396,57,83,106,299,405,112,67,22,107,176,784,SF
2003,32,26,222,24,62,0,0,24,62,5,11,29,30,59,8,5,1,15,31,53,PF
2003,39,82,3031,679,1527,16,55,663,1472,266,324,71,426,497,311,123,39,173,171,1640,SF
2003,33,79,1633,211,505,0,1,211,504,115,155,147,304,451,55,66,33,102,239,537,C
2003,37,75,952,110,256,49,124,61,132,30,34,12,48,60,70,27,3,35,49,299,PG
2003,29,80,2989,515,1244,126,370,389,874,339,403,110,394,504,711,179,25,296,127,1495,PG
2003,21,80,2213,315,642,37,114,278,528,296,370,147,273,420,138,118,175,136,185,963,SF
2003,28,65,1951,332,711,78,219,254,492,106,135,52,200,252,170,101,30,55,110,848,SG
2003,27,55,928,97,228,2,8,95,220,20,37,15,66,81,233,69,2,94,123,216,PG
2003,28,32,287,25,65,0,1,25,64,10,13,18,44,62,14,8,9,10,44,60,C
2003,34,63,1704,249,577,95,263,154,314,137,194,67,199,266,230,81,29,122,134,730,PF
2003,33,76,2215,255,516,2,16,253,500,120,144,114,388,502,235,82,40,87,206,632,PF
2003,26,69,1611,266,514,47,116,219,398,60,88,125,205,330,54,35,91,46,264,639,C
2003,23,35,487,56,129,0,4,56,125,57,82,26,57,83,31,7,3,25,43,169,SF
2003,25,60,541,81,202,9,31,72,171,12,20,19,68,87,21,15,6,16,58,183,SF
2003,29,63,1929,325,809,92,252,233,557,156,194,48,164,212,144,59,21,103,156,898,SG
2003,23,77,3044,519,1149,75,217,444,932,283,345,152,351,503,133,99,35,143,205,1396,SF
2003,27,2,12,2,4,0,0,2,4,2,2,0,0,0,1,0,0,0,0,6,PG
2003,30,26,211,28,75,2,3,26,72,2,10,21,39,60,6,5,11,20,35,60,SF
2003,30,19,131,19,50,1,1,18,49,1,5,13,27,40,2,2,8,9,22,40,SF
2003,30,7,80,9,25,1,2,8,23,1,5,8,12,20,4,3,3,11,13,20,SF
2003,36,41,488,27,70,0,3,27,67,18,23,24,59,83,25,9,1,19,62,72,PF
2003,25,75,1986,248,573,60,176,188,397,91,104,22,127,149,263,47,1,77,151,647,PG
2003,32,81,1497,147,359,28,79,119,280,41,74,139,214,353,104,66,19,52,136,363,SG
2003,27,42,812,123,238,0,0,123,238,53,79,66,130,196,20,19,32,35,107,299,C
2003,21,9,35,3,12,0,3,3,9,5,8,1,6,7,5,3,1,3,4,11,SG
2003,27,54,781,69,163,0,0,69,163,36,61,86,73,159,38,15,19,27,116,174,PF
2003,23,64,2006,343,773,62,177,281,596,325,405,77,245,322,123,55,16,147,194,1073,SG
2003,24,82,2443,305,635,0,3,305,632,231,322,260,464,724,88,49,111,158,276,841,C
2003,39,81,2936,595,1289,3,14,592,1275,474,621,113,515,628,379,136,31,210,204,1667,PF
2003,31,14,103,8,25,5,15,3,10,3,5,1,6,7,17,4,0,5,9,24,PG
2003,36,13,89,13,32,3,8,10,24,5,6,7,11,18,7,9,3,7,11,34,PF
2003,25,81,3240,671,1530,89,296,582,1234,375,467,53,210,263,654,108,20,263,200,1806,PG
2003,24,81,3373,662,1466,141,364,521,1102,251,295,199,574,773,198,185,95,157,208,1716,SF
2003,27,23,223,22,59,0,1,22,58,10,15,8,27,35,3,5,6,14,37,54,PF
2003,30,3,6,0,3,0,1,0,2,0,0,0,3,3,0,0,0,1,0,0,SF
2003,29,78,2378,421,918,33,87,388,831,167,221,234,465,699,137,95,85,135,234,1042,PF
2003,25,77,2628,509,1082,9,43,500,1039,256,392,164,476,640,185,98,70,192,294,1283,PF
2003,30,82,3321,670,1586,119,306,551,1280,313,369,66,432,498,462,83,17,230,196,1772,SF
2003,36,65,2119,191,393,0,1,191,392,84,117,90,326,416,209,32,12,79,147,466,C
2003,25,80,2763,457,1017,21,72,436,945,212,283,154,369,523,163,67,32,115,210,1147,SF
2003,25,52,1811,291,667,16,55,275,612,134,181,88,247,335,95,47,21,74,136,732,SF
2003,25,28,952,166,350,5,17,161,333,78,102,66,122,188,68,20,11,41,74,415,SF
2003,22,17,113,11,31,6,18,5,13,2,2,2,10,12,12,4,0,5,20,30,SF
2003,35,58,792,104,232,0,0,104,232,65,84,59,97,156,17,17,19,50,144,273,C
2003,28,82,1949,173,418,91,248,82,170,61,98,64,224,288,106,78,28,67,188,498,SF
2003,29,11,70,4,17,0,0,4,17,3,4,7,15,22,5,3,1,2,13,11,C
2003,25,67,1367,194,395,0,0,194,395,69,126,95,260,355,43,28,60,96,162,457,C
2003,23,75,2954,829,1813,173,448,656,1365,576,726,121,367,488,411,124,59,195,156,2407,SG
2003,28,75,1311,188,423,6,35,182,388,50,67,22,75,97,170,21,2,75,117,432,PG
2003,30,80,2374,286,666,37,112,249,554,112,134,61,289,350,278,131,9,109,177,721,SF
2003,23,58,620,112,258,0,2,112,256,31,43,66,75,141,18,11,8,37,118,255,PF
2003,26,72,1671,244,597,3,16,241,581,65,81,32,122,154,112,49,14,54,123,556,SG
2003,23,52,809,116,287,0,3,116,284,76,105,93,138,231,28,18,38,48,124,308,C
2003,21,67,2008,263,642,0,14,263,628,92,155,113,250,363,176,67,69,178,159,618,SF
2003,26,80,2913,377,928,23,108,354,820,311,391,84,232,316,537,99,11,206,203,1088,PG
2003,26,73,2270,329,667,5,16,324,651,292,357,185,418,603,193,65,43,118,203,955,C
2003,22,65,2186,373,859,109,300,264,559,156,186,46,295,341,170,42,21,125,173,1011,SF
2003,22,49,1826,296,708,87,256,209,452,127,150,40,246,286,139,36,16,99,139,806,SF
2003,22,16,360,77,151,22,44,55,107,29,36,6,49,55,31,6,5,26,34,205,SF
2003,37,70,2117,281,637,113,318,168,319,207,230,21,151,172,170,62,4,66,89,882,SG
2003,33,21,262,39,106,7,25,32,81,16,18,19,31,50,22,7,3,10,29,101,PF
2003,22,82,2382,401,805,1,2,400,803,301,371,196,479,675,137,31,147,173,230,1104,C
2003,27,73,3044,463,1067,112,318,351,749,242,282,70,233,303,208,95,36,166,185,1280,SG
2003,25,35,445,67,159,0,0,67,159,26,41,47,82,129,6,16,21,25,79,160,C
2003,24,51,644,89,171,0,0,89,171,27,41,59,119,178,22,19,44,46,87,205,C
2003,27,8,43,5,13,0,0,5,13,8,10,6,2,8,3,0,4,2,7,18,C
2003,27,3,12,0,1,0,0,0,1,0,0,1,0,1,0,0,2,0,6,0,C
2003,27,5,31,5,12,0,0,5,12,8,10,5,2,7,3,0,2,2,1,18,C
2003,24,49,632,82,176,7,32,75,144,11,14,40,88,128,25,8,17,29,35,182,SF
2003,22,79,2510,338,749,3,14,335,735,244,290,228,578,806,106,65,30,111,246,923,PF
2003,23,14,62,11,31,0,5,11,26,5,8,0,4,4,5,4,0,8,0,27,SG
2003,23,12,42,9,26,0,4,9,22,5,8,0,1,1,3,4,0,4,0,23,SG
2003,23,2,20,2,5,0,1,2,4,0,0,0,3,3,2,0,0,4,0,4,SG
2003,31,31,193,23,71,8,38,15,33,7,9,5,18,23,12,5,3,14,22,61,SF
2003,36,24,514,49,131,0,0,49,131,40,55,54,99,153,19,4,37,34,54,138,C
2003,27,22,364,43,96,0,0,43,96,34,47,29,53,82,7,8,32,21,58,120,C
2003,22,14,77,11,31,2,10,9,21,5,10,3,8,11,3,2,2,6,13,29,SF
2003,27,38,405,84,190,0,1,84,189,42,51,32,38,70,26,6,3,32,46,210,SF
2003,26,48,1103,129,231,0,1,129,230,62,91,90,133,223,47,40,22,23,129,320,SF
2003,28,82,2711,518,1114,111,269,407,845,308,339,63,171,234,598,85,6,192,134,1455,PG
2003,26,77,2337,400,762,0,2,400,760,61,95,146,358,504,114,39,116,99,256,861,C
2003,28,73,1931,231,467,32,84,199,383,70,90,86,185,271,99,50,26,69,174,564,SF
2003,29,82,1375,134,330,11,45,123,285,78,114,37,122,159,196,55,4,86,72,357,PG
2003,24,80,3117,690,1489,148,390,542,1099,483,548,81,710,791,239,111,82,152,206,2011,PF
2003,24,77,2864,610,1260,7,21,603,1239,373,510,202,594,796,155,66,178,180,277,1600,PF
2003,30,67,2535,695,1211,0,0,695,1211,451,725,259,483,742,206,38,159,196,229,1841,C
2003,39,42,514,23,55,0,0,23,55,28,34,37,70,107,40,13,6,21,90,74,C
2003,23,49,1679,268,611,42,129,226,482,136,175,59,267,326,178,42,41,140,181,714,SF
2003,23,72,1366,180,423,38,112,142,311,96,131,117,218,335,71,25,39,66,167,494,PF
2003,24,15,93,7,29,1,6,6,23,7,8,8,8,16,23,7,0,10,9,22,PG
2003,30,82,1897,199,441,2,6,197,435,134,178,25,157,182,291,69,5,72,122,534,PG
2003,30,53,1127,117,255,1,5,116,250,68,91,12,87,99,181,37,4,36,71,303,PG
2003,30,29,770,82,186,1,1,81,185,66,87,13,70,83,110,32,1,36,51,231,PG
2003,27,36,1369,186,436,0,0,186,436,69,105,57,271,328,47,18,79,98,110,441,C
2003,29,81,1926,169,326,0,0,169,326,100,196,180,323,503,55,20,147,104,235,438,C
2003,31,80,1800,153,278,0,2,153,276,72,116,134,234,368,112,50,71,76,194,378,C
2003,23,1,6,2,3,0,0,2,3,0,0,1,0,1,0,0,0,1,0,4,SF
2003,21,27,145,10,23,0,0,10,23,7,11,10,40,50,5,5,3,5,30,27,C
2003,33,28,440,52,129,0,5,52,124,41,55,11,40,51,81,25,0,40,35,145,PG
2003,26,82,1321,170,423,45,133,125,290,81,107,83,189,272,86,41,24,70,148,466,PF
2003,24,80,1976,162,388,8,37,154,351,65,87,48,187,235,259,68,16,131,168,397,PG
2003,23,34,342,37,93,7,24,30,69,4,4,9,28,37,39,13,2,23,45,85,PG
2003,21,66,1103,136,338,38,118,98,220,98,118,29,90,119,162,48,12,133,106,408,PG
2003,20,82,2774,484,1043,82,243,402,800,219,290,33,183,216,432,71,4,198,174,1269,PG
2003,30,30,648,82,163,1,2,81,161,23,38,46,86,132,21,16,20,18,52,188,PF
2003,27,78,1655,254,516,3,20,251,496,138,220,120,144,264,101,73,29,117,161,649,SF
2003,34,80,3208,665,1466,54,182,611,1284,250,352,79,255,334,663,133,20,187,181,1634,PG
2003,34,52,2123,444,992,34,114,410,878,162,234,56,192,248,457,93,12,131,117,1084,PG
2003,34,28,1085,221,474,20,68,201,406,88,118,23,63,86,206,40,8,56,64,550,PG
2003,33,82,2245,252,609,87,212,165,397,39,50,40,201,241,244,72,13,82,161,630,SG
2003,31,66,1941,274,601,100,231,174,370,79,97,24,168,192,112,42,19,56,64,727,SG
2003,25,82,2949,421,1073,116,344,305,729,195,247,97,266,363,188,88,32,128,232,1153,SF
2003,32,62,1360,210,446,80,201,130,245,101,122,44,112,156,70,33,9,56,92,601,SG
2003,25,79,3096,663,1592,118,391,545,1201,604,753,106,472,578,349,139,62,288,227,2048,SG
2003,37,64,1911,265,597,38,133,227,464,121,148,57,221,278,285,105,25,164,149,689,SF
2003,27,23,325,40,87,0,0,40,87,23,38,46,60,106,6,13,15,15,50,103,C
2003,26,83,2518,309,752,70,229,239,523,205,246,90,336,426,184,106,15,144,197,893,SF
2003,26,25,872,121,324,24,88,97,236,86,102,38,107,145,78,29,6,66,63,352,SF
2003,26,58,1646,188,428,46,141,142,287,119,144,52,229,281,106,77,9,78,134,541,SF
2003,24,12,98,14,38,2,7,12,31,13,15,1,3,4,3,2,0,7,9,43,SG
2003,27,26,403,41,93,0,0,41,93,22,29,25,64,89,4,9,8,25,46,104,C
2003,22,42,435,53,118,20,47,33,71,11,17,5,40,45,24,10,14,21,25,137,SF
2003,23,32,546,18,46,0,0,18,46,12,24,48,97,145,12,10,45,19,85,48,C
2003,22,72,1910,274,668,104,293,170,375,72,102,76,247,323,97,64,22,100,136,724,PF
2003,24,42,244,22,58,5,12,17,46,29,36,4,13,17,33,4,0,23,25,78,PG
2003,21,77,1301,264,515,0,5,264,510,122,161,139,204,343,41,42,14,62,141,650,PF
2003,29,81,2518,276,595,0,0,276,595,154,214,154,453,607,73,56,262,137,271,706,C
2003,30,30,488,80,145,0,0,80,145,38,48,27,65,92,9,6,17,29,79,198,C
2003,23,82,2316,455,971,182,416,273,555,149,185,98,273,371,117,100,13,74,143,1241,SG
2003,29,1,10,0,3,0,0,0,3,1,2,0,0,0,0,0,0,0,4,1,PF
2003,27,35,144,20,59,4,8,16,51,8,9,10,16,26,7,6,2,4,21,52,C
2003,35,62,1532,196,457,101,254,95,203,63,83,28,126,154,65,23,5,55,99,556,SF
2003,22,82,2698,476,1161,123,334,353,827,207,271,111,267,378,247,90,23,179,201,1282,SG
2003,22,59,1368,203,546,61,198,142,348,85,124,98,183,281,52,35,10,64,92,552,SG
2003,31,11,91,8,35,1,5,7,30,0,0,4,4,8,6,3,0,6,11,17,SG
2003,36,81,2825,372,935,87,259,285,676,161,238,81,237,318,268,87,88,158,259,992,PF
2003,37,64,1676,197,420,0,0,197,420,152,214,163,345,508,61,52,111,83,126,546,C
2003,26,64,1355,155,315,3,14,152,301,51,63,76,124,200,66,62,13,52,120,364,SF
2003,30,69,2591,539,1248,90,263,449,985,268,306,86,371,457,205,91,26,248,183,1436,SF
2003,31,68,1303,183,455,44,132,139,323,68,90,61,202,263,107,50,31,91,192,478,PF
2003,33,70,1344,125,297,0,1,125,296,47,58,53,163,216,69,34,44,66,174,297,C
2003,30,82,3351,642,1583,133,359,509,1224,399,467,68,283,351,395,72,23,285,271,1816,SF
2003,28,79,1933,289,630,2,5,287,625,242,306,148,358,506,124,57,40,170,206,822,PF
2003,22,76,872,96,244,19,68,77,176,16,23,26,68,94,68,10,11,63,71,227,PG
2003,32,70,1388,108,306,46,140,62,166,53,69,43,165,208,72,70,7,55,130,315,SF
2003,38,78,1209,172,361,3,6,169,355,129,164,88,247,335,142,61,49,75,141,476,C
2003,23,64,504,48,116,10,31,38,85,26,35,16,43,59,47,17,6,29,53,132,PG
2003,24,13,77,10,24,0,0,10,24,2,2,10,13,23,4,0,5,2,13,22,C
2003,19,5,8,0,2,0,0,0,2,0,0,1,1,2,1,1,0,0,0,0,PF
2003,25,9,37,0,5,0,0,0,5,0,0,4,2,6,8,5,0,2,3,0,PG
2003,23,75,1025,64,207,13,44,51,163,53,78,64,120,184,65,45,12,39,91,194,SG
2003,21,39,502,55,183,5,28,50,155,17,25,16,27,43,68,20,2,43,36,132,PG
2003,21,22,420,51,165,5,28,46,137,16,23,12,23,35,53,18,2,36,30,123,PG
2003,21,17,82,4,18,0,0,4,18,1,2,4,4,8,15,2,0,7,6,9,PG
2003,26,27,256,29,93,4,26,25,67,21,29,9,16,25,22,14,1,21,33,83,SG
2003,24,59,724,68,169,14,39,54,130,30,36,40,101,141,46,16,18,46,77,180,PF
2003,26,45,448,41,107,0,0,41,107,12,21,34,39,73,23,14,5,25,62,94,SF
2003,36,72,900,101,261,38,109,63,152,10,15,20,99,119,103,32,13,54,62,250,PG
2003,25,2,5,0,4,0,0,0,4,0,0,0,1,1,0,0,0,0,0,0,PF
2003,22,36,378,44,112,0,5,44,107,32,35,33,44,77,20,10,3,8,51,120,SG
2003,26,77,1381,182,331,0,0,182,331,97,161,136,230,366,19,47,53,62,176,461,PF
2003,32,26,141,27,50,0,0,27,50,27,45,18,13,31,4,6,1,9,31,81,PF
2003,22,36,274,39,103,7,25,32,78,7,10,8,23,31,14,14,3,20,31,92,SG
2003,27,3,13,1,4,0,1,1,3,3,4,0,0,0,1,1,0,1,3,5,SG
2003,27,54,1117,151,328,0,2,151,326,102,131,111,159,270,38,14,55,43,171,404,SF
2003,33,53,1032,113,291,39,118,74,173,95,114,21,78,99,70,28,9,43,79,360,SG
2003,29,82,3108,361,799,7,32,354,767,325,379,71,230,301,544,133,11,194,235,1054,PG
2003,32,74,2859,454,1127,134,360,320,767,173,218,45,240,285,332,102,22,172,134,1215,SF
2003,28,70,2747,491,1201,71,245,420,956,455,518,61,197,258,316,65,28,193,130,1508,SG
2003,26,79,1594,185,427,0,0,185,427,71,134,211,343,554,24,45,40,69,169,441,C
2003,21,61,760,114,284,4,12,110,272,47,68,22,63,85,40,22,8,49,57,279,SG
2003,27,47,251,14,37,0,0,14,37,8,12,19,36,55,6,2,15,10,42,36,PF
2003,40,82,2275,309,640,29,80,280,560,237,287,51,150,201,629,137,16,182,184,884,PG
2003,25,72,2450,497,1034,155,406,342,628,231,264,61,336,397,141,72,5,101,143,1380,SF
2003,29,59,1315,156,415,44,114,112,301,53,67,40,115,155,204,39,6,82,67,409,PG
2003,20,82,2570,392,830,2,10,390,820,320,484,250,471,721,78,62,87,189,269,1106,PF
2003,29,71,1275,163,380,62,160,101,220,70,87,23,122,145,209,38,7,98,111,458,SG
2003,32,4,13,2,5,0,0,2,5,0,0,5,2,7,0,0,0,1,1,4,SF
2003,36,47,956,120,278,1,11,119,267,79,107,20,75,95,215,46,6,76,55,320,PG
2003,22,26,138,14,56,4,16,10,40,0,2,8,20,28,7,6,3,9,24,32,C
2003,29,55,1130,135,328,28,85,107,243,103,148,58,109,167,177,45,2,82,108,401,SG
2003,23,67,1478,235,489,0,2,235,487,177,245,114,270,384,45,55,104,99,152,647,PF
2003,25,52,1836,351,729,61,145,290,584,150,173,53,188,241,136,44,22,87,123,913,SF
2003,26,67,1377,231,535,0,2,231,533,100,138,95,143,238,66,22,22,100,151,562,PF
2003,25,81,3081,488,1141,160,431,328,710,259,292,37,242,279,600,126,14,249,175,1395,PG
2003,24,38,513,61,124,0,0,61,124,60,94,70,95,165,3,8,23,33,66,182,PF
2003,25,66,1978,260,559,0,0,260,559,147,197,185,344,529,112,62,28,116,169,667,PF
2003,25,20,586,82,190,0,0,82,190,33,45,45,92,137,39,16,6,40,49,197,PF
2003,25,46,1392,178,369,0,0,178,369,114,152,140,252,392,73,46,22,76,120,470,PF
2003,30,81,2577,497,1028,2,3,495,1025,138,184,160,477,637,162,81,97,138,344,1134,C
2003,25,80,2358,412,930,97,265,315,665,145,186,97,292,389,102,70,49,133,257,1066,SF
2003,24,73,2237,220,556,46,166,174,390,80,112,58,202,260,548,125,18,192,201,566,PG
2003,26,17,109,16,36,7,13,9,23,14,20,3,9,12,3,4,2,8,9,53,SG
2003,25,69,851,105,237,1,3,104,234,57,88,108,154,262,50,45,37,53,153,268,C
2003,28,80,1222,208,389,0,2,208,387,60,101,106,185,291,77,32,23,59,142,476,SF
2003,23,8,97,17,40,4,8,13,32,7,7,8,8,16,6,8,0,8,5,45,SG
2003,23,15,86,5,20,0,0,5,20,4,10,6,8,14,1,0,6,8,13,14,C
2003,23,33,543,61,135,0,0,61,135,39,58,45,77,122,13,6,17,26,80,161,C
2003,19,81,1320,115,393,37,152,78,241,48,65,64,117,181,91,31,29,84,136,315,SF
2003,23,67,1175,165,391,29,78,136,313,88,110,35,153,188,87,25,12,50,125,447,SF
2003,31,73,2026,342,831,118,312,224,519,110,144,35,173,208,312,42,4,123,86,912,SG
2003,27,74,2337,459,952,65,176,394,776,193,240,159,365,524,93,63,30,150,251,1176,PF
2003,27,80,1686,184,411,8,34,176,377,97,125,26,92,118,232,64,2,97,169,473,PG
2003,25,65,947,92,163,0,0,92,163,64,96,97,128,225,36,18,29,48,172,248,C
2003,19,47,1385,223,605,55,174,168,431,128,160,20,62,82,130,38,7,85,107,629,SG
2003,26,78,3235,603,1554,188,582,415,972,176,286,99,464,563,373,116,31,260,221,1570,PF
2003,26,67,1243,115,274,0,1,115,273,66,101,115,253,368,64,20,55,56,143,296,C
2003,28,73,2873,210,437,1,6,209,431,85,189,293,833,1126,120,104,230,88,179,506,C
2003,20,47,571,90,183,1,4,89,179,39,74,38,90,128,23,24,15,44,68,220,SF
2003,28,74,2684,515,1094,110,307,405,787,200,272,113,435,548,153,70,77,140,223,1340,PF
2003,32,66,1465,165,414,101,267,64,147,41,53,25,152,177,306,78,11,95,146,472,PG
2003,23,79,1366,170,391,31,91,139,300,62,86,46,118,164,225,89,14,88,138,433,PG
2003,32,79,2024,186,414,0,0,186,414,149,194,214,385,599,68,69,36,63,174,521,PF
2003,29,67,2622,661,1433,5,21,656,1412,215,354,160,544,704,364,106,88,215,204,1542,PF
2003,26,75,2396,437,990,38,130,399,860,226,313,98,296,394,246,123,18,215,220,1138,SG
2003,23,37,234,19,75,1,4,18,71,22,29,12,16,28,27,8,2,19,32,61,SF
2003,32,73,2710,449,1037,134,316,315,721,185,237,38,137,175,251,109,9,132,173,1217,SG
2003,26,16,230,25,53,0,0,25,53,17,25,37,36,73,2,1,12,9,33,67,C
2003,22,72,1563,260,638,32,134,228,504,98,125,43,170,213,121,45,32,156,134,650,SG
2003,31,51,1052,124,349,50,164,74,185,57,69,3,64,67,145,29,2,71,92,355,PG
2003,31,29,762,94,261,43,128,51,133,46,57,1,45,46,124,17,1,55,77,277,PG
2003,31,22,290,30,88,7,36,23,52,11,12,2,19,21,21,12,1,16,15,78,PG
2003,20,46,479,73,140,0,0,73,140,25,50,32,72,104,21,7,12,26,65,171,PF
2003,23,15,364,29,81,6,17,23,64,21,29,9,32,41,42,16,1,16,38,85,SG
2003,23,31,324,21,67,4,18,17,49,16,18,11,19,30,50,11,3,12,31,62,PG
2003,31,81,1597,199,439,0,1,199,438,102,130,137,194,331,88,27,57,85,206,500,C
2003,28,78,2638,396,905,48,146,348,759,187,239,55,190,245,416,111,21,128,170,1027,PG
2003,27,6,19,1,7,0,1,1,6,0,0,2,0,2,0,2,0,3,4,2,SF
2003,30,82,2350,254,575,37,110,217,465,201,268,143,239,382,140,86,19,97,234,746,SF
2003,22,21,167,9,33,6,16,3,17,4,6,3,15,18,34,7,2,17,20,28,PG
2003,27,76,2407,333,859,143,404,190,455,110,131,25,187,212,631,91,10,168,130,919,PG
2003,21,75,1961,273,685,65,202,208,483,103,161,27,168,195,350,86,17,171,179,714,PG
2003,29,71,2346,267,535,1,6,266,529,156,281,231,419,650,95,116,26,98,197,691,PF
2003,31,21,276,34,80,0,2,34,78,24,32,12,33,45,26,12,5,17,33,92,SF
2003,34,69,872,120,292,0,2,120,290,33,42,72,121,193,22,27,21,32,159,273,C
2003,27,78,1881,228,579,93,261,135,318,78,102,24,147,171,266,77,6,114,140,627,PG
2003,27,51,1169,134,338,56,159,78,179,48,57,12,98,110,128,61,3,61,84,372,PG
2003,27,27,712,94,241,37,102,57,139,30,45,12,49,61,138,16,3,53,56,255,PG
2003,32,66,1161,134,341,64,171,70,170,31,50,53,154,207,59,42,26,35,141,363,SF
2003,29,82,2061,374,826,2,11,372,815,237,300,147,211,358,104,44,27,126,238,987,SF
2003,40,71,840,123,257,0,2,123,255,51,83,83,143,226,24,20,20,60,120,297,C
2003,29,7,24,2,4,0,1,2,3,1,4,0,1,1,1,0,0,1,3,5,PF
2003,24,38,353,29,76,1,3,28,73,21,27,27,68,95,19,10,13,23,37,80,C
2003,21,53,334,59,118,3,9,56,109,7,20,15,38,53,12,15,1,23,36,128,PF
2003,23,69,2317,362,846,71,211,291,635,273,371,101,261,362,198,159,50,145,242,1068,SF
2003,27,70,1982,325,716,0,5,325,711,147,223,170,358,528,80,51,54,110,209,797,C
2003,21,59,1381,168,428,21,78,147,350,49,62,36,126,162,130,57,33,81,145,406,SG
2003,25,41,412,62,162,16,47,46,115,42,58,26,51,77,10,8,10,31,41,182,C
2004,27,85,2684,501,1054,9,34,492,1020,373,429,189,450,639,174,68,37,184,222,1384,PF
2004,27,53,1956,383,790,5,23,378,767,294,334,141,354,495,127,44,19,131,147,1065,PF
2004,27,32,728,118,264,4,11,114,253,79,95,48,96,144,47,24,18,53,75,319,PF
2004,25,45,616,83,198,0,0,83,198,25,33,42,77,119,16,12,28,27,81,191,PF
2004,28,56,2152,447,1017,148,378,299,639,245,271,69,217,286,268,71,11,156,132,1287,SG
2004,27,82,2581,287,764,161,434,126,330,103,134,26,200,226,372,114,18,128,212,838,PG
2004,25,71,1029,90,203,0,1,90,202,63,107,89,209,298,35,34,114,48,119,243,PF
2004,29,51,1810,230,612,79,259,151,353,155,188,26,156,182,228,66,3,90,79,694,SG
2004,33,44,905,113,256,1,4,112,252,35,48,19,62,81,125,26,5,50,73,262,PG
2004,30,80,1974,238,564,36,128,202,436,123,161,53,169,222,122,68,17,118,182,635,SG
2004,19,82,2995,624,1465,69,214,555,1251,408,525,183,315,498,227,97,41,247,225,1725,SF
2004,23,1,6,0,1,0,0,0,1,1,2,0,1,1,1,0,0,1,1,1,PF
2004,23,1,4,1,2,0,0,1,2,0,2,0,1,1,0,1,0,0,0,2,PF
2004,23,30,246,8,30,0,0,8,30,13,27,21,29,50,12,13,3,9,49,29,C
2004,22,55,2066,358,914,125,333,233,581,237,317,55,199,254,275,103,12,226,176,1078,PG
2004,23,56,434,65,175,19,52,46,123,2,4,12,31,43,14,12,2,24,49,151,SG
2004,35,79,2247,291,736,135,429,156,307,123,144,63,163,226,311,133,16,155,148,840,PG
2004,24,71,2008,339,768,38,117,301,651,181,225,41,144,185,355,63,5,156,165,897,PG
2004,29,64,1544,192,484,81,241,111,243,73,97,9,84,93,223,45,2,92,102,538,PG
2004,29,40,751,88,235,42,130,46,105,31,43,6,42,48,95,19,1,48,60,249,PG
2004,29,24,793,104,249,39,111,65,138,42,54,3,42,45,128,26,1,44,42,289,PG
2004,35,69,1416,143,347,1,7,142,340,110,139,52,122,174,85,55,15,76,114,397,SF
2004,32,54,1313,208,432,1,3,207,429,114,157,112,168,280,66,29,32,77,160,531,PF
2004,32,37,1000,168,333,0,1,168,332,82,112,76,134,210,54,22,23,52,98,418,PF
2004,32,17,313,40,99,1,2,39,97,32,45,36,34,70,12,7,9,25,62,113,PF
2004,22,81,1385,177,442,27,86,150,356,99,131,30,103,133,175,88,13,125,171,480,PG
2004,21,70,1500,210,470,83,210,127,260,47,61,23,100,123,165,93,7,120,184,550,PG
2004,23,38,724,63,138,2,13,61,125,43,61,53,98,151,48,27,3,44,76,171,SF
2004,36,1,11,2,3,0,0,2,3,2,2,0,0,0,0,0,0,0,2,6,SG
2004,32,59,1803,215,427,114,252,101,175,91,110,21,183,204,342,85,16,139,121,635,SG
2004,34,57,1101,120,297,51,138,69,159,60,71,25,98,123,147,57,8,53,66,351,SG
2004,28,7,40,4,7,0,0,4,7,0,0,5,3,8,1,1,0,2,10,8,C
2004,27,73,1478,170,384,2,9,168,375,66,89,118,241,359,58,26,67,63,159,408,C
2004,27,23,501,56,117,1,1,55,116,23,33,39,79,118,21,8,20,24,55,136,C
2004,27,50,977,114,267,1,8,113,259,43,56,79,162,241,37,18,47,39,104,272,C
2004,25,79,1947,242,543,65,186,177,357,120,164,102,201,303,101,101,58,56,187,669,SF
2004,25,14,147,27,49,1,1,26,48,5,8,11,24,35,5,1,6,11,31,60,PF
2004,25,36,487,60,128,0,1,60,127,30,56,42,79,121,10,14,18,22,69,150,C
2004,25,12,132,16,32,0,1,16,31,9,12,11,20,31,5,2,5,5,23,41,PF
2004,23,2,5,1,3,0,0,1,3,0,0,0,1,1,0,0,0,0,0,2,PF
2004,27,82,2020,329,805,62,166,267,639,195,248,60,181,241,107,63,13,111,262,915,SG
2004,23,6,34,4,18,0,4,4,14,3,3,3,1,4,4,1,0,6,6,11,PG
2004,23,21,271,50,106,9,22,41,84,39,47,9,31,40,9,5,11,33,23,148,SF
2004,31,61,762,64,172,3,20,61,152,40,46,17,51,68,112,31,4,33,66,171,PG
2004,25,82,2980,527,1170,148,378,379,792,304,373,67,210,277,444,112,18,175,146,1506,PG
2004,27,78,2758,392,996,130,335,262,661,404,460,35,241,276,446,84,8,189,177,1318,PG
2004,23,75,1392,157,407,75,202,82,205,55,67,18,99,117,209,57,7,128,100,444,PG
2004,35,46,756,97,206,0,3,97,203,13,24,76,130,206,45,38,19,35,86,207,PF
2004,35,16,294,18,47,0,0,18,47,2,3,22,47,69,10,11,5,8,49,38,C
2004,28,82,2402,342,604,0,0,342,604,159,221,207,382,589,75,80,106,150,253,843,C
2004,23,73,1787,183,454,67,187,116,267,65,103,106,211,317,98,46,10,75,128,498,SF
2004,27,71,1206,135,290,0,2,135,288,75,94,86,194,280,28,17,101,45,150,345,C
2004,22,75,2592,471,900,1,6,470,894,219,285,230,627,857,148,74,55,134,199,1162,PF
2004,23,16,258,22,56,0,1,22,55,14,18,13,41,54,15,4,14,18,40,58,C
2004,19,75,2510,327,712,5,14,322,698,202,288,191,366,557,78,59,106,107,215,861,C
2004,25,9,26,1,5,0,0,1,5,2,2,0,1,1,1,0,1,0,2,4,C
2004,32,82,2624,211,502,77,212,134,290,66,114,45,208,253,113,84,33,90,166,565,SF
2004,28,52,392,18,53,0,0,18,53,10,12,39,48,87,18,18,16,6,47,46,PF
2004,27,82,1849,321,766,55,171,266,595,142,162,42,101,143,295,51,3,100,84,839,SG
2004,24,5,38,1,3,0,0,1,3,1,2,1,10,11,1,1,0,3,6,3,PF
2004,24,11,60,6,12,0,0,6,12,0,0,5,7,12,0,2,0,4,8,12,C
2004,31,66,773,89,188,0,1,89,187,41,49,72,101,173,20,33,74,17,130,219,C
2004,27,15,154,16,33,0,0,16,33,8,12,18,21,39,7,4,2,13,29,40,PF
2004,27,11,132,13,28,0,0,13,28,8,12,15,19,34,6,4,2,12,21,34,PF
2004,27,4,22,3,5,0,0,3,5,0,0,3,2,5,1,0,0,1,8,6,PF
2004,24,69,2670,484,982,0,1,484,981,411,532,269,445,714,227,64,154,193,229,1379,PF
2004,23,36,443,43,158,19,74,24,84,13,20,9,27,36,51,18,4,24,32,118,PG
2004,23,31,403,39,137,19,66,20,71,13,20,7,26,33,39,18,4,19,27,110,PG
2004,23,5,40,4,21,0,8,4,13,0,0,2,1,3,12,0,0,5,5,8,PG
2004,23,13,160,13,35,5,14,8,21,1,6,2,9,11,17,7,0,10,9,32,PG
2004,24,18,72,12,26,0,0,12,26,4,6,5,10,15,3,0,3,6,13,28,C
2004,24,3,17,1,10,0,0,1,10,1,2,3,2,5,0,2,0,1,2,3,PF
2004,25,58,627,85,196,4,14,81,182,60,74,38,92,130,33,15,4,38,61,234,SG
2004,22,55,969,117,254,38,99,79,155,17,27,41,105,146,64,30,7,29,80,289,SF
2004,22,21,408,45,99,12,32,33,67,8,13,18,50,68,25,17,2,12,38,110,SF
2004,22,34,561,72,155,26,67,46,88,9,14,23,55,78,39,13,5,17,42,179,SF
2004,21,74,2239,288,589,1,2,287,587,228,334,178,372,550,112,66,52,140,144,805,PF
2004,34,80,2753,339,712,0,1,339,711,158,185,237,453,690,155,78,73,101,203,836,PF
2004,24,3,17,2,4,0,0,2,4,2,4,0,1,1,2,0,0,7,1,6,PG
2004,31,40,412,40,105,11,23,29,82,27,31,9,28,37,82,25,3,33,44,118,PG
2004,31,3,10,2,4,0,0,2,4,0,0,0,0,0,2,0,0,0,0,4,PG
2004,31,37,402,38,101,11,23,27,78,27,31,9,28,37,80,25,3,33,44,114,PG
2004,25,65,2447,516,1178,71,217,445,961,454,533,103,256,359,330,112,28,171,176,1557,SG
2004,27,53,703,66,175,12,44,54,131,20,27,28,75,103,45,21,4,34,77,164,SG
2004,26,22,141,19,56,0,2,19,54,3,6,6,9,15,7,6,1,4,9,41,SF
2004,23,68,2030,240,631,10,42,230,589,133,176,92,234,326,126,75,13,91,162,623,SF
2004,33,41,552,54,124,11,30,43,94,15,24,24,47,71,32,22,4,24,54,134,SG
2004,24,45,675,119,250,50,108,69,142,16,21,4,57,61,23,10,13,28,72,304,SF
2004,22,49,570,81,197,6,32,75,165,35,53,26,73,99,40,10,13,54,75,203,PF
2004,29,72,2162,262,549,0,2,262,547,98,136,211,516,727,132,86,187,98,239,622,C
2004,35,65,892,138,314,0,0,138,314,85,124,52,157,209,45,21,50,63,137,361,C
2004,26,76,1634,220,466,55,124,165,342,238,271,100,217,317,103,66,20,84,206,733,PF
2004,23,16,70,7,16,1,3,6,13,4,6,1,5,6,2,1,0,6,8,19,SG
2004,23,13,48,5,11,1,3,4,8,2,2,0,3,3,1,0,0,2,3,13,SG
2004,23,3,22,2,5,0,0,2,5,2,4,1,2,3,1,1,0,4,5,6,SG
2004,28,5,87,11,37,0,3,11,34,0,0,2,9,11,12,4,0,12,9,22,PG
2004,27,10,110,11,35,4,11,7,24,16,20,2,9,11,4,0,0,9,10,42,SG
2004,27,4,50,5,14,1,3,4,11,11,12,0,3,3,2,0,0,6,5,22,SG
2004,27,6,60,6,21,3,8,3,13,5,8,2,6,8,2,0,0,3,5,20,SG
2004,27,73,2785,608,1457,93,243,515,1214,336,417,95,254,349,348,88,65,223,212,1645,SG
2004,34,81,2838,620,1270,74,186,546,1084,289,331,44,227,271,592,102,18,220,247,1603,PG
2004,29,69,1743,161,360,0,0,161,360,96,142,153,319,472,72,52,96,84,203,418,PF
2004,21,35,782,67,158,0,1,67,157,79,118,82,188,270,23,17,43,38,87,213,PF
2004,32,79,2067,278,578,0,10,278,568,47,77,77,183,260,136,60,12,85,184,603,SF
2004,33,82,2780,317,688,49,142,268,546,148,172,69,260,329,347,151,41,155,186,831,SG
2004,28,2,27,2,6,0,0,2,6,0,0,1,6,7,1,1,0,0,1,4,PF
2004,25,60,1595,224,524,4,22,220,502,182,224,38,118,156,267,97,9,102,146,634,PG
2004,26,4,92,7,23,0,1,7,22,1,2,1,6,7,19,4,2,5,13,15,PG
2004,36,34,843,107,259,8,36,99,223,49,65,45,147,192,46,23,26,57,79,271,C
2004,35,22,170,12,34,0,0,12,34,4,6,2,8,10,15,3,0,9,27,28,PG
2004,26,20,545,79,165,1,4,78,161,67,85,36,75,111,17,11,11,31,71,226,C
2004,25,81,1732,147,295,0,1,147,294,188,262,117,199,316,77,26,18,79,255,482,C
2004,25,78,2220,163,384,0,2,163,382,136,184,143,257,400,153,67,56,97,251,462,C
2004,23,35,442,67,141,0,5,67,136,21,28,31,70,101,20,16,16,17,64,155,C
2004,22,17,139,7,27,0,1,7,26,0,0,3,3,6,24,10,0,10,14,14,PG
2004,28,56,1207,211,471,44,113,167,358,103,119,58,117,175,45,37,20,55,131,569,PF
2004,23,80,2811,509,1318,165,521,344,797,200,240,46,237,283,405,111,29,193,161,1383,SG
2004,28,77,1051,119,307,56,144,63,163,93,104,60,183,243,52,24,14,55,101,387,PF
2004,21,73,2154,417,840,1,1,416,839,235,350,143,308,451,68,24,83,177,258,1070,PF
2004,35,70,1229,76,196,3,15,73,181,49,58,22,65,87,53,23,5,48,153,204,SF
2004,22,82,2197,270,499,0,1,270,498,112,174,194,432,626,21,44,189,86,273,652,C
2004,28,74,2403,348,650,0,2,348,648,217,332,344,543,887,60,33,137,131,227,913,C
2004,28,71,1512,187,398,42,116,145,282,155,184,23,119,142,298,45,6,61,64,571,PG
2004,23,56,1039,203,411,11,36,192,375,60,78,66,80,146,116,53,12,44,51,477,SG
2004,35,80,2570,266,660,0,0,266,660,176,230,207,464,671,137,37,65,114,206,708,C
2004,35,15,538,46,120,0,0,46,120,37,49,49,94,143,14,8,8,21,45,129,C
2004,35,65,2032,220,540,0,0,220,540,139,181,158,370,528,123,29,57,93,161,579,C
2004,24,67,2686,554,1402,187,582,367,820,237,352,66,221,287,501,158,27,215,178,1532,PG
2004,34,76,1682,133,281,0,0,133,281,65,106,158,240,398,72,43,62,40,154,331,C
2004,33,17,78,1,11,0,1,1,10,2,2,2,6,8,4,2,0,3,12,4,SG
2004,33,3,23,0,2,0,1,0,1,0,0,0,0,0,1,0,0,1,4,0,SG
2004,33,14,55,1,9,0,0,1,9,2,2,2,6,8,3,2,0,2,8,4,SG
2004,23,4,23,2,5,0,2,2,3,1,1,1,4,5,0,0,0,2,3,5,PF
2004,24,22,796,134,311,17,48,117,263,51,75,18,103,121,111,25,8,68,51,336,SG
2004,24,57,1678,312,639,35,92,277,547,145,198,59,178,237,148,71,14,121,120,804,SF
2004,30,71,1211,93,195,0,0,93,195,44,54,131,186,317,44,47,32,54,217,230,C
2004,30,33,509,70,184,20,66,50,118,37,44,16,43,59,28,27,7,17,46,197,SG
2004,28,9,86,9,28,2,9,7,19,6,8,5,8,13,2,6,0,1,6,26,SG
2004,21,76,1919,140,313,6,26,134,287,56,93,111,231,342,182,59,37,126,191,342,SG
2004,25,43,294,37,98,10,30,27,68,11,14,7,19,26,38,17,0,26,44,95,PG
2004,25,23,143,21,49,3,10,18,39,4,6,4,12,16,18,9,0,13,22,49,PG
2004,25,20,151,16,49,7,20,9,29,7,8,3,7,10,20,8,0,13,22,46,PG
2004,25,3,12,3,3,0,0,3,3,1,2,2,0,2,0,0,0,1,3,7,PF
2004,22,56,730,57,147,0,0,57,147,12,20,72,127,199,34,26,51,29,116,126,C
2004,35,81,2317,314,668,2,13,312,655,170,260,136,327,463,432,57,77,173,222,800,C
2004,25,71,1478,247,637,59,198,188,439,111,139,30,118,148,137,82,4,104,111,664,SG
2004,26,72,1029,140,322,0,0,140,322,45,52,88,177,265,44,23,36,48,142,325,C
2004,26,46,685,100,225,0,0,100,225,31,36,60,129,189,30,17,30,37,84,231,C
2004,26,26,344,40,97,0,0,40,97,14,16,28,48,76,14,6,6,11,58,94,C
2004,23,58,1137,137,352,8,46,129,306,78,94,17,62,79,130,45,6,65,108,360,PG
2004,29,15,78,4,18,1,7,3,11,3,3,0,6,6,13,4,0,8,1,12,PG
2004,28,61,949,149,379,11,36,138,343,73,86,54,142,196,39,22,24,48,85,382,C
2004,27,69,2527,592,1181,2,12,590,1169,352,588,227,632,859,213,62,185,183,164,1538,PF
2004,23,75,2336,323,720,94,254,229,466,137,185,87,355,442,220,68,13,143,169,877,SF
2004,23,47,893,111,282,4,9,107,273,66,105,55,112,167,55,32,18,51,134,292,SF
2004,19,17,32,6,14,0,0,6,14,1,4,2,1,3,3,0,4,3,6,13,SF
2004,31,67,1457,166,451,52,163,114,288,76,89,20,109,129,273,56,5,98,137,460,PG
2004,31,33,730,80,202,28,85,52,117,32,36,7,59,66,156,30,3,50,85,220,PG
2004,31,34,727,86,249,24,78,62,171,44,53,13,50,63,117,26,2,48,52,240,PG
2004,27,62,875,94,199,0,1,94,198,30,45,65,138,203,32,35,39,35,145,218,C
2004,25,42,510,66,153,0,1,66,152,25,42,48,53,101,22,9,17,20,68,157,PF
2004,23,75,1280,67,165,0,3,67,162,83,148,156,252,408,33,54,10,65,176,217,PF
2004,26,7,32,5,12,3,8,2,4,0,2,0,4,4,1,0,0,1,0,13,SF
2004,30,72,2778,514,1159,150,370,364,789,164,193,78,247,325,212,84,39,83,118,1342,SG
2004,29,82,1769,203,576,52,179,151,397,122,153,30,122,152,187,103,4,79,115,580,SG
2004,25,46,738,134,350,2,17,132,333,90,120,61,141,202,43,16,8,51,97,360,SF
2004,22,9,41,6,11,0,0,6,11,3,6,3,8,11,3,0,1,3,9,15,PF
2004,20,55,1472,153,398,5,21,148,377,80,98,37,140,177,356,60,3,139,123,391,PG
2004,27,56,625,71,139,0,0,71,139,75,92,114,136,250,9,12,11,37,148,217,C
2004,27,82,1961,197,362,0,4,197,358,103,154,248,362,610,64,71,27,60,189,497,C
2004,27,36,261,15,48,1,8,14,40,13,18,18,35,53,14,9,3,12,37,44,SF
2004,34,38,846,73,186,15,61,58,125,22,30,29,73,102,98,29,4,48,99,183,SF
2004,28,44,572,59,130,0,0,59,130,19,35,54,113,167,17,6,46,21,68,137,C
2004,26,54,469,63,139,34,92,29,47,23,26,12,44,56,24,16,4,7,50,183,SF
2004,26,79,3194,450,1117,73,250,377,867,337,435,116,317,433,493,139,35,294,257,1310,PG
2004,22,4,43,3,8,0,0,3,8,2,6,4,7,11,2,0,1,4,5,8,PF
2004,25,75,1260,183,349,0,1,183,348,58,118,126,220,346,28,51,105,45,186,424,C
2004,23,38,364,25,86,3,10,22,76,16,25,8,31,39,40,11,2,18,22,69,PG
2004,23,2,13,1,7,0,0,1,7,1,2,0,0,0,0,2,0,1,0,3,SG
2004,27,82,3231,804,1611,11,43,793,1568,368,465,245,894,1139,409,120,178,212,202,1987,PF
2004,27,2,22,1,3,0,0,1,3,0,0,0,0,0,1,0,0,0,2,2,PF
2004,23,78,2458,506,1049,4,15,502,1034,365,511,206,394,600,198,44,132,187,185,1381,PF
2004,26,82,1951,233,571,65,186,168,385,73,96,87,245,332,112,81,38,88,189,604,SF
2004,25,22,157,15,36,3,8,12,28,17,20,4,13,17,16,9,1,12,16,50,PG
2004,35,56,1411,215,548,9,38,206,510,100,136,61,129,190,89,65,16,83,107,539,SG
2004,26,77,2260,330,789,88,245,242,544,239,298,86,258,344,291,136,16,161,181,987,SG
2004,26,48,1435,188,427,46,113,142,314,67,81,37,127,164,80,41,10,63,98,489,SF
2004,26,25,606,128,297,14,39,114,258,68,77,14,48,62,42,15,5,40,46,338,SG
2004,25,69,1643,230,589,40,119,190,470,120,156,58,208,266,130,50,19,102,123,620,SG
2004,25,55,1465,205,524,36,105,169,419,110,142,54,183,237,115,40,17,83,106,556,SG
2004,25,14,178,25,65,4,14,21,51,10,14,4,25,29,15,10,2,19,17,64,SG
2004,32,11,85,7,22,2,8,5,14,1,1,1,6,7,11,5,0,3,5,17,PG
2004,32,5,66,5,14,2,6,3,8,1,1,1,5,6,10,3,0,2,5,13,PG
2004,32,6,19,2,8,0,2,2,6,0,0,0,1,1,1,2,0,1,0,4,PG
2004,22,79,2134,369,829,9,42,360,787,167,262,160,356,516,89,62,72,126,196,914,PF
2004,31,76,2303,289,613,0,1,289,612,86,110,174,350,524,69,51,35,82,254,664,C
2004,38,55,1106,92,224,0,1,92,223,39,54,79,154,233,71,24,21,29,70,223,PF
2004,30,10,98,11,23,0,0,11,23,3,8,7,10,17,3,1,1,7,17,25,C
2004,22,53,767,143,357,19,61,124,296,59,81,16,49,65,53,26,5,59,83,364,SG
2004,29,19,133,5,18,1,2,4,16,0,4,1,18,19,10,7,2,3,17,11,SG
2004,34,55,819,70,203,1,4,69,199,20,28,65,122,187,63,31,12,39,81,161,PF
2004,34,30,304,31,99,0,1,31,98,6,8,15,41,56,21,14,4,20,34,68,PF
2004,34,25,515,39,104,1,3,38,101,14,20,50,81,131,42,17,8,19,47,93,PF
2004,23,31,263,36,74,1,2,35,72,20,28,21,32,53,4,6,12,9,25,93,PF
2004,30,54,484,37,75,1,2,36,73,21,35,47,46,93,16,13,8,31,63,96,SF
2004,25,78,2772,530,1166,18,68,512,1098,297,342,78,201,279,310,103,17,210,222,1375,SG
2004,28,46,473,51,95,0,0,51,95,67,96,49,97,146,13,8,8,27,74,169,C
2004,30,17,172,25,47,0,0,25,47,18,27,22,33,55,6,3,4,10,32,68,C
2004,25,41,507,46,130,9,30,37,100,22,27,30,40,70,19,10,9,15,67,123,SF
2004,32,76,2095,279,679,30,79,249,600,111,138,69,218,287,176,70,20,107,146,699,SG
2004,32,34,876,120,271,14,35,106,236,42,49,27,71,98,97,28,8,42,65,296,SG
2004,32,42,1219,159,408,16,44,143,364,69,89,42,147,189,79,42,12,65,81,403,SG
2004,27,31,1134,193,410,8,33,185,377,108,157,91,156,247,63,22,2,65,102,502,SF
2004,23,79,2441,421,909,21,77,400,832,185,252,163,345,508,131,80,22,163,250,1048,PF
2004,30,56,872,100,202,0,0,100,202,58,78,58,119,177,29,12,14,65,134,258,PF
2004,33,69,1504,187,463,38,101,149,362,66,78,39,101,140,135,41,2,53,74,478,PG
2004,25,53,660,71,159,2,9,69,150,33,43,10,69,79,81,28,5,29,59,177,PG
2004,23,60,783,89,201,0,3,89,198,61,83,48,116,164,21,24,27,45,129,239,PF
2004,23,24,345,36,89,0,3,36,86,26,39,29,43,72,8,10,11,22,44,98,PF
2004,23,36,438,53,112,0,0,53,112,35,44,19,73,92,13,14,16,23,85,141,PF
2004,23,75,1795,205,447,0,3,205,444,140,183,189,284,473,51,33,24,74,197,550,PF
2004,24,81,2264,177,381,4,13,173,368,48,61,68,189,257,133,36,54,46,200,406,SG
2004,22,70,2044,278,695,40,131,238,564,77,98,71,193,264,106,71,11,110,157,673,SF
2004,24,77,1484,200,388,0,1,200,387,137,234,186,201,387,43,32,100,80,154,537,C
2004,33,6,72,7,24,4,18,3,6,4,5,1,3,4,5,1,0,5,2,22,PG
2004,31,6,68,10,21,0,0,10,21,4,6,11,10,21,2,1,2,3,1,24,PF
2004,21,77,2504,334,630,0,2,334,628,240,352,154,349,503,168,116,41,183,280,908,PF
2004,35,5,38,3,5,0,0,3,5,3,4,5,3,8,0,0,1,2,10,9,PF
2004,23,76,2706,318,823,144,369,174,454,135,168,42,217,259,517,101,21,204,276,915,PG
2004,31,79,1804,178,383,76,172,102,211,98,116,21,247,268,109,66,10,44,136,530,SG
2004,33,81,1290,141,348,41,108,100,240,69,107,108,164,272,101,48,49,55,165,392,PF
2004,25,60,1188,161,449,51,136,110,313,36,45,28,110,138,148,65,4,63,92,409,SG
2004,32,50,1799,340,781,87,202,253,579,157,172,20,101,121,99,38,2,102,105,924,SG
2004,23,67,1589,229,532,20,66,209,466,97,138,149,219,368,97,69,54,67,168,575,SF
2004,30,81,2877,529,1169,0,1,529,1168,318,393,171,399,570,158,54,22,178,284,1376,PF
2004,27,29,503,80,207,31,77,49,130,27,33,4,31,35,70,7,0,34,32,218,PG
2004,25,61,2061,401,1009,79,232,322,777,267,335,96,230,326,148,95,26,152,147,1148,SG
2004,24,2,11,1,4,0,1,1,3,0,0,2,1,3,1,1,0,2,3,2,PF
2004,23,36,406,53,116,0,3,53,113,19,43,50,68,118,19,13,1,22,40,125,PF
2004,33,33,661,49,143,14,50,35,93,5,8,13,54,67,85,39,6,34,45,117,SG
2004,22,59,789,82,155,0,0,82,155,23,69,54,116,170,12,5,73,29,101,187,C
2004,28,81,2539,466,965,2,7,464,958,303,406,279,374,653,109,39,201,163,277,1237,C
2004,28,48,2040,435,1125,57,199,378,926,339,455,34,144,178,324,115,5,209,87,1266,SG
2004,30,50,1185,263,592,81,219,182,373,82,109,55,119,174,105,49,8,63,106,689,SG
2004,33,80,3119,382,900,162,405,220,495,107,127,52,435,487,226,86,23,175,227,1033,SF
2004,29,22,598,71,171,0,1,71,170,64,81,45,81,126,18,12,6,24,45,206,PF
2004,38,42,577,34,100,7,41,27,59,28,39,10,60,70,119,17,1,53,41,103,PG
2004,25,80,2940,536,1261,145,427,391,834,233,297,97,273,370,244,142,20,223,216,1450,SF
2004,22,78,1828,150,360,75,180,75,180,91,111,42,159,201,98,48,9,68,144,466,SF
2004,28,65,990,129,259,0,0,129,259,66,100,78,152,230,32,20,60,82,180,324,C
2004,19,79,3122,622,1492,63,217,559,1275,347,460,99,333,432,465,130,58,273,149,1654,SG
2004,28,81,2196,272,657,106,281,166,376,103,127,28,206,234,339,96,3,124,156,753,PG
2004,28,55,1684,213,510,86,226,127,284,76,95,20,156,176,244,70,2,83,113,588,PG
2004,28,26,512,59,147,20,55,39,92,27,32,8,50,58,95,26,1,41,43,165,PG
2004,27,82,2376,488,913,16,40,472,873,220,294,233,287,520,70,83,30,81,174,1212,SF
2004,25,58,1760,185,477,51,150,134,327,74,101,44,131,175,281,93,20,115,132,495,PG
2004,23,2,8,3,6,1,3,2,3,1,1,0,1,1,1,0,0,1,0,8,SG
2004,23,19,187,24,66,16,39,8,27,12,19,5,23,28,6,4,7,18,36,76,SF
2004,23,82,3133,555,1115,48,132,507,983,357,468,109,355,464,315,92,28,198,224,1515,SF
2004,22,82,1913,177,469,5,30,172,439,105,171,180,244,424,93,48,28,107,212,464,PF
2004,24,20,290,17,59,1,12,16,47,7,16,15,30,45,12,7,1,14,28,42,C
2004,29,73,1598,167,411,41,122,126,289,75,94,28,102,130,202,64,8,75,138,450,PG
2004,38,46,637,80,199,0,3,80,196,52,78,3,30,33,111,26,3,51,34,212,PG
2004,23,21,287,36,97,13,36,23,61,28,31,5,34,39,11,8,7,16,32,113,SF
2004,36,66,965,55,103,0,1,55,102,17,28,61,171,232,24,27,43,30,156,127,C
2004,22,82,3331,555,1291,83,272,472,1019,174,232,80,305,385,362,93,26,199,177,1367,SG
2004,23,41,734,72,203,7,33,65,170,22,37,59,124,183,27,37,32,37,90,173,SF
2004,23,20,154,15,53,1,4,14,49,5,11,7,16,23,12,5,6,12,23,36,SG
2004,27,82,2016,210,524,98,273,112,251,55,72,15,155,170,478,30,4,103,92,573,PG
2004,32,81,2998,473,1156,177,479,296,677,278,333,38,270,308,258,92,34,129,226,1401,SG
2004,24,81,1508,123,311,27,89,96,222,124,149,25,101,126,173,65,18,73,132,397,SG
2004,23,6,26,2,9,1,4,1,5,2,2,0,2,2,0,1,0,0,1,7,SF
2004,24,42,373,33,96,13,44,20,52,14,23,24,44,68,14,12,9,19,48,93,SG
2004,33,5,10,0,2,0,0,0,2,0,0,1,0,1,0,0,0,0,2,0,PF
2004,21,82,1843,200,435,0,2,200,433,99,142,126,335,461,85,23,73,155,211,499,C
2004,22,41,427,52,129,21,44,31,85,20,24,19,36,55,14,13,2,21,41,145,SF
2004,30,67,2450,368,959,94,293,274,666,206,249,85,343,428,618,122,14,214,110,1036,PG
2004,22,78,2895,412,931,68,201,344,730,392,496,226,403,629,244,150,215,215,174,1284,PF
2004,29,82,2842,434,959,97,276,337,683,107,136,56,271,327,206,125,40,95,144,1072,SG
2004,28,56,1037,105,246,2,8,103,238,49,65,14,98,112,204,84,1,72,107,261,PG
2004,28,3,19,1,3,0,0,1,3,0,0,0,3,3,4,3,1,3,1,2,PG
2004,28,32,598,58,138,1,5,57,133,19,27,11,50,61,102,52,0,44,50,136,PG
2004,28,21,420,46,105,1,3,45,102,30,38,3,45,48,98,29,0,25,56,123,PG
2004,22,74,882,115,327,81,207,34,120,19,24,30,81,111,40,25,8,41,102,330,SF
2004,35,73,1522,211,506,49,168,162,338,145,199,60,211,271,200,59,21,110,110,616,PF
2004,34,48,984,119,256,6,21,113,235,40,50,50,182,232,89,37,28,42,102,284,PF
2004,27,17,328,57,124,8,40,49,84,10,13,30,49,79,24,8,13,11,47,132,C
2004,18,21,224,43,88,0,4,43,84,10,13,9,35,44,9,3,3,15,28,96,C
2004,24,10,63,13,20,0,0,13,20,8,12,2,9,11,2,0,1,3,2,34,SF
2004,26,6,37,5,14,1,2,4,12,2,2,0,4,4,0,0,0,2,7,13,SF
2004,26,4,17,2,6,0,0,2,6,2,2,0,3,3,0,0,0,2,5,6,SF
2004,26,2,20,3,8,1,2,2,6,0,0,0,1,1,0,0,0,0,2,7,SF
2004,30,4,22,1,3,1,1,0,2,1,2,0,3,3,2,2,0,4,2,4,PG
2004,30,73,2233,394,933,106,289,288,644,144,182,46,154,200,151,61,12,101,177,1038,SG
2004,26,14,65,7,20,2,5,5,15,0,0,1,6,7,2,2,2,3,10,16,SF
2004,24,80,2931,535,1229,145,386,390,843,206,270,133,385,518,175,99,54,135,233,1421,SF
2004,28,4,48,2,10,0,3,2,7,4,6,2,5,7,4,2,0,4,7,8,PG
2004,23,82,1617,223,517,25,85,198,432,101,117,24,131,155,305,62,2,174,200,572,PG
2004,26,76,2332,309,714,80,209,229,505,101,131,26,161,187,317,61,5,124,185,799,PG
2004,33,78,1701,149,375,43,139,106,236,34,51,96,216,312,117,48,18,64,159,375,SF
2004,28,72,1246,101,204,0,6,101,198,57,118,134,138,272,28,33,18,47,175,259,C
2004,24,73,2628,453,1013,76,231,377,782,526,620,96,334,430,224,65,16,207,217,1508,SF
2004,25,82,2777,383,809,0,1,383,808,353,470,268,579,847,86,43,101,201,278,1119,C
2004,40,42,1373,193,400,0,1,193,399,168,225,61,306,367,163,50,20,103,116,554,PF
2004,26,81,3254,598,1386,87,274,511,1112,356,436,58,205,263,719,129,9,249,172,1639,PG
2004,26,34,1415,262,606,37,118,225,488,147,185,19,98,117,281,64,5,97,74,708,PG
2004,26,47,1839,336,780,50,156,286,624,209,251,39,107,146,438,65,4,152,98,931,PG
2004,25,79,3217,590,1341,90,265,500,1076,228,268,212,525,737,214,167,104,156,203,1498,SF
2004,30,82,2988,470,1020,131,325,339,695,134,182,210,598,808,122,93,124,117,247,1205,PF
2004,30,16,408,57,136,11,27,46,109,14,20,28,71,99,28,13,20,22,47,139,PF
2004,30,66,2580,413,884,120,298,293,586,120,162,182,527,709,94,80,104,95,200,1066,PF
2004,32,16,172,20,67,6,26,14,41,9,9,2,5,7,23,2,1,7,23,55,PG
2004,26,65,2252,439,900,7,25,432,875,201,294,133,484,617,160,95,82,168,230,1086,PF
2004,31,19,730,156,398,19,67,137,331,65,80,19,98,117,47,14,5,37,42,396,SF
2004,26,82,2534,409,867,9,39,400,828,356,463,93,266,359,152,60,24,148,191,1183,SF
2004,23,26,328,32,98,13,39,19,59,19,22,1,30,31,26,11,6,20,36,96,SG
2004,23,3,43,1,11,1,6,0,5,0,0,0,3,3,3,1,0,2,5,3,SG
2004,23,23,285,31,87,12,33,19,54,19,22,1,27,28,23,10,6,18,31,93,SG
2004,36,59,789,104,219,0,1,104,218,43,63,57,131,188,29,14,18,45,144,251,PF
2004,29,77,1900,203,523,137,366,66,157,62,82,28,211,239,124,72,22,91,179,605,PF
2004,30,59,636,47,117,0,1,47,116,19,27,48,85,133,20,12,20,25,89,113,C
2004,29,42,927,126,268,0,0,126,268,38,69,70,187,257,36,37,24,57,117,290,PF
2004,29,18,421,65,142,0,0,65,142,22,38,31,88,119,20,12,11,27,46,152,PF
2004,29,24,506,61,126,0,0,61,126,16,31,39,99,138,16,25,13,30,71,138,PF
2004,24,67,2675,653,1566,174,513,479,1053,398,500,95,307,402,370,93,42,179,129,1878,SG
2004,29,39,1269,196,416,15,47,181,369,58,76,16,78,94,196,36,2,61,94,465,SG
2004,29,31,1096,138,331,31,80,107,251,56,67,17,65,82,234,36,4,59,69,363,PG
2004,31,75,2112,265,577,75,172,190,405,84,111,45,208,253,195,85,23,103,142,689,SF
2004,24,33,391,27,82,1,10,26,72,33,43,5,29,34,59,16,1,29,39,88,PG
2004,24,68,1442,237,537,0,3,237,534,89,116,148,195,343,57,38,18,59,191,563,PF
2004,27,39,516,90,211,2,7,88,204,13,17,10,39,49,22,14,5,26,37,195,SG
2004,24,22,391,59,127,0,0,59,127,34,48,47,93,140,10,9,22,25,58,152,PF
2004,24,54,939,127,254,0,0,127,254,76,118,109,164,273,11,28,41,65,150,330,C
2004,22,79,2079,365,753,7,40,358,713,124,193,112,247,359,162,67,61,130,168,861,SF
2004,22,37,888,143,331,5,30,138,301,39,72,48,119,167,80,25,27,56,84,330,SF
2004,22,42,1191,222,422,2,10,220,412,85,121,64,128,192,82,42,34,74,84,531,SF
2004,18,34,159,17,65,0,1,17,64,14,24,11,32,43,7,7,15,13,33,48,C
2004,27,82,2838,430,941,12,65,418,876,342,411,127,239,366,501,142,25,215,194,1214,PG
2004,27,72,2621,373,731,12,38,361,693,256,329,191,552,743,312,68,86,144,247,1014,PF
2004,23,65,1770,270,616,80,215,190,401,102,141,42,174,216,232,59,14,107,162,722,SF
2004,33,48,506,53,100,0,1,53,99,15,23,46,84,130,36,19,26,33,91,121,C
2004,38,80,2254,260,594,134,334,126,260,146,165,18,170,188,249,65,11,68,96,800,SG
2004,23,82,2692,535,1025,0,2,535,1023,361,446,197,538,735,122,22,156,204,273,1431,C
2004,28,80,3229,460,1081,164,420,296,661,176,217,40,322,362,258,107,33,180,179,1260,SG
2004,26,80,1611,246,472,0,0,246,472,100,169,178,296,474,36,55,52,96,195,592,C
2004,26,53,938,138,280,0,0,138,280,69,110,101,166,267,20,22,27,55,113,345,C
2004,26,27,673,108,192,0,0,108,192,31,59,77,130,207,16,33,25,41,82,247,C
2004,25,35,417,40,84,0,1,40,83,22,38,41,72,113,8,17,12,25,42,102,PF
2004,28,4,10,1,5,0,0,1,5,0,0,1,1,2,0,0,0,0,1,2,C
2004,28,28,385,49,94,0,0,49,94,30,35,28,54,82,19,7,13,22,64,128,PF
2004,33,12,215,33,71,0,0,33,71,30,34,8,19,27,8,2,6,10,32,96,C
2004,23,28,610,107,243,5,17,102,226,60,80,48,125,173,20,12,17,34,58,279,PF
2004,30,33,518,76,215,21,60,55,155,24,35,14,76,90,28,15,7,38,47,197,SF
2004,24,82,2021,389,915,67,229,322,686,168,235,45,159,204,205,81,28,149,158,1013,PG
2004,32,7,35,3,12,2,5,1,7,0,1,3,2,5,1,1,0,2,3,8,SF
2004,37,65,1494,141,295,0,0,141,295,81,119,145,292,437,25,17,123,54,141,363,C
2004,28,28,366,27,69,0,0,27,69,44,59,43,69,112,0,8,25,18,59,98,C
2004,28,3,7,0,1,0,0,0,1,0,0,0,1,1,0,0,1,1,1,0,C
2004,28,25,359,27,68,0,0,27,68,44,59,43,68,111,0,8,24,17,58,98,C
2004,23,45,516,47,132,23,63,24,69,21,29,8,62,70,30,14,14,23,72,138,SF
2004,28,27,300,63,138,0,0,63,138,16,19,26,37,63,17,10,7,24,48,142,PF
2004,28,8,83,11,27,0,0,11,27,7,9,8,6,14,4,1,0,0,9,29,SF
2004,28,22,397,73,162,0,3,73,159,24,30,30,36,66,17,4,1,21,36,170,SF
2004,27,58,720,72,162,2,4,70,158,30,46,67,89,156,25,35,19,29,90,176,SF
2004,29,78,2612,397,845,104,257,293,588,230,251,59,173,232,687,67,8,209,139,1128,PG
2004,27,82,2353,328,700,0,0,328,700,54,114,257,376,633,114,51,165,107,247,710,C
2004,29,64,1245,108,276,2,19,106,257,36,46,65,90,155,72,25,19,54,109,254,SF
2004,30,66,847,80,217,20,58,60,159,54,71,10,55,65,121,44,5,64,51,234,PG
2004,30,30,401,27,87,8,23,19,64,18,24,2,28,30,48,16,2,30,16,80,PG
2004,30,36,446,53,130,12,35,41,95,36,47,8,27,35,73,28,3,34,35,154,PG
2004,25,77,2915,605,1310,99,290,506,1020,371,423,90,580,670,207,92,104,135,216,1680,C
2004,25,78,2788,608,1400,2,18,606,1382,348,460,193,585,778,164,59,199,181,248,1566,PF
2004,31,67,2464,554,948,0,0,554,948,331,676,246,523,769,196,34,166,195,225,1439,C
2004,40,7,25,2,6,0,0,2,6,5,6,0,5,5,2,0,0,1,8,9,PF
2004,24,80,3003,485,1127,61,205,424,922,340,458,160,616,776,327,85,71,236,273,1371,PF
2004,24,71,1580,251,542,18,48,233,494,162,209,160,261,421,69,36,63,101,138,682,PF
2004,31,82,1401,95,257,4,9,91,248,147,176,23,147,170,234,51,8,81,119,341,PG
2004,28,43,925,121,285,0,0,121,285,36,61,78,167,245,24,16,68,54,137,278,C
2004,30,78,2153,208,437,0,1,208,436,113,195,221,357,578,123,30,139,99,228,529,C
2004,32,82,1606,159,312,0,4,159,308,61,116,125,217,342,90,73,70,69,170,379,PF
2004,19,8,19,3,7,0,0,3,7,2,4,2,2,4,1,1,0,1,1,8,PF
2004,34,61,1033,99,245,3,23,96,222,23,31,16,70,86,138,26,2,58,89,224,PG
2004,34,6,22,3,8,0,0,3,8,2,2,0,1,1,4,1,0,2,4,8,PG
2004,34,55,1011,96,237,3,23,93,214,21,29,16,69,85,134,25,2,56,85,216,PG
2004,19,59,664,68,175,0,0,68,175,58,90,69,105,174,13,21,12,34,87,194,C
2004,34,26,220,22,52,0,0,22,52,5,6,4,14,18,27,12,1,16,20,49,PG
2004,27,58,547,74,167,28,65,46,102,24,32,46,93,139,23,12,13,22,73,200,PF
2004,25,59,1211,104,298,4,26,100,272,45,68,15,87,102,184,41,11,87,90,257,PG
2004,24,31,479,81,199,22,62,59,137,23,27,8,29,37,70,13,6,47,50,207,PG
2004,24,13,63,6,16,2,4,4,12,0,0,0,6,6,11,2,0,12,5,14,PG
2004,24,5,71,9,29,0,5,9,24,0,0,0,4,4,12,4,1,5,7,18,PG
2004,24,13,345,66,154,20,53,46,101,23,27,8,19,27,47,7,5,30,38,175,PG
2004,21,75,2577,423,946,62,199,361,747,191,272,43,194,237,411,61,7,179,148,1099,PG
2004,31,12,64,4,10,0,0,4,10,4,6,4,6,10,1,0,3,2,7,12,C
2004,28,73,1651,200,395,2,12,198,383,105,190,129,139,268,139,84,21,105,152,507,SF
2004,20,79,1144,149,376,19,70,130,306,65,84,44,115,159,60,41,16,67,187,382,SF
2004,35,82,2825,482,1024,55,165,427,859,180,252,72,270,342,449,96,19,151,169,1199,PG
2004,34,75,1391,156,348,68,141,88,207,51,61,31,122,153,120,56,10,77,103,431,SG
2004,22,10,89,14,28,0,0,14,28,4,4,6,18,24,3,2,2,6,14,32,PF
2004,23,2,18,1,6,1,3,0,3,0,0,0,1,1,1,1,0,3,1,3,SG
2004,19,10,35,8,15,0,0,8,15,6,9,5,9,14,3,0,2,5,6,22,C
2004,32,58,1037,126,314,55,138,71,176,31,39,16,101,117,66,19,9,38,38,338,SG
2004,32,16,284,33,107,11,43,22,64,6,8,2,16,18,23,5,2,16,11,83,SG
2004,32,33,621,80,168,36,76,44,92,19,25,12,62,74,38,11,6,18,22,215,SG
2004,32,9,132,13,39,8,19,5,20,6,6,2,23,25,5,3,1,4,5,40,SG
2004,26,82,2148,238,587,126,340,112,247,76,94,35,226,261,113,88,14,69,206,678,SF
2004,33,49,703,72,191,43,122,29,69,14,16,10,63,73,26,16,5,29,42,201,SF
2004,26,80,3099,602,1497,115,384,487,1113,517,631,69,453,522,410,131,52,303,234,1836,SG
2004,21,53,748,96,231,35,105,61,126,52,75,48,71,119,27,32,12,40,100,279,PG
2004,38,23,412,53,140,13,48,40,92,17,27,20,48,68,50,21,9,29,38,136,SF
2004,21,49,473,53,129,9,32,44,97,38,60,14,41,55,68,13,3,36,70,153,SG
2004,28,61,678,47,114,0,0,47,114,12,21,67,97,164,10,23,26,22,110,106,C
2004,31,4,20,1,2,0,0,1,2,0,1,0,3,3,0,1,0,3,8,2,PF
2004,27,82,2451,368,770,112,290,256,480,278,335,92,311,403,122,137,40,112,248,1126,SG
2004,28,65,1419,200,409,0,0,200,409,59,92,101,188,289,53,22,28,77,161,459,C
2004,23,82,2701,338,723,57,157,281,566,108,141,93,297,390,191,63,69,119,149,841,SF
2004,24,17,347,18,50,0,0,18,50,13,31,32,79,111,7,5,17,18,53,49,C
2004,24,12,314,18,50,0,0,18,50,12,29,31,70,101,4,5,17,16,48,48,C
2004,23,77,2321,345,812,140,377,205,435,95,127,104,302,406,142,80,42,109,187,925,PF
2004,22,81,3067,663,1368,1,5,662,1363,299,393,242,609,851,163,68,41,247,227,1626,PF
2004,30,85,2664,266,549,0,0,266,549,140,217,195,419,614,71,54,307,120,300,672,C
2004,30,53,1648,171,373,0,0,171,373,96,147,105,276,381,51,30,166,86,189,438,C
2004,30,32,1016,95,176,0,0,95,176,44,70,90,143,233,20,24,141,34,111,234,C
2004,31,24,273,34,77,0,0,34,77,23,30,23,35,58,6,5,11,17,52,91,C
2004,31,21,222,22,54,0,0,22,54,22,28,19,30,49,4,5,9,13,45,66,C
2004,31,3,51,12,23,0,0,12,23,1,2,4,5,9,2,0,2,4,7,25,C
2004,24,82,3021,633,1439,127,363,506,1076,383,441,118,289,407,185,81,6,116,152,1776,SG
2004,36,18,262,22,76,5,28,17,48,17,17,9,32,41,24,6,0,13,22,66,SF
2004,23,78,2936,563,1284,77,273,486,1011,258,377,124,400,524,226,86,41,196,182,1461,SG
2004,23,65,2338,425,1068,120,341,305,727,151,204,146,268,414,139,67,19,141,130,1121,SG
2004,22,69,1114,145,350,27,80,118,270,65,79,35,73,108,163,52,7,80,105,382,PG
2004,37,82,2846,366,945,112,314,254,631,123,173,54,268,322,271,68,73,173,237,967,PF
2004,27,51,1024,157,326,1,5,156,321,28,43,27,77,104,58,33,10,45,57,343,SF
2004,31,42,1336,275,614,34,100,241,514,114,137,46,143,189,57,42,9,106,96,698,SF
2004,32,69,1409,207,505,50,152,157,353,75,98,100,207,307,137,59,27,98,183,539,PF
2004,34,55,595,54,151,0,1,54,150,33,37,24,73,97,29,14,10,22,89,141,C
2004,34,35,325,34,94,0,0,34,94,12,15,10,40,50,11,9,5,15,48,80,C
2004,34,20,270,20,57,0,1,20,56,21,22,14,33,47,18,5,5,7,41,61,C
2004,31,16,529,75,200,23,54,52,146,39,51,7,57,64,56,12,4,37,45,212,SF
2004,31,50,1968,308,752,46,148,262,604,148,180,27,175,202,273,39,18,171,139,810,PG
2004,29,67,1256,173,404,0,3,173,401,183,225,110,210,320,69,36,24,112,164,529,PF
2004,27,41,733,38,117,0,0,38,117,16,38,78,129,207,41,22,21,42,103,92,PF
2004,23,72,1244,190,432,48,138,142,294,31,52,20,77,97,59,33,20,48,109,459,SG
2004,33,72,945,98,244,43,112,55,132,50,65,32,114,146,71,32,12,37,110,289,SF
2004,24,77,1603,161,416,50,147,111,269,71,92,38,158,196,134,62,16,77,122,443,SG
2004,20,10,130,11,23,0,0,11,23,7,12,23,29,52,7,2,4,6,16,29,C
2004,27,54,708,78,163,0,0,78,163,61,90,35,97,132,24,19,21,32,98,217,C
2004,25,69,928,86,218,10,41,76,177,58,70,42,131,173,65,21,14,42,113,240,PF
2004,27,57,583,81,178,6,21,75,157,32,46,43,49,92,19,19,20,23,66,200,SF
2004,26,7,86,10,23,0,1,10,22,1,3,8,8,16,4,1,1,9,9,21,PF
2004,23,56,1376,147,373,2,12,145,361,141,169,115,147,262,96,51,17,73,169,437,SF
2004,27,56,1577,255,513,0,0,255,513,79,138,119,292,411,49,30,61,78,165,589,C
2004,23,22,165,21,60,4,12,17,48,7,14,10,15,25,14,7,1,11,20,53,SG
2004,26,31,168,26,70,0,3,26,67,12,20,11,20,31,11,2,6,7,25,64,C
2004,28,76,2254,311,708,1,5,310,703,207,241,230,413,643,78,47,94,82,209,830,PF
2004,23,1,4,1,2,0,0,1,2,0,0,1,1,2,0,0,0,0,1,2,C
2004,34,71,929,119,293,43,107,76,186,77,83,27,54,81,56,15,6,42,91,358,SG
2004,23,20,178,16,43,6,12,10,31,6,8,13,28,41,7,5,5,14,18,44,SF
2004,30,82,2966,295,715,2,18,293,697,252,316,62,219,281,563,97,6,187,213,844,PG
2004,25,73,976,133,273,0,0,133,273,71,88,91,134,225,48,42,12,43,126,337,PF
2004,33,82,3100,518,1266,99,299,419,967,240,295,56,254,310,286,88,21,158,101,1375,SF
2004,29,26,774,128,321,23,65,105,256,83,103,16,78,94,103,24,3,88,49,362,SF
2004,27,42,453,43,103,0,0,43,103,22,36,50,75,125,23,11,15,19,61,108,C
2004,22,54,1511,261,586,7,30,254,556,89,133,43,135,178,92,28,16,80,86,618,SG
2004,22,26,933,115,285,12,41,103,244,49,71,36,84,120,66,24,1,40,54,291,SF
2004,28,8,76,3,7,0,0,3,7,2,2,5,13,18,0,1,8,1,21,8,PF
2004,28,17,71,2,5,0,0,2,5,1,2,3,8,11,0,1,2,2,13,5,C
2004,26,81,3264,665,1386,240,554,425,832,394,425,91,417,508,173,108,14,153,159,1964,SF
2004,30,82,3118,408,1018,156,427,252,591,127,145,52,256,308,500,99,9,180,173,1099,PG
2004,21,55,2025,411,865,1,5,410,860,310,435,157,339,496,78,64,89,177,188,1133,PF
2004,30,43,571,79,196,29,66,50,130,44,51,13,58,71,90,26,2,54,63,231,PG
2004,37,61,1197,150,353,10,36,140,317,72,98,34,121,155,244,35,11,85,76,382,PG
2004,37,46,915,122,269,10,33,112,236,57,76,24,94,118,185,27,7,67,59,311,PG
2004,37,15,282,28,84,0,3,28,81,15,22,10,27,37,59,8,4,18,17,71,PG
2004,23,5,33,4,10,0,0,4,10,3,6,2,8,10,1,0,0,3,9,11,C
2004,23,4,29,3,9,0,0,3,9,3,6,2,8,10,0,0,0,3,7,9,C
2004,23,1,4,1,1,0,0,1,1,0,0,0,0,0,1,0,0,0,2,2,C
2004,30,80,1663,202,485,21,79,181,406,171,226,100,226,326,233,62,14,105,158,596,SG
2004,30,53,707,71,173,9,36,62,137,48,69,30,73,103,89,37,9,39,86,199,SG
2004,30,27,956,131,312,12,43,119,269,123,157,70,153,223,144,25,5,66,72,397,SG
2004,21,42,494,69,140,0,1,69,139,42,58,68,89,157,14,18,12,32,57,180,PF
2004,24,77,1528,268,571,1,4,267,567,190,262,141,237,378,38,56,118,88,188,727,PF
2004,26,28,622,106,236,20,46,86,190,53,64,24,64,88,33,12,1,28,42,285,SF
2004,27,75,2081,367,765,0,2,367,763,128,174,131,253,384,107,43,47,149,253,862,PF
2004,26,81,3018,499,1196,146,421,353,775,215,260,49,287,336,437,124,16,229,192,1359,PG
2004,25,79,1901,257,526,0,0,257,526,191,295,183,345,528,68,36,123,113,219,705,C
2004,26,74,2699,381,813,1,5,380,808,243,323,261,489,750,111,82,33,172,219,1006,PF
2004,31,80,2548,392,829,0,3,392,826,106,127,145,517,662,149,56,80,132,298,890,PF
2004,26,66,2089,363,813,73,194,290,619,171,218,64,256,320,124,64,20,116,196,970,SF
2004,26,42,1343,226,510,47,130,179,380,93,122,38,167,205,90,40,15,73,127,592,SF
2004,26,24,746,137,303,26,64,111,239,78,96,26,89,115,34,24,5,43,69,378,SF
2004,25,52,1378,153,370,77,207,76,163,49,67,28,108,136,303,84,17,110,132,432,PG
2004,26,71,942,145,287,2,5,143,282,70,128,106,156,262,43,39,37,62,161,362,C
2004,29,68,1025,155,328,0,6,155,322,69,91,83,133,216,49,12,17,54,129,379,C
2004,24,11,96,10,38,2,4,8,34,3,6,6,9,15,4,3,0,6,7,25,SG
2004,24,7,15,0,4,0,0,0,4,1,2,0,1,1,0,1,1,2,3,1,C
2004,24,4,10,0,2,0,0,0,2,0,0,0,1,1,0,0,1,2,1,0,C
2004,24,3,5,0,2,0,0,0,2,1,2,0,0,0,0,1,0,0,2,1,C
2004,24,40,533,67,133,0,0,67,133,36,61,37,91,128,18,9,22,23,79,170,C
2004,20,39,307,40,122,3,11,37,111,23,29,24,39,63,10,6,8,17,50,106,PF
2004,24,80,2073,262,645,101,241,161,404,114,161,52,306,358,154,80,32,94,165,739,SF
2004,26,4,28,3,9,0,1,3,8,2,4,1,4,5,2,2,1,3,3,8,SF
2004,32,39,1255,187,479,46,150,141,329,70,99,16,88,104,206,20,2,78,57,490,PG
2004,28,72,2340,410,903,93,233,317,670,249,290,149,352,501,120,68,33,169,215,1162,SF
2004,28,47,1574,273,613,60,161,213,452,163,199,98,245,343,83,52,18,119,151,769,SF
2004,28,25,766,137,290,33,72,104,218,86,91,51,107,158,37,16,15,50,64,393,SF
2004,28,71,1271,107,277,3,20,104,257,53,68,12,104,116,195,44,2,84,126,270,PG
2004,26,66,1606,152,300,0,0,152,300,134,181,123,220,343,57,42,25,77,258,438,C
2004,21,1,3,0,1,0,0,0,1,0,0,0,0,0,0,0,0,0,1,0,C
2004,22,61,2126,371,798,16,53,355,745,233,312,85,162,247,275,86,34,196,140,991,PG
2004,20,44,708,112,306,31,86,81,220,32,47,9,49,58,51,26,7,41,89,287,SG
2004,27,82,2840,483,1129,82,305,401,824,103,186,198,486,684,369,65,65,202,212,1151,PF
2004,27,33,418,38,99,0,2,38,97,29,44,42,70,112,6,9,11,15,54,105,PF
2004,29,81,3050,315,748,1,8,314,740,142,290,324,682,1006,138,143,246,123,162,773,C
2004,21,37,337,32,89,0,2,32,87,11,24,35,39,74,19,14,14,8,37,75,SF
2004,29,37,368,61,145,5,13,56,132,31,40,12,47,59,14,5,8,24,38,158,SF
2004,29,68,2390,425,974,82,248,343,726,156,212,102,357,459,156,61,122,119,190,1088,PF
2004,29,45,1675,296,669,59,173,237,496,115,155,69,229,298,114,36,72,87,131,766,PF
2004,29,1,42,8,24,1,6,7,18,3,3,1,5,6,2,1,5,3,0,20,PF
2004,29,22,673,121,281,22,69,99,212,38,54,32,123,155,40,24,45,29,59,302,PF
2004,23,72,730,65,153,13,39,52,114,31,44,39,88,127,113,28,8,44,70,174,PF
2004,33,71,1252,160,390,84,206,76,184,20,27,12,132,144,215,64,11,96,107,424,PG
2004,33,35,827,115,260,59,138,56,122,16,21,10,86,96,170,47,8,69,74,305,PG
2004,33,36,425,45,130,25,68,20,62,4,6,2,46,48,45,17,3,27,33,119,PG
2004,24,81,1669,172,464,26,106,146,358,90,138,49,129,178,402,91,19,146,175,460,PG
2004,33,52,868,104,211,0,1,104,210,53,72,74,130,204,30,30,15,35,75,261,PF
2004,33,15,216,18,40,0,0,18,40,18,19,14,36,50,13,8,2,9,19,54,PF
2004,33,37,652,86,171,0,1,86,170,35,53,60,94,154,17,22,13,26,56,207,PF
2004,30,23,831,174,421,1,5,173,416,81,114,48,152,200,105,31,20,60,76,430,PF
2004,27,72,1872,363,850,22,69,341,781,138,183,78,182,260,139,91,19,161,197,886,SG
2004,27,13,404,68,175,1,8,67,167,21,27,21,40,61,35,20,3,32,38,158,SG
2004,27,59,1468,295,675,21,61,274,614,117,156,57,142,199,104,71,16,129,159,728,SG
2004,24,81,2179,262,612,69,181,193,431,153,206,60,236,296,183,101,7,129,176,746,SG
2004,33,61,2001,311,800,92,285,219,515,137,182,28,106,134,175,71,14,100,147,851,SG
2004,23,71,930,108,228,0,2,108,226,57,80,117,180,297,60,27,28,48,117,273,PF
2004,27,62,865,99,190,0,0,99,190,63,126,97,164,261,7,25,51,66,176,261,C
2004,27,1,4,0,1,0,0,0,1,0,0,0,0,0,0,0,1,1,0,0,C
2004,27,61,861,99,189,0,0,99,189,63,126,97,164,261,7,25,50,65,176,261,C
2004,23,72,985,215,468,33,87,182,381,78,104,44,121,165,60,32,20,78,105,541,SF
2004,32,16,186,17,45,8,18,9,27,5,5,3,12,15,14,6,2,6,6,47,PG
2004,21,65,1340,227,436,0,1,227,435,105,150,125,180,305,51,29,20,80,183,559,C
2004,24,26,145,17,36,6,10,11,26,10,12,3,13,16,17,3,0,7,15,50,PG
2004,32,72,1337,172,342,1,3,171,339,105,155,101,193,294,81,34,46,89,187,450,C
2004,29,56,1730,201,496,26,89,175,407,66,85,18,132,150,224,55,10,78,114,494,SG
2004,31,71,1886,231,598,35,127,196,471,215,283,65,221,286,120,70,9,88,180,712,SF
2004,31,21,513,77,177,11,32,66,145,78,109,21,74,95,25,22,1,31,52,243,SF
2004,31,50,1373,154,421,24,95,130,326,137,174,44,147,191,95,48,8,57,128,469,SF
2004,23,56,714,80,208,18,60,62,148,41,48,8,45,53,121,25,6,63,58,219,PG
2004,28,72,2115,290,713,120,364,170,349,82,98,25,122,147,492,92,5,136,97,782,PG
2004,30,68,1637,158,336,0,8,158,328,106,155,177,298,475,72,90,8,74,134,422,PF
2004,30,15,407,28,57,0,1,28,56,21,29,35,93,128,11,19,3,23,30,77,PF
2004,30,53,1230,130,279,0,7,130,272,85,126,142,205,347,61,71,5,51,104,345,PF
2004,21,57,772,115,303,10,39,105,264,44,56,23,49,72,76,28,2,51,87,284,SG
2004,35,43,527,90,186,2,3,88,183,16,27,38,94,132,17,20,16,16,95,198,C
2004,35,16,267,53,101,2,2,51,99,9,13,23,49,72,6,15,7,6,45,117,C
2004,35,27,260,37,85,0,1,37,84,7,14,15,45,60,11,5,9,10,50,81,C
2004,28,37,525,59,151,25,74,34,77,40,45,9,34,43,64,23,1,26,40,183,SG
2004,28,16,238,28,81,5,26,23,55,11,13,0,17,17,52,14,1,21,22,72,PG
2004,30,79,1574,304,602,0,0,304,602,144,197,88,168,256,57,30,20,113,204,752,PF
2004,41,48,373,70,150,0,1,70,149,24,39,37,61,98,11,21,9,32,61,164,C
2004,25,38,506,44,96,0,0,44,96,33,55,65,69,134,10,11,19,26,52,121,C
2004,22,62,673,88,237,10,29,78,208,38,60,46,90,136,46,20,14,52,88,224,SF
2004,24,73,2714,468,1112,75,242,393,870,322,439,100,285,385,272,152,50,202,194,1333,SF
2004,28,65,1674,257,586,0,5,257,581,96,131,144,301,445,71,45,58,77,192,610,C
2004,26,16,114,17,46,4,14,13,32,9,10,4,14,18,2,3,5,6,13,47,C
2004,26,2,9,0,1,0,0,0,1,4,4,0,4,4,0,0,1,0,0,4,C
2004,26,14,105,17,45,4,14,13,31,5,6,4,10,14,2,3,4,6,13,43,C
2005,28,54,1867,337,670,15,39,322,631,220,254,123,269,392,111,49,26,117,150,909,PF
2005,31,16,201,16,49,8,19,8,30,9,12,8,21,29,37,9,1,19,29,49,SG
2005,26,36,519,84,177,0,0,84,177,26,28,40,59,99,18,9,22,18,53,194,PF
2005,26,14,248,35,76,0,0,35,76,13,14,24,28,52,11,4,11,11,29,83,PF
2005,26,22,271,49,101,0,0,49,101,13,14,16,31,47,7,5,11,7,24,111,PF
2005,29,78,3064,640,1494,209,556,431,938,378,428,79,268,347,289,84,5,171,167,1867,SG
2005,23,77,1262,184,387,12,31,172,356,112,152,85,136,221,64,76,24,77,156,492,SG
2005,28,80,2717,403,974,139,389,264,585,191,258,42,237,279,514,118,7,170,212,1136,PG
2005,26,67,1430,191,358,0,3,191,355,131,190,137,273,410,71,14,100,64,144,513,C
2005,30,47,1239,152,391,58,151,94,240,70,87,25,103,128,143,36,4,70,89,432,SG
2005,34,43,743,85,201,6,13,79,188,27,37,24,64,88,103,33,0,49,87,203,PG
2005,34,39,717,81,190,6,13,75,177,27,37,23,60,83,98,33,0,46,81,195,PG
2005,34,4,26,4,11,0,0,4,11,0,0,1,4,5,5,0,0,3,6,8,PG
2005,31,1,20,0,2,0,1,0,1,0,0,1,0,1,0,0,0,1,2,0,SG
2005,31,65,1151,98,215,5,28,93,187,54,66,40,150,190,70,40,14,49,136,255,SF
2005,20,75,2608,530,1230,42,158,488,1072,456,573,141,285,426,194,68,30,224,229,1558,SF
2005,24,59,736,76,175,1,3,75,172,43,55,59,126,185,16,21,8,52,157,196,C
2005,23,80,3274,656,1523,205,562,451,961,521,640,83,295,378,411,139,23,242,245,2038,PG
2005,19,80,1382,172,389,3,13,169,376,121,174,89,153,242,85,70,18,73,150,468,SF
2005,36,66,988,89,277,28,111,61,166,58,68,35,80,115,178,45,8,67,92,264,PG
2005,36,14,412,53,159,17,70,36,89,19,21,16,32,48,65,15,2,28,30,142,PG
2005,36,52,576,36,118,11,41,25,77,39,47,19,48,67,113,30,6,39,62,122,PG
2005,25,70,1448,167,429,8,30,159,399,119,149,26,78,104,280,44,4,107,143,461,PG
2005,25,30,742,93,232,7,18,86,214,53,63,11,35,46,152,20,3,55,67,246,PG
2005,25,40,706,74,197,1,12,73,185,66,86,15,43,58,128,24,1,52,76,215,PG
2005,30,82,2903,388,910,176,455,212,455,163,203,31,166,197,358,73,2,151,181,1115,PG
2005,36,55,663,68,167,0,0,68,167,57,77,45,54,99,36,23,8,31,83,193,SF
2005,25,5,19,0,1,0,0,0,1,0,0,1,1,2,1,1,0,1,3,0,PG
2005,25,4,18,0,1,0,0,0,1,0,0,1,1,2,1,1,0,1,3,0,PG
2005,33,24,191,13,38,0,1,13,37,7,15,17,20,37,9,2,4,15,31,33,PF
2005,33,3,13,0,4,0,0,0,4,2,2,0,2,2,1,0,0,2,7,2,C
2005,23,81,1145,115,286,21,59,94,227,121,163,29,97,126,155,63,13,79,146,372,PG
2005,22,63,1087,168,354,51,139,117,215,55,69,32,98,130,126,30,7,87,127,442,PG
2005,24,43,715,62,151,5,22,57,129,35,58,49,84,133,57,30,7,45,80,164,SF
2005,22,38,483,45,124,14,52,31,72,14,19,11,29,40,69,19,1,27,51,118,PG
2005,22,27,314,20,69,9,37,11,32,7,10,5,14,19,42,14,0,16,35,56,PG
2005,22,11,169,25,55,5,15,20,40,7,9,6,15,21,27,5,1,11,16,62,PG
2005,33,81,1742,194,459,100,280,94,179,113,135,29,161,190,178,39,20,64,123,601,SG
2005,35,69,1505,161,368,71,165,90,203,62,71,26,133,159,167,60,9,67,95,455,SG
2005,35,16,275,31,77,11,32,20,45,10,13,4,17,21,28,14,2,14,28,83,SG
2005,35,53,1230,130,291,60,133,70,158,52,58,22,116,138,139,46,7,53,67,372,SG
2005,28,81,1894,163,354,0,6,163,348,68,94,109,343,452,42,30,81,81,244,394,C
2005,26,80,2516,271,613,70,177,201,436,180,228,158,255,413,126,91,77,75,201,792,SG
2005,26,4,36,3,11,0,0,3,11,0,2,4,4,8,0,0,0,4,10,6,PF
2005,28,63,1790,303,667,54,134,249,533,112,150,48,153,201,91,44,8,79,205,772,SG
2005,24,7,93,16,40,1,5,15,35,3,6,5,9,14,4,1,2,10,9,36,SF
2005,32,76,1461,190,452,26,85,164,367,108,122,19,88,107,143,66,9,67,148,514,PG
2005,26,80,3084,560,1264,131,364,429,900,320,413,77,255,332,541,124,30,203,191,1571,PG
2005,18,30,384,45,78,0,1,45,77,19,40,47,71,118,12,12,24,12,87,109,C
2005,28,80,2866,404,913,165,387,239,526,343,382,48,223,271,464,81,9,180,194,1316,PG
2005,24,44,648,61,186,36,93,25,93,33,41,18,53,71,69,13,0,39,47,191,PG
2005,29,82,2130,327,618,0,1,327,617,117,164,143,254,397,129,33,64,158,229,771,C
2005,25,2,12,2,5,1,2,1,3,0,0,0,3,3,0,0,0,0,1,5,SG
2005,24,74,1791,262,688,57,173,205,515,133,183,76,150,226,135,68,8,122,167,714,SG
2005,24,82,1553,247,463,39,92,208,371,56,71,108,177,285,48,39,19,40,220,589,C
2005,28,51,451,49,108,0,1,49,107,26,32,29,78,107,8,15,28,16,78,124,C
2005,28,34,262,34,79,0,1,34,78,14,16,16,42,58,4,11,16,8,55,82,C
2005,28,17,189,15,29,0,0,15,29,12,16,13,36,49,4,4,12,8,23,42,C
2005,23,51,1772,361,693,0,1,361,692,187,268,141,316,457,144,41,24,137,179,909,PF
2005,24,67,859,74,172,0,0,74,172,52,71,86,138,224,49,10,32,52,160,200,C
2005,20,81,3017,473,1005,3,10,470,995,412,542,194,524,718,153,76,113,187,226,1361,PF
2005,33,82,2627,251,598,102,253,149,345,71,112,50,235,285,126,55,39,57,175,675,SF
2005,29,66,604,47,111,3,6,44,105,14,21,21,55,76,18,23,5,7,61,111,SF
2005,28,82,2162,340,824,56,166,284,658,279,303,37,106,143,372,78,12,121,122,1015,PG
2005,25,18,119,15,24,0,1,15,23,3,8,8,20,28,5,1,2,5,12,33,PF
2005,25,8,55,3,7,0,0,3,7,0,0,3,11,14,2,1,2,1,4,6,PF
2005,25,8,48,8,12,0,0,8,12,2,6,5,6,11,2,0,0,3,8,18,PF
2005,25,2,16,4,5,0,1,4,4,1,2,0,3,3,1,0,0,1,0,9,PF
2005,32,77,885,84,186,0,0,84,186,43,63,70,144,214,15,25,63,33,153,211,C
2005,28,7,24,3,7,0,0,3,7,0,0,7,5,12,0,0,0,2,4,6,PF
2005,25,81,3001,629,1251,0,3,629,1248,364,484,296,474,770,208,62,169,183,240,1622,PF
2005,24,18,185,11,37,3,15,8,22,6,13,6,16,22,12,8,1,13,11,31,PG
2005,25,72,2276,387,756,0,0,387,756,164,220,226,305,531,86,33,55,106,183,938,C
2005,25,14,152,23,62,4,11,19,51,4,9,10,18,28,14,1,6,15,17,54,SF
2005,26,67,1238,173,409,45,121,128,288,103,130,37,139,176,92,39,12,53,83,494,SG
2005,23,8,55,2,6,0,3,2,3,8,10,1,10,11,4,3,1,5,4,12,SF
2005,22,42,908,109,237,0,0,109,237,74,129,72,134,206,39,25,15,67,112,292,PF
2005,35,82,2817,338,758,0,0,338,758,210,243,266,471,737,178,74,50,101,233,886,PF
2005,25,76,1066,124,348,26,72,98,276,59,75,21,72,93,155,32,1,74,59,333,PG
2005,32,80,1945,166,442,48,130,118,312,57,74,23,164,187,410,82,7,125,106,437,PG
2005,26,66,2689,573,1324,131,387,442,937,542,664,95,297,392,398,86,53,270,174,1819,SG
2005,28,70,1522,160,303,49,121,111,182,63,81,66,142,208,133,75,6,49,169,432,SG
2005,27,64,1313,187,489,34,108,153,381,37,45,33,156,189,63,40,4,35,101,445,SF
2005,24,24,219,28,60,3,11,25,49,14,19,1,11,12,28,13,1,12,25,73,PG
2005,24,77,2746,441,991,38,125,403,866,275,319,146,304,450,146,110,23,125,213,1195,SF
2005,19,3,5,4,4,0,0,4,4,2,2,0,0,0,0,1,0,1,0,10,C
2005,25,65,1203,163,409,57,153,106,256,37,48,15,136,151,62,18,29,37,104,420,SF
2005,23,40,475,86,177,13,36,73,141,53,65,35,67,102,25,10,5,30,59,238,PF
2005,23,3,11,4,7,0,0,4,7,1,1,2,1,3,0,0,0,0,0,9,PF
2005,23,37,464,82,170,13,36,69,134,52,64,33,66,99,25,10,5,30,59,229,PF
2005,30,66,2015,279,600,0,4,279,596,125,173,131,530,661,152,61,199,103,177,683,C
2005,36,40,390,39,123,0,2,39,121,42,55,28,65,93,19,8,7,29,57,120,C
2005,36,10,50,0,7,0,0,0,7,2,4,3,8,11,3,0,1,1,10,2,C
2005,36,30,340,39,116,0,2,39,114,40,51,25,57,82,16,8,6,28,47,118,C
2005,27,58,1433,160,432,44,125,116,307,158,181,63,162,225,114,88,19,83,172,522,PF
2005,28,6,16,2,3,0,0,2,3,4,6,1,0,1,1,0,0,1,1,8,SG
2005,24,25,430,70,180,13,39,57,141,71,83,13,47,60,17,17,2,25,37,224,SG
2005,29,66,742,72,177,2,17,70,160,35,51,12,57,69,161,35,18,62,88,181,PG
2005,28,20,608,124,302,19,59,105,243,50,72,28,38,66,61,25,15,22,56,317,SG
2005,28,57,2220,572,1239,108,254,464,985,317,388,78,257,335,266,84,33,146,187,1569,SF
2005,35,59,1522,319,687,27,103,292,584,134,155,25,132,157,301,36,14,109,160,799,PG
2005,30,62,1525,160,297,0,0,160,297,112,143,102,314,416,40,55,82,64,170,432,C
2005,24,36,433,42,125,12,49,30,76,15,24,4,27,31,51,13,0,24,30,111,PG
2005,22,80,2189,207,419,0,2,207,417,226,336,261,514,775,65,69,141,118,268,640,C
2005,33,55,951,113,265,0,3,113,262,24,37,32,92,124,64,17,15,35,95,250,SG
2005,21,80,2376,302,642,13,56,289,586,190,231,195,287,482,151,74,35,106,184,807,SG
2005,34,52,1525,130,332,15,62,115,270,70,78,38,139,177,199,80,18,104,106,345,SG
2005,34,31,996,83,204,10,39,73,165,50,56,29,94,123,153,43,13,68,61,226,SG
2005,34,21,529,47,128,5,23,42,105,20,22,9,45,54,46,37,5,36,45,119,SG
2005,26,62,1866,257,611,11,61,246,550,187,254,37,147,184,374,109,8,119,184,712,PG
2005,26,46,1501,216,501,10,52,206,449,162,213,32,121,153,286,87,6,92,154,604,PG
2005,26,16,365,41,110,1,9,40,101,25,41,5,26,31,88,22,2,27,30,108,PG
2005,27,14,65,5,14,0,2,5,12,3,4,2,4,6,7,2,0,2,2,13,PG
2005,37,5,50,3,14,0,2,3,12,3,3,3,12,15,0,0,0,2,6,9,C
2005,27,70,942,174,376,6,14,168,362,48,71,84,100,184,18,15,13,63,147,402,C
2005,26,50,961,65,157,0,1,65,156,83,119,57,107,164,61,11,6,34,146,213,C
2005,26,80,2542,186,451,2,6,184,445,137,209,153,335,488,105,71,71,91,322,511,C
2005,24,82,1396,190,354,0,3,190,351,83,118,156,220,376,32,34,50,62,252,463,C
2005,24,72,1087,176,422,78,199,98,223,28,37,63,153,216,35,23,26,29,139,458,C
2005,23,5,74,10,24,0,4,10,20,3,6,2,5,7,22,6,1,6,6,23,PG
2005,24,70,2688,437,1097,185,512,252,585,182,216,33,170,203,302,92,19,148,135,1241,SG
2005,29,73,1827,188,497,45,174,143,323,226,256,103,272,375,98,48,17,104,154,647,PF
2005,22,63,1808,393,730,0,0,393,730,226,314,116,222,338,37,21,58,163,202,1012,C
2005,36,18,249,13,29,0,0,13,29,4,8,8,19,27,15,5,4,5,39,30,SF
2005,23,72,1785,250,477,0,0,250,477,89,148,187,355,542,35,46,121,114,241,589,C
2005,29,59,1609,202,367,0,3,202,364,138,228,183,318,501,51,15,80,102,205,542,C
2005,29,75,2026,273,623,49,165,224,458,248,304,20,149,169,309,51,3,78,78,843,PG
2005,22,21,72,6,18,1,2,5,16,0,0,7,11,18,4,2,0,6,7,13,SF
2005,24,60,1412,220,504,7,35,213,469,98,133,87,129,216,128,83,14,86,124,545,SG
2005,36,72,1843,193,419,0,0,193,419,115,152,152,276,428,80,27,41,96,147,501,PF
2005,25,46,1581,291,752,118,354,173,398,185,243,32,143,175,362,81,14,131,126,885,PG
2005,25,18,593,111,303,44,137,67,166,74,96,16,51,67,129,31,4,38,52,340,PG
2005,25,28,988,180,449,74,217,106,232,111,147,16,92,108,233,50,10,93,74,545,PG
2005,35,61,1307,112,234,0,0,112,234,60,99,152,223,375,47,32,65,43,162,284,C
2005,35,36,577,45,109,0,0,45,109,22,38,61,92,153,23,13,32,20,79,112,C
2005,35,25,730,67,125,0,0,67,125,38,61,91,131,222,24,19,33,23,83,172,C
2005,24,42,328,42,111,19,53,23,58,14,17,29,50,79,12,8,4,15,45,117,PF
2005,25,82,2696,481,1041,61,180,420,861,286,351,66,183,249,246,89,27,205,174,1309,SG
2005,31,8,49,4,9,0,0,4,9,1,3,7,3,10,0,2,0,1,14,9,C
2005,22,30,459,42,117,9,35,33,82,23,40,13,42,55,38,22,6,23,44,116,SG
2005,31,56,1340,246,591,72,202,174,389,103,136,28,102,130,104,47,3,54,123,667,SG
2005,19,61,1663,280,645,31,117,249,528,120,162,92,230,322,135,48,27,118,98,711,SF
2005,22,66,1201,124,294,9,50,115,244,57,77,54,116,170,149,37,18,87,123,314,SG
2005,26,71,2090,306,756,85,245,221,511,190,228,34,146,180,347,76,4,145,201,887,PG
2005,26,4,16,1,8,1,3,0,5,2,3,0,1,1,1,0,0,1,1,5,PG
2005,26,67,2074,305,748,84,242,221,506,188,225,34,145,179,346,76,4,144,200,882,PG
2005,26,11,61,4,14,3,9,1,5,2,2,3,6,9,1,2,1,2,5,13,SF
2005,23,39,306,20,69,0,2,20,67,0,5,30,40,70,15,8,27,12,53,40,C
2005,36,15,130,13,31,0,0,13,31,8,12,18,14,32,19,4,1,14,25,34,C
2005,26,63,1054,186,447,48,147,138,300,87,97,32,87,119,111,43,4,68,98,507,SG
2005,27,80,1175,148,331,0,2,148,329,25,41,74,185,259,47,23,22,36,160,321,C
2005,24,74,1184,139,345,19,75,120,270,85,109,11,79,90,132,39,11,65,120,382,PG
2005,29,71,1435,238,543,25,71,213,472,96,120,73,165,238,49,42,24,78,138,597,C
2005,22,82,2177,172,488,94,265,78,223,49,67,23,190,213,398,82,3,119,205,487,PG
2005,28,66,2203,517,1042,3,9,514,1033,305,455,202,530,732,179,45,174,127,144,1342,PF
2005,24,79,2570,408,905,107,276,301,629,134,172,97,338,435,203,79,26,132,198,1057,SF
2005,24,47,472,61,127,1,2,60,125,29,47,34,61,95,24,7,10,22,60,152,SF
2005,20,2,54,11,21,0,1,11,20,5,9,6,10,16,1,1,1,3,7,27,SG
2005,25,10,110,10,31,0,0,10,31,7,12,12,13,25,3,3,4,2,19,27,C
2005,23,25,139,11,30,0,0,11,30,7,14,8,11,19,3,3,4,8,12,29,C
2005,32,74,1428,161,405,27,103,134,302,66,83,15,75,90,250,45,9,111,156,415,PG
2005,29,42,732,79,182,0,1,79,181,72,93,69,110,179,11,22,12,45,129,230,C
2005,28,67,939,101,216,1,3,100,213,45,79,61,140,201,34,34,41,40,129,248,C
2005,26,79,1649,227,526,0,0,227,526,122,212,142,184,326,76,32,69,115,199,576,PF
2005,22,8,28,2,6,0,0,2,6,3,5,0,2,2,0,0,0,1,4,7,SG
2005,26,65,1233,165,373,27,82,138,291,59,78,88,113,201,45,37,8,34,104,416,SG
2005,24,79,1881,131,275,0,2,131,273,125,234,254,482,736,58,58,15,104,202,387,PF
2005,31,64,2358,387,907,116,285,271,622,113,136,45,217,262,169,48,18,60,123,1003,SG
2005,30,74,2222,297,755,108,291,189,464,175,203,38,180,218,301,76,4,129,176,877,PG
2005,26,54,903,133,292,0,6,133,286,70,103,29,146,175,64,25,13,63,96,336,PF
2005,23,16,77,14,29,5,10,9,19,2,2,1,2,3,11,2,0,11,9,35,PG
2005,23,15,73,13,27,4,9,9,18,2,2,0,2,2,11,2,0,11,9,32,PG
2005,23,1,4,1,2,1,1,0,1,0,0,1,0,1,0,0,0,0,0,3,PG
2005,28,62,1047,118,226,0,0,118,226,227,258,157,191,348,8,15,7,91,265,463,C
2005,28,61,1594,168,324,0,5,168,319,90,142,205,345,550,43,46,12,55,186,426,C
2005,28,8,56,9,17,1,3,8,14,0,2,3,5,8,0,2,0,5,7,19,SF
2005,29,78,1700,156,311,0,0,156,311,40,72,165,264,429,56,26,159,58,201,352,C
2005,27,43,499,56,140,31,80,25,60,21,25,17,44,61,30,15,4,14,35,164,SG
2005,27,78,2978,563,1330,38,127,525,1203,499,606,126,324,450,547,112,28,317,273,1663,PG
2005,23,23,441,37,127,14,54,23,73,5,8,16,45,61,20,13,2,17,40,93,PF
2005,34,2,21,3,6,0,0,3,6,3,5,1,2,3,0,0,0,0,2,9,PF
2005,26,81,1783,243,451,0,0,243,451,107,199,261,413,674,30,47,106,81,224,593,C
2005,24,21,187,17,50,4,14,13,36,3,4,1,13,14,7,5,1,7,17,41,PG
2005,24,10,108,10,27,3,12,7,15,3,4,0,11,11,3,3,0,4,12,26,PG
2005,24,11,79,7,23,1,2,6,21,0,0,1,2,3,4,2,1,3,5,15,PG
2005,24,8,146,18,52,5,18,13,34,3,4,7,8,15,18,4,1,8,15,44,SG
2005,28,82,3121,683,1360,6,25,677,1335,445,549,247,861,1108,466,121,112,222,207,1817,PF
2005,28,71,955,123,306,49,147,74,159,29,33,21,103,124,30,19,9,30,107,324,PF
2005,24,56,1790,357,695,1,6,356,689,282,367,130,280,410,135,37,93,137,146,997,PF
2005,27,15,306,37,104,21,58,16,46,15,20,13,40,53,14,8,2,12,32,110,SF
2005,26,73,1021,81,242,36,117,45,125,71,81,16,96,112,83,59,5,60,105,269,PG
2005,36,14,284,32,80,3,9,29,71,18,20,11,26,37,27,14,4,9,37,85,SG
2005,27,74,2193,367,780,97,258,270,522,355,442,75,254,329,288,119,27,172,190,1186,SG
2005,27,81,1660,283,632,38,105,245,527,111,137,25,157,182,137,46,11,90,155,715,SG
2005,26,7,68,8,22,1,8,7,14,8,10,3,8,11,4,3,3,2,9,25,SG
2005,33,33,537,57,136,32,80,25,56,26,31,10,49,59,78,15,0,15,32,172,PG
2005,33,9,55,4,15,3,9,1,6,7,8,1,7,8,0,0,0,1,5,18,PG
2005,33,24,482,53,121,29,71,24,50,19,23,9,42,51,78,15,0,14,27,154,PG
2005,23,82,2523,464,943,5,28,459,915,251,310,207,546,753,130,77,76,133,233,1184,PF
2005,21,82,2002,434,1056,134,331,300,725,233,270,55,160,215,164,53,10,186,224,1235,SG
2005,32,69,1136,103,209,0,0,103,209,57,79,101,156,257,34,23,23,43,175,263,C
2005,23,57,1066,155,423,30,105,125,318,97,125,22,111,133,100,34,6,75,121,437,SG
2005,30,69,667,58,161,2,9,56,152,33,44,52,94,146,53,43,4,30,78,151,SF
2005,22,70,1492,202,522,67,204,135,318,56,78,128,325,453,53,23,118,55,120,527,PF
2005,35,47,966,99,241,8,26,91,215,33,43,56,135,191,68,41,17,57,104,239,PF
2005,35,20,218,11,37,0,0,11,37,4,6,15,28,43,12,9,4,9,23,26,PF
2005,35,27,748,88,204,8,26,80,178,29,37,41,107,148,56,32,13,48,81,213,PF
2005,24,9,106,13,38,0,1,13,37,6,11,5,10,15,3,2,2,6,15,32,PF
2005,31,47,275,17,37,0,0,17,37,12,31,19,16,35,5,6,7,8,39,46,SF
2005,26,76,2926,510,1160,36,118,474,1042,368,429,74,221,295,372,77,13,217,232,1424,SG
2005,29,16,159,11,32,0,0,11,32,29,48,18,24,42,6,5,2,12,26,51,C
2005,31,21,297,43,83,0,1,43,82,9,17,23,42,65,13,7,5,18,55,95,C
2005,33,37,894,110,260,15,50,95,210,34,46,19,70,89,74,28,3,50,79,269,SF
2005,28,78,2584,418,855,9,43,409,812,245,315,196,284,480,142,70,16,133,250,1090,SF
2005,24,66,2550,453,986,16,74,437,912,236,351,145,316,461,208,85,16,204,249,1158,SF
2005,24,29,550,64,178,6,19,58,159,29,35,13,50,63,62,25,5,41,72,163,SG
2005,31,70,1271,217,424,0,0,217,424,127,177,106,186,292,56,24,18,84,188,561,PF
2005,21,76,1173,157,366,44,131,113,235,78,103,28,74,102,169,77,19,82,139,436,PG
2005,34,73,1128,118,299,21,65,97,234,56,69,39,82,121,49,27,6,29,68,313,SG
2005,22,43,760,106,184,0,0,106,184,52,91,48,87,135,13,16,55,53,134,264,C
2005,26,74,1887,257,573,35,95,222,478,157,200,18,185,203,367,99,14,102,167,706,PG
2005,24,3,16,2,2,0,0,2,2,4,4,2,5,7,1,1,1,1,2,8,PF
2005,24,80,2675,346,641,0,4,346,637,178,225,239,487,726,108,63,41,113,260,870,PF
2005,25,82,2068,225,475,1,11,224,464,90,114,80,139,219,128,30,30,64,200,541,SG
2005,23,54,1560,206,530,42,123,164,407,99,118,41,186,227,90,49,9,62,107,553,SF
2005,25,68,1865,239,427,0,0,239,427,159,261,202,262,464,57,52,114,96,218,637,C
2005,32,78,1203,116,220,0,2,116,218,41,76,164,184,348,21,29,37,49,149,273,PF
2005,22,55,1317,194,386,0,2,194,384,140,212,104,221,325,84,50,48,94,167,528,C
2005,32,67,2338,517,1015,3,13,514,1002,280,341,77,241,318,220,97,28,161,144,1317,SF
2005,24,77,2800,445,1122,145,408,300,714,171,216,32,272,304,494,122,21,176,244,1206,PG
2005,32,76,1272,139,284,70,145,69,139,89,102,32,149,181,85,50,15,20,105,437,SG
2005,34,75,1396,157,375,51,138,106,237,86,109,91,177,268,80,67,60,69,138,451,PF
2005,26,13,300,61,135,12,29,49,106,10,13,2,17,19,24,24,3,13,23,144,SG
2005,26,5,41,6,17,4,6,2,11,0,0,0,3,3,5,2,0,0,3,16,SG
2005,26,50,550,98,214,28,62,70,152,13,14,14,47,61,67,18,3,22,39,237,PG
2005,33,20,532,85,205,31,80,54,125,36,43,4,19,23,42,8,2,21,40,237,SG
2005,19,82,2670,352,677,0,2,352,675,277,413,287,536,823,75,77,136,165,232,981,PF
2005,24,76,2446,377,793,34,115,343,678,170,232,169,315,484,109,116,49,122,211,958,SF
2005,31,61,1624,244,541,0,1,244,540,97,115,126,220,346,94,32,5,79,143,585,PF
2005,28,79,1729,266,664,89,258,177,406,70,90,19,86,105,283,27,6,113,121,691,PG
2005,26,61,2358,467,1086,59,209,408,877,352,453,74,308,382,285,176,18,153,168,1345,SG
2005,25,35,317,42,103,0,2,42,101,18,37,50,37,87,6,10,1,23,35,102,SF
2005,19,67,873,116,287,2,6,114,281,44,101,73,124,197,43,25,18,52,96,278,PF
2005,24,31,224,37,73,0,0,37,73,21,39,25,44,69,3,4,7,22,42,95,PF
2005,34,76,1144,108,302,23,84,85,218,46,58,38,85,123,130,68,13,68,125,285,SG
2005,23,76,1046,135,220,0,1,135,219,78,163,98,129,227,13,4,102,44,131,348,C
2005,21,82,2686,269,546,47,142,222,404,156,210,89,375,464,246,138,48,139,204,741,SG
2005,29,78,2615,458,979,2,7,456,972,402,503,299,373,672,100,53,165,191,313,1320,C
2005,24,15,58,6,14,0,0,6,14,3,4,3,5,8,0,0,5,5,13,15,C
2005,29,75,3174,771,1818,104,338,667,1480,656,786,51,248,299,596,180,9,344,140,2302,PG
2005,23,62,809,85,198,3,9,82,189,47,67,19,65,84,103,39,7,58,140,220,PG
2005,31,25,536,109,255,33,96,76,159,50,58,23,62,85,59,14,2,28,58,301,SG
2005,28,21,230,17,33,0,2,17,31,8,13,3,20,23,24,7,1,10,26,42,SG
2005,34,64,1987,248,582,122,295,126,287,54,58,33,236,269,183,35,5,115,153,672,SF
2005,34,24,990,118,283,54,147,64,136,30,33,10,105,115,86,23,1,56,67,320,SF
2005,34,40,997,130,299,68,148,62,151,24,25,23,131,154,97,12,4,59,86,352,SF
2005,23,10,43,10,27,4,6,6,21,5,6,2,4,6,3,0,0,2,4,29,SF
2005,30,81,1976,340,731,0,2,340,729,289,349,184,222,406,81,32,18,131,171,969,C
2005,26,51,1806,330,819,103,286,227,533,190,229,44,206,250,119,64,14,123,154,953,SF
2005,23,40,768,65,157,34,89,31,68,48,62,17,50,67,37,11,1,27,56,212,SF
2005,23,44,1030,100,251,32,88,68,163,103,130,18,82,100,76,22,7,44,48,335,SG
2005,29,80,1330,174,342,0,2,174,340,47,65,81,160,241,19,23,111,88,279,395,C
2005,20,80,3388,795,1684,108,308,687,1376,477,636,111,477,588,577,177,52,262,146,2175,SF
2005,29,74,1859,331,751,100,259,231,492,109,145,35,173,208,263,65,6,106,174,871,PG
2005,29,47,1167,205,460,58,152,147,308,67,90,23,99,122,185,40,4,80,114,535,PG
2005,29,27,692,126,291,42,107,84,184,42,55,12,74,86,78,25,2,26,60,336,PG
2005,28,68,2605,519,1189,71,208,448,981,225,296,160,359,519,154,55,16,118,151,1334,PF
2005,26,50,1656,189,457,56,151,133,306,59,82,20,141,161,303,84,17,98,107,493,PG
2005,20,71,1051,195,369,0,3,195,366,85,135,119,193,312,24,22,55,66,195,475,PF
2005,24,33,1355,238,564,30,89,208,475,227,269,49,191,240,133,33,17,132,109,733,SF
2005,23,77,2007,203,434,16,51,187,383,101,173,152,222,374,151,66,35,114,206,523,SF
2005,30,15,104,15,45,0,9,15,36,12,13,3,6,9,9,5,1,7,6,42,PG
2005,25,6,87,6,22,0,4,6,18,0,0,5,5,10,4,1,0,3,10,12,SF
2005,30,63,1747,203,456,41,108,162,348,85,113,32,147,179,302,59,15,96,144,532,PG
2005,24,71,1232,185,371,53,148,132,223,80,101,43,108,151,75,43,18,65,140,503,SG
2005,37,46,410,28,54,1,1,27,53,16,25,43,70,113,6,7,13,18,86,73,C
2005,23,82,3240,544,1179,177,370,367,809,135,180,120,302,422,291,79,24,148,167,1400,SF
2005,24,2,15,0,2,0,1,0,1,0,0,0,3,3,0,1,0,1,1,0,SF
2005,24,52,649,83,190,23,60,60,130,44,64,11,58,69,21,13,11,29,81,233,SG
2005,28,82,2576,331,726,225,521,106,205,68,86,14,217,231,350,44,5,98,121,955,PG
2005,33,80,2839,351,820,142,382,209,438,174,216,38,367,405,212,86,38,99,251,1018,SF
2005,25,77,2268,275,647,87,229,188,418,176,207,34,208,242,196,61,31,114,171,813,SG
2005,24,75,1330,126,318,66,166,60,152,53,62,39,135,174,57,31,28,43,123,371,SF
2005,25,76,1830,210,486,102,261,108,225,55,75,107,291,398,65,44,24,49,165,577,SF
2005,29,10,116,9,31,0,4,9,27,5,10,6,7,13,6,5,2,3,16,23,SF
2005,22,63,1632,246,495,0,1,246,494,80,121,135,288,423,73,26,68,115,182,572,C
2005,23,81,1491,269,671,80,194,189,477,70,85,32,132,164,61,40,6,46,132,688,SF
2005,24,45,356,47,98,0,1,47,97,24,43,52,76,128,8,8,13,26,86,118,C
2005,22,32,523,54,124,4,11,50,113,23,42,28,80,108,25,20,18,33,80,135,SF
2005,31,66,2435,340,855,129,358,211,497,142,192,94,394,488,545,123,9,167,110,951,PG
2005,23,41,1349,207,420,23,77,184,343,203,259,89,166,255,132,67,136,90,101,640,PF
2005,30,11,243,28,73,7,21,21,52,6,10,1,31,32,20,8,3,7,12,69,SG
2005,23,1,3,0,1,0,0,0,1,0,0,0,0,0,1,0,0,0,0,0,PG
2005,29,66,1944,248,587,3,20,245,567,167,196,21,149,170,591,131,5,147,192,666,PG
2005,23,82,2667,317,759,226,558,91,201,82,96,40,339,379,182,103,33,106,265,942,SF
2005,21,75,1965,281,570,0,2,281,568,185,255,161,240,401,77,32,63,112,280,747,PF
2005,36,53,1099,105,256,42,116,63,140,44,61,31,129,160,160,39,13,64,70,296,SF
2005,30,5,12,0,1,0,0,0,1,0,0,0,1,1,0,0,0,2,1,0,SG
2005,35,49,739,107,184,1,7,106,177,45,59,36,95,131,41,32,15,29,78,260,PF
2005,28,80,2196,341,688,82,225,259,463,120,148,154,399,553,98,42,99,70,262,884,PF
2005,19,37,380,49,132,2,4,47,128,15,22,24,65,89,11,5,7,17,51,115,C
2005,19,16,119,17,49,2,3,15,46,8,12,9,23,32,1,1,2,10,20,44,C
2005,19,21,261,32,83,0,1,32,82,7,10,15,42,57,10,4,5,7,31,71,C
2005,31,3,54,10,26,4,12,6,14,5,8,0,6,6,6,1,0,2,2,29,SG
2005,25,71,2697,532,1151,173,432,359,719,220,283,110,278,388,94,75,62,123,158,1457,SF
2005,29,17,227,22,52,5,8,17,44,15,17,3,9,12,45,12,2,14,28,64,PG
2005,19,30,814,89,215,0,2,89,213,44,59,22,67,89,151,32,11,75,82,222,PG
2005,24,31,518,57,135,20,45,37,90,27,33,7,32,39,123,22,3,47,78,161,PG
2005,27,70,2007,295,654,55,155,240,499,142,165,14,135,149,322,33,0,105,168,787,PG
2005,27,21,479,48,122,15,45,33,77,14,18,0,40,40,58,8,0,24,48,125,PG
2005,27,49,1528,247,532,40,110,207,422,128,147,14,95,109,264,25,0,81,120,662,PG
2005,34,44,933,68,189,11,37,57,152,17,23,55,119,174,88,32,12,57,83,164,SF
2005,29,41,601,34,66,0,0,34,66,20,40,63,65,128,18,7,14,24,103,88,C
2005,25,66,2436,425,986,51,168,374,818,563,657,70,324,394,225,70,8,195,191,1464,SG
2005,26,23,703,98,227,0,0,98,227,74,123,79,126,205,29,8,23,59,74,270,C
2005,27,82,3281,604,1308,115,325,489,983,458,549,50,198,248,668,122,6,233,186,1781,PG
2005,26,81,3146,613,1289,114,341,499,948,229,275,235,680,915,154,163,119,125,199,1569,PF
2005,29,23,244,27,80,0,3,27,77,22,28,18,38,56,8,3,11,14,29,76,PF
2005,31,65,1645,262,592,151,363,111,229,72,91,95,333,428,81,57,46,42,136,747,PF
2005,33,11,190,16,50,5,18,11,32,5,8,3,7,10,28,6,0,6,19,42,PG
2005,27,70,2272,444,907,0,12,444,895,199,308,146,365,511,170,100,78,149,228,1087,PF
2005,21,45,455,45,117,5,25,40,92,36,55,29,29,58,22,16,3,24,35,131,PG
2005,27,80,2893,478,1079,1,8,477,1071,420,524,85,227,312,217,58,27,164,198,1377,SF
2005,37,61,699,74,182,0,0,74,182,48,63,54,109,163,14,18,20,40,122,196,PF
2005,30,72,906,95,235,55,155,40,80,15,29,29,109,138,37,25,15,36,144,260,PF
2005,30,44,553,62,150,30,90,32,60,8,15,21,56,77,26,15,9,17,85,162,PF
2005,30,28,353,33,85,25,65,8,20,7,14,8,53,61,11,10,6,19,59,98,PF
2005,27,10,88,7,13,0,0,7,13,1,5,7,14,21,0,3,8,6,24,15,C
2005,30,77,1797,307,598,0,1,307,597,126,192,177,305,482,71,46,52,93,204,740,PF
2005,25,78,3182,715,1660,142,435,573,1225,431,557,71,413,484,448,135,52,201,167,2003,SF
2005,30,76,2651,377,915,91,264,286,651,130,160,32,125,157,391,56,1,117,177,975,PG
2005,32,68,1118,61,142,20,62,41,80,10,16,20,152,172,103,48,17,31,116,152,SG
2005,25,53,1382,143,408,18,72,125,336,112,146,20,93,113,236,63,12,99,138,416,PG
2005,25,43,423,71,156,0,1,71,155,23,28,31,48,79,13,9,2,13,64,165,PF
2005,28,18,390,65,158,0,3,65,155,7,10,9,31,40,20,16,2,14,20,137,SF
2005,25,75,1870,280,552,0,2,280,550,175,258,197,305,502,50,14,108,110,237,735,C
2005,23,63,1699,336,697,8,23,328,674,129,215,71,228,299,129,75,78,157,189,809,SF
2005,19,37,254,25,76,0,0,25,76,17,24,3,40,43,7,2,17,16,31,67,C
2005,28,82,2852,427,895,6,39,421,856,253,302,100,238,338,569,121,8,220,204,1113,PG
2005,33,2,9,2,3,0,0,2,3,0,0,0,1,1,1,1,0,1,2,4,PF
2005,28,56,2089,319,609,5,19,314,590,233,287,139,382,521,220,69,68,82,181,876,C
2005,24,76,2278,387,766,140,323,247,443,108,150,36,264,300,220,54,23,127,197,1022,SF
2005,39,66,2105,314,719,96,298,218,421,250,268,18,138,156,146,50,5,77,109,974,SG
2005,24,80,2447,538,975,0,0,538,975,389,497,208,461,669,61,34,160,196,298,1465,C
2005,29,66,2388,408,932,150,342,258,590,168,205,45,184,229,188,74,30,133,152,1134,SG
2005,29,23,726,128,296,58,125,70,171,55,69,11,52,63,42,23,9,41,49,369,SG
2005,29,43,1662,280,636,92,217,188,419,113,136,34,132,166,146,51,21,92,103,765,SG
2005,27,77,1933,289,602,0,1,289,601,153,227,247,339,586,34,58,86,108,236,731,C
2005,27,54,1519,234,460,0,1,234,459,121,171,169,270,439,26,53,53,81,172,589,C
2005,27,23,414,55,142,0,0,55,142,32,56,78,69,147,8,5,33,27,64,142,C
2005,26,8,69,3,9,0,1,3,8,8,9,6,17,23,0,2,3,6,7,14,C
2005,26,8,24,3,4,0,0,3,4,2,4,3,4,7,0,0,1,1,2,8,C
2005,26,4,27,3,5,0,0,3,5,0,0,1,6,7,1,1,2,0,4,6,PF
2005,29,74,1178,144,287,1,5,143,282,107,136,97,149,246,47,19,32,63,173,396,PF
2005,34,18,457,68,150,0,0,68,150,51,86,31,96,127,14,5,41,45,50,187,PF
2005,34,19,245,32,62,0,0,32,62,31,55,22,49,71,4,3,33,12,32,95,C
2005,24,70,2375,392,947,59,148,333,799,233,319,251,505,756,97,53,33,108,190,1076,PF
2005,31,62,918,132,310,46,105,86,205,61,80,44,120,164,47,32,16,54,85,371,SF
2005,25,49,883,131,363,24,95,107,268,59,80,15,83,98,65,30,11,57,59,345,SG
2005,38,80,1212,108,217,0,0,108,217,106,143,150,276,426,10,16,101,51,135,322,C
2005,29,11,72,8,20,0,1,8,19,4,7,9,9,18,1,1,5,0,20,20,C
2005,24,16,204,15,43,10,21,5,22,9,12,4,26,30,9,1,0,5,30,49,SF
2005,24,55,1137,146,368,65,175,81,193,88,105,20,132,152,65,28,16,68,153,445,PF
2005,29,68,2017,415,869,0,2,415,867,133,165,128,170,298,109,36,16,110,190,963,SF
2005,28,68,1185,145,322,6,21,139,301,58,91,102,141,243,65,41,24,61,148,354,PF
2005,28,42,610,70,172,6,15,64,157,29,45,53,65,118,37,18,10,32,71,175,PF
2005,28,26,575,75,150,0,6,75,144,29,46,49,76,125,28,23,14,29,77,179,PF
2005,30,75,2573,430,857,94,218,336,639,211,238,57,192,249,861,74,6,245,136,1165,PG
2005,22,79,1612,286,628,44,141,242,487,73,107,52,141,193,237,78,3,117,199,689,PG
2005,28,70,1785,198,430,0,0,198,430,14,30,184,275,459,71,31,117,73,207,410,C
2005,30,74,1832,182,424,19,53,163,371,55,69,78,142,220,91,50,18,61,144,438,SG
2005,25,81,1892,241,601,25,97,216,504,170,222,69,317,386,122,37,34,135,208,677,SF
2005,31,38,360,35,109,0,12,35,97,20,24,10,36,46,39,18,2,27,44,90,PG
2005,31,32,321,32,93,0,12,32,81,18,22,9,33,42,34,17,2,25,42,82,PG
2005,31,6,39,3,16,0,0,3,16,2,2,1,3,4,5,1,0,2,2,8,PG
2005,26,78,3020,663,1445,91,228,572,1217,615,708,96,661,757,240,97,119,176,219,2032,PF
2005,26,44,1530,386,854,1,6,385,848,295,391,85,303,388,82,25,88,131,173,1068,PF
2005,32,73,2492,658,1095,0,0,658,1095,353,765,253,507,760,200,36,171,203,262,1669,C
2005,25,64,2320,366,774,36,117,330,657,207,298,134,519,653,238,42,65,161,211,975,PF
2005,22,73,2600,448,1003,0,1,448,1002,209,343,275,520,795,64,62,125,125,214,1105,PF
2005,25,82,2304,354,756,17,63,337,693,329,387,194,422,616,166,32,68,141,227,1054,C
2005,32,26,158,11,31,0,0,11,31,6,9,3,16,19,19,5,0,6,16,28,PG
2005,29,62,1215,161,353,0,0,161,353,46,69,106,218,324,29,15,56,68,193,368,C
2005,31,56,556,37,84,0,2,37,82,13,38,55,112,167,37,7,40,24,88,87,C
2005,33,39,214,12,34,0,0,12,34,5,9,16,37,53,13,6,12,8,29,29,PF
2005,20,59,793,133,267,4,10,129,257,49,75,40,81,121,35,30,40,39,77,319,SF
2005,20,74,1397,160,354,0,1,160,353,138,185,131,247,378,60,44,34,70,166,458,C
2005,28,66,942,98,233,50,126,48,107,29,40,47,138,185,55,33,10,30,119,275,PF
2005,26,80,1533,175,392,2,12,173,380,115,155,26,108,134,279,48,13,104,126,467,PG
2005,25,32,453,82,213,23,66,59,147,17,23,12,35,47,76,16,1,45,53,204,PG
2005,23,16,144,18,43,3,13,15,30,9,13,4,8,12,15,5,0,19,16,48,PG
2005,23,11,110,11,28,2,9,9,19,9,13,2,7,9,11,3,0,10,13,33,PG
2005,23,5,34,7,15,1,4,6,11,0,0,2,1,3,4,2,0,9,3,15,PG
2005,22,80,2735,539,1118,43,156,496,962,210,323,47,251,298,491,98,4,215,167,1331,PG
2005,29,70,1957,319,601,2,25,317,576,169,282,126,147,273,138,106,21,143,164,809,SF
2005,21,65,862,120,276,30,78,90,198,44,64,15,56,71,49,29,4,47,121,314,SG
2005,36,77,2541,339,725,42,129,297,596,153,201,48,188,236,469,88,12,148,121,873,PG
2005,35,40,529,56,150,25,65,31,85,16,18,14,51,65,57,18,2,28,39,153,SG
2005,24,4,12,1,3,0,1,1,2,0,0,0,1,1,1,0,0,2,0,2,SG
2005,20,60,548,56,119,0,0,56,119,37,58,53,123,176,21,9,37,43,98,149,C
2005,33,41,667,107,226,41,89,66,137,9,13,3,80,83,39,19,4,17,30,264,SF
2005,33,16,206,25,57,8,21,17,36,4,4,1,21,22,11,6,0,7,6,62,SF
2005,33,25,461,82,169,33,68,49,101,5,9,2,59,61,28,13,4,10,24,202,SF
2005,27,82,2510,356,848,129,335,227,513,188,226,71,269,340,169,91,18,93,219,1029,SG
2005,34,68,841,111,258,57,134,54,124,45,56,15,64,79,51,29,1,37,67,324,SG
2005,27,82,2960,556,1223,108,292,448,931,549,668,78,461,539,348,133,39,230,255,1769,SF
2005,22,67,1340,214,501,67,195,147,306,141,202,65,124,189,82,46,18,92,139,636,SF
2005,22,43,515,78,174,15,40,63,134,46,66,19,50,69,44,25,0,41,76,217,PG
2005,29,49,865,79,167,0,0,79,167,33,49,85,120,205,18,30,24,31,123,191,C
2005,32,9,27,2,6,0,0,2,6,0,0,5,3,8,1,1,2,1,5,4,PF
2005,28,50,1382,127,356,55,178,72,178,96,111,45,174,219,88,48,23,69,134,405,SF
2005,29,33,335,45,87,0,1,45,86,27,31,30,48,78,9,7,3,12,53,117,C
2005,24,82,3039,469,963,47,138,422,825,221,274,133,302,435,247,56,71,135,161,1206,SF
2005,27,42,428,56,128,8,28,48,100,16,25,24,52,76,37,16,5,27,44,136,SF
2005,25,76,1858,199,333,0,0,199,333,90,174,178,410,588,74,24,163,98,239,488,C
2005,24,63,1856,266,650,128,329,138,321,81,103,52,237,289,86,57,31,80,172,741,PF
2005,28,12,128,6,19,0,0,6,19,7,10,9,19,28,6,0,2,15,32,19,C
2005,19,6,20,5,10,0,0,5,10,1,2,1,3,4,0,0,1,3,4,11,C
2005,23,46,1603,332,741,0,6,332,735,207,254,142,300,442,86,34,17,112,112,871,PF
2005,31,63,1731,115,257,0,0,115,257,74,107,111,220,331,34,23,158,56,183,304,C
2005,32,58,928,133,234,0,0,133,234,73,85,49,135,184,26,13,40,49,130,339,C
2005,25,75,2848,625,1418,104,293,521,1125,369,432,72,240,312,172,63,8,133,152,1723,SG
2005,23,23,121,15,29,0,3,15,26,11,15,8,8,16,10,3,1,5,12,41,SF
2005,22,19,132,10,30,0,0,10,30,1,4,13,25,38,1,3,7,9,35,21,C
2005,24,72,2724,610,1368,125,370,485,998,214,309,125,299,424,281,105,32,169,156,1559,SG
2005,24,79,2839,407,1045,226,631,181,414,136,184,91,388,479,158,96,27,102,197,1176,SG
2005,23,82,2571,299,739,67,178,232,561,159,180,55,149,204,483,94,23,149,185,824,PG
2005,24,31,328,36,81,3,8,33,73,18,26,14,34,48,30,11,4,20,42,93,SG
2005,38,42,1090,141,354,42,127,99,227,35,58,31,83,114,74,44,39,41,107,359,C
2005,38,29,599,61,169,25,66,36,103,27,39,23,72,95,30,18,14,25,74,174,PF
2005,32,9,157,34,77,2,6,32,71,20,23,4,20,24,8,4,3,7,19,90,SF
2005,33,30,882,109,289,25,92,84,197,32,42,28,114,142,60,19,12,66,103,275,SF
2005,33,28,485,63,161,23,76,40,85,20,28,33,71,104,26,22,8,20,69,169,PF
2005,32,81,2710,527,1159,108,274,419,885,333,390,44,232,276,209,63,10,180,190,1495,SF
2005,30,76,1475,198,441,1,10,197,431,137,186,129,212,341,59,46,16,102,208,534,PF
2005,30,50,862,124,267,0,4,124,263,69,99,95,132,227,41,31,9,56,124,317,PF
2005,30,26,613,74,174,1,6,73,168,68,87,34,80,114,18,15,7,46,84,217,PF
2005,23,78,1659,161,373,1,4,160,369,74,110,59,151,210,109,51,22,54,165,397,SG
2005,28,79,1262,41,99,0,1,41,98,29,67,157,175,332,64,43,41,44,193,111,C
2005,24,48,968,157,406,51,137,106,269,37,48,20,69,89,68,20,7,47,74,402,SG
2005,24,14,91,4,20,2,10,2,10,2,2,3,7,10,3,2,1,3,7,12,SG
2005,24,34,877,153,386,49,127,104,259,35,46,17,62,79,65,18,6,44,67,390,SG
2005,34,70,1026,95,252,56,149,39,103,61,77,50,122,172,72,44,11,35,130,307,SF
2005,25,58,993,85,210,31,91,54,119,35,48,12,109,121,114,40,13,51,92,236,SG
2005,21,23,329,28,62,0,0,28,62,23,39,36,86,122,8,4,17,17,53,79,PF
2005,28,11,105,7,21,0,0,7,21,8,11,6,13,19,1,3,4,4,28,22,C
2005,26,54,1167,132,332,22,68,110,264,53,69,83,161,244,88,34,18,66,111,339,PF
2005,28,16,128,17,42,2,8,15,34,13,24,18,20,38,12,2,3,8,16,49,SF
2005,19,19,104,10,23,0,0,10,23,6,11,6,12,18,2,1,5,12,21,26,C
2005,27,9,30,5,11,0,0,5,11,2,4,1,1,2,3,0,0,1,3,12,PF
2005,24,75,2799,474,1017,50,115,424,902,231,273,128,318,446,205,106,16,135,227,1229,SF
2005,28,24,246,22,57,0,1,22,56,5,17,23,39,62,5,5,6,13,29,49,PF
2005,28,25,695,82,148,0,0,82,148,20,53,84,134,218,38,26,43,27,73,184,C
2005,24,8,78,13,39,2,12,11,27,0,2,6,8,14,3,5,0,8,20,28,SG
2005,21,38,433,44,113,6,22,38,91,33,48,19,33,52,39,23,5,25,50,127,SG
2005,19,76,1859,295,748,81,281,214,467,111,161,39,113,152,142,55,11,109,135,782,SG
2005,27,45,648,62,148,1,2,61,146,41,55,29,82,111,38,25,14,39,103,166,PF
2005,29,74,2265,319,621,0,1,319,620,175,228,179,362,541,67,43,38,79,222,813,PF
2005,19,74,2050,274,602,4,23,270,579,163,237,147,310,457,127,59,144,135,157,715,SF
2005,35,50,750,102,248,41,105,61,143,69,80,15,50,65,71,14,7,27,82,314,SG
2005,35,37,636,93,218,38,90,55,128,67,77,13,36,49,57,12,7,24,74,291,SG
2005,35,13,114,9,30,3,15,6,15,2,3,2,14,16,14,2,0,3,8,23,SG
2005,24,33,510,44,136,3,12,41,124,14,16,39,77,116,28,6,4,27,58,105,SF
2005,31,81,1844,125,327,13,45,112,282,59,80,37,118,155,317,67,16,89,189,322,SG
2005,21,68,906,122,328,30,85,92,243,64,96,50,71,121,36,26,19,58,116,338,SG
2005,26,81,1668,257,488,0,3,257,485,94,111,125,219,344,114,51,18,70,206,608,PF
2005,23,27,255,23,58,0,0,23,58,16,27,18,39,57,2,12,4,10,46,62,C
2005,34,80,2450,398,961,69,211,329,750,156,188,65,189,254,179,53,21,127,124,1021,SF
2005,30,56,1617,274,662,32,120,242,542,253,298,38,145,183,127,53,10,106,104,833,SG
2005,23,55,1089,174,426,25,67,149,359,56,101,38,64,102,69,16,9,57,73,429,SG
2005,29,12,145,11,21,0,0,11,21,3,7,21,19,40,5,6,5,6,32,25,PF
2005,27,66,2534,451,1016,174,433,277,583,253,275,62,223,285,138,79,12,102,157,1329,SF
2005,27,9,32,3,10,1,2,2,8,1,2,4,1,5,1,0,0,0,3,8,SG
2005,31,81,2762,457,1165,181,490,276,675,182,199,56,254,310,458,86,2,164,158,1277,PG
2005,22,80,2889,747,1336,3,16,744,1320,583,795,219,494,713,131,77,130,189,278,2080,C
2005,31,62,1014,114,304,21,83,93,221,52,64,11,92,103,115,30,1,64,103,301,SG
2005,38,16,196,9,43,1,2,8,41,9,10,3,24,27,39,3,2,16,15,28,PG
2005,24,21,73,11,37,1,3,10,34,2,2,6,7,13,2,2,2,6,16,25,C
2005,31,61,1922,215,504,55,155,160,349,141,188,79,258,337,317,65,7,147,168,626,PG
2005,22,77,1509,237,446,0,1,237,445,176,235,169,249,418,44,27,28,108,224,650,C
2005,19,16,72,5,11,0,0,5,11,5,9,1,4,5,2,1,7,4,16,15,C
2005,25,60,1279,219,488,0,4,219,484,166,219,92,181,273,43,41,92,90,182,604,PF
2005,27,81,2558,465,919,63,169,402,750,260,304,82,221,303,191,40,16,132,178,1253,SF
2005,24,4,17,1,6,1,1,0,5,4,4,2,2,4,3,0,0,1,1,7,PG
2005,28,38,905,127,292,3,8,124,284,39,60,41,123,164,53,16,12,63,123,296,PF
2005,28,27,431,76,154,0,1,76,153,24,43,26,67,93,14,11,8,31,57,176,C
2005,19,68,1330,169,430,17,69,152,361,105,133,10,94,104,224,35,4,125,120,460,PG
2005,27,80,2401,372,743,103,245,269,498,146,173,38,150,188,429,109,15,147,177,993,PG
2005,29,25,356,34,94,17,56,17,38,7,9,7,29,36,17,14,1,9,29,92,SF
2005,26,47,976,128,255,0,0,128,255,76,144,85,159,244,20,17,51,50,133,332,C
2005,24,11,117,12,20,0,0,12,20,2,6,17,20,37,4,4,4,7,13,26,PF
2005,24,9,112,11,18,0,0,11,18,2,6,15,20,35,4,4,4,7,12,24,PF
2005,24,2,5,1,2,0,0,1,2,0,0,2,0,2,0,0,0,0,1,2,PF
2005,29,44,521,42,86,0,0,42,86,27,46,39,58,97,17,15,13,18,82,111,C
2005,27,73,2167,367,781,1,5,366,776,173,227,184,351,535,152,67,17,131,227,908,PF
2005,27,47,1344,217,476,1,4,216,472,95,119,106,202,308,77,40,6,83,151,530,PF
2005,27,26,823,150,305,0,1,150,304,78,108,78,149,227,75,27,11,48,76,378,PF
2005,32,80,2855,424,901,2,4,422,897,66,84,170,661,831,160,70,79,99,310,916,PF
2005,27,71,1940,315,718,85,208,230,510,136,173,45,192,237,110,41,17,113,222,851,SF
2005,26,40,1301,218,522,58,156,160,366,122,164,26,134,160,257,81,12,134,112,616,PG
2005,27,74,1327,177,399,0,8,177,391,55,102,136,196,332,61,54,50,73,215,409,C
2005,25,31,278,32,64,0,0,32,64,14,18,21,35,56,10,3,16,12,42,78,C
2005,21,35,220,22,74,2,17,20,57,4,7,12,29,41,10,8,11,19,33,50,PF
2005,21,23,158,15,51,0,7,15,44,4,7,11,18,29,4,8,8,14,24,34,PF
2005,21,12,62,7,23,2,10,5,13,0,0,1,11,12,6,0,3,5,9,16,PF
2005,25,67,1757,328,782,93,245,235,537,188,225,62,171,233,153,41,18,119,140,937,SF
2005,22,80,1149,173,390,58,142,115,248,67,89,16,67,83,150,41,10,77,96,471,PG
2005,33,53,1619,214,561,100,257,114,304,58,74,20,141,161,227,44,0,92,70,586,SG
2005,29,33,818,128,285,30,78,98,207,56,65,55,110,165,41,21,11,47,82,342,SF
2005,29,29,684,129,279,24,64,105,215,72,92,34,95,129,34,15,10,34,88,354,PF
2005,22,54,863,99,193,0,2,99,191,68,127,109,148,257,27,41,38,26,122,266,PF
2005,29,71,1410,146,325,5,15,141,310,76,91,17,90,107,135,41,1,62,138,373,SG
2005,27,38,360,27,59,0,0,27,59,26,38,30,62,92,17,4,11,20,60,80,C
2005,23,10,57,6,16,0,0,6,16,4,7,5,8,13,7,3,2,7,11,16,PF
2005,23,36,648,76,183,0,3,76,180,44,68,59,103,162,33,22,17,57,94,196,C
2005,20,35,403,33,117,17,63,16,54,18,19,13,49,62,51,12,2,15,41,101,SG
2005,23,77,2974,630,1318,13,45,617,1273,581,762,110,287,397,520,121,82,321,230,1854,SG
2005,21,11,102,18,55,5,26,13,29,3,4,0,2,2,13,5,0,9,15,44,SG
2005,28,77,2955,581,1377,110,341,471,1036,201,373,182,513,695,265,89,58,253,217,1473,PF
2005,28,53,2128,420,1013,85,268,335,745,157,294,126,371,497,194,64,32,183,147,1082,PF
2005,28,24,827,161,364,25,73,136,291,44,79,56,142,198,71,25,26,70,70,391,PF
2005,28,14,134,11,31,0,0,11,31,2,3,8,10,18,4,3,7,8,25,24,PF
2005,30,74,2671,295,651,1,9,294,642,130,304,292,610,902,123,106,176,82,159,721,C
2005,22,70,2147,286,637,17,62,269,575,191,289,118,268,386,137,117,91,159,182,780,SF
2005,30,79,2687,467,1062,75,236,392,826,136,195,174,470,644,142,65,115,127,236,1145,PF
2005,24,61,768,74,180,16,61,58,119,34,48,55,87,142,93,26,11,58,70,198,SF
2005,34,14,360,24,77,16,51,8,26,11,13,6,33,39,43,15,0,18,22,75,PG
2005,25,80,1808,236,554,52,163,184,391,91,138,35,129,164,359,83,19,167,184,615,PG
2005,34,40,525,47,114,0,0,47,114,29,35,35,87,122,17,9,6,15,74,123,PF
2005,31,67,2370,555,1283,15,44,540,1239,181,228,130,482,612,318,94,53,182,214,1306,PF
2005,31,46,1668,412,917,11,29,401,888,143,179,94,353,447,252,68,34,133,144,978,PF
2005,31,21,702,143,366,4,15,139,351,38,49,36,129,165,66,26,19,49,70,328,PF
2005,28,69,1489,272,617,36,104,236,513,141,188,49,180,229,80,85,27,90,165,721,SG
2005,25,55,1125,137,320,32,99,105,221,109,141,20,119,139,84,39,5,58,105,415,SG
2005,25,16,192,12,51,2,11,10,40,20,28,6,22,28,19,5,0,15,16,46,SF
2005,34,80,2774,334,840,118,315,216,525,162,189,38,190,228,265,96,9,113,215,948,SG
2005,34,26,934,133,342,28,80,105,262,67,76,12,73,85,109,35,1,54,65,361,SG
2005,34,54,1840,201,498,90,235,111,263,95,113,26,117,143,156,61,8,59,150,587,SG
2005,24,30,552,75,172,2,5,73,167,34,50,40,89,129,23,12,16,37,62,186,SF
2005,21,39,507,66,155,24,67,42,88,19,27,14,51,65,53,21,8,24,69,175,SG
2005,28,17,135,14,31,0,0,14,31,14,40,11,23,34,1,2,12,11,31,42,C
2005,24,58,677,121,289,24,60,97,229,27,44,24,65,89,44,32,11,37,64,293,SF
2005,24,42,531,98,227,19,44,79,183,21,34,20,54,74,36,30,10,27,51,236,SF
2005,24,16,146,23,62,5,16,18,46,6,10,4,11,15,8,2,1,10,13,57,SF
2005,22,54,1005,169,329,0,0,169,329,88,144,63,165,228,38,26,24,77,129,426,C
2005,25,29,520,73,168,16,59,57,109,21,34,29,37,66,26,22,10,16,55,183,SF
2005,25,48,278,32,77,5,16,27,61,12,16,4,21,25,33,14,1,14,26,81,PG
2005,33,42,315,29,63,0,0,29,63,15,17,17,43,60,8,5,8,17,70,73,C
2005,33,19,150,14,27,0,0,14,27,9,10,7,24,31,6,4,5,11,25,37,C
2005,33,23,165,15,36,0,0,15,36,6,7,10,19,29,2,1,3,6,45,36,C
2005,32,55,1322,142,330,28,73,114,257,112,161,44,128,172,92,38,4,60,147,424,SG
2005,32,21,739,87,185,17,40,70,145,74,108,28,67,95,42,16,2,34,80,265,SG
2005,32,34,583,55,145,11,33,44,112,38,53,16,61,77,50,22,2,26,67,159,SG
2005,24,9,71,3,20,0,4,3,16,0,0,2,4,6,11,2,3,3,9,6,SG
2005,29,71,1952,266,644,107,330,159,314,80,101,19,103,122,399,75,5,130,91,719,PG
2005,31,79,1211,122,243,0,5,122,238,115,172,115,168,283,41,55,10,65,155,359,SF
2005,22,80,2254,323,737,32,99,291,638,136,160,50,194,244,484,74,11,196,221,814,PG
2005,36,19,152,12,41,0,1,12,40,9,11,15,15,30,8,4,6,5,30,33,C
2005,31,72,1527,273,584,0,2,273,582,195,244,104,155,259,78,38,15,86,218,741,PF
2005,31,48,1056,194,417,0,2,194,415,130,165,73,105,178,43,26,12,60,144,518,PF
2005,31,24,471,79,167,0,0,79,167,65,79,31,50,81,35,12,3,26,74,223,PF
2005,42,29,344,35,90,0,2,35,88,17,23,29,47,76,9,8,7,15,53,87,C
2005,26,45,712,71,164,0,1,71,163,34,59,81,139,220,17,8,39,37,78,176,C
2005,23,3,40,5,12,0,0,5,12,0,0,2,4,6,0,4,0,2,6,10,SF
2005,25,7,291,59,119,7,17,52,102,47,51,8,37,45,22,12,6,17,27,172,SF
2005,19,3,27,3,11,0,4,3,7,1,1,0,1,1,3,4,0,3,2,7,SF
2005,29,80,2287,320,683,0,3,320,680,131,198,177,436,613,87,58,69,100,251,771,C
2005,27,20,92,17,36,2,3,15,33,7,12,6,12,18,5,3,2,5,9,43,C
2006,29,72,1961,332,632,5,22,327,610,218,278,106,251,357,149,48,42,108,227,887,PF
2006,23,5,35,4,16,1,5,3,11,0,0,1,4,5,4,1,0,4,4,9,SG
2006,27,54,701,121,247,1,1,120,246,23,38,44,96,140,20,14,16,34,92,266,PF
2006,30,78,3022,681,1500,269,653,412,847,324,359,71,261,332,286,105,16,188,151,1955,SG
2006,24,51,978,129,274,11,34,118,240,100,134,32,79,111,67,51,18,67,126,369,PG
2006,29,63,2431,280,738,102,312,178,426,99,143,36,219,255,425,101,15,157,194,761,PG
2006,27,32,570,56,98,0,0,56,98,49,103,61,94,155,6,8,41,26,84,161,C
2006,23,36,564,75,181,24,58,51,123,33,41,23,47,70,32,11,4,32,48,207,SF
2006,31,43,1047,108,303,40,134,68,169,93,111,21,122,143,101,23,6,54,98,349,SG
2006,31,20,582,68,173,19,67,49,106,61,73,12,71,83,53,15,4,37,49,216,SG
2006,31,23,465,40,130,21,67,19,63,32,38,9,51,60,48,8,2,17,49,133,SG
2006,32,48,638,54,126,5,19,49,107,13,18,18,63,81,30,17,6,24,75,126,SF
2006,19,6,9,0,1,0,0,0,1,0,0,1,3,4,0,2,0,0,1,0,C
2006,21,80,2941,756,1572,37,152,719,1420,573,709,122,272,394,216,88,42,218,229,2122,SF
2006,25,52,601,53,145,0,1,53,144,15,28,43,101,144,15,24,6,42,104,121,C
2006,24,80,3384,746,1668,199,540,547,1128,655,799,59,221,280,484,161,25,297,286,2346,PG
2006,20,57,999,93,226,1,5,92,221,77,127,78,140,218,61,57,11,62,100,264,SF
2006,20,36,709,61,146,1,3,60,143,42,77,49,88,137,46,43,9,46,78,165,SF
2006,20,21,290,32,80,0,2,32,78,35,50,29,52,81,15,14,2,16,22,99,SF
2006,37,62,622,43,128,11,48,32,80,33,42,18,63,81,86,27,3,58,71,130,PG
2006,26,50,600,57,157,2,6,55,151,42,58,24,46,70,155,19,3,45,77,158,PG
2006,26,27,594,111,221,5,14,106,207,64,79,9,51,60,77,19,1,38,42,291,SG
2006,31,28,552,66,174,33,92,33,82,22,31,12,33,45,69,14,0,30,58,187,SG
2006,31,43,1161,160,399,64,182,96,217,107,132,11,64,75,129,29,2,57,94,491,PG
2006,37,36,385,25,73,0,0,25,73,21,30,18,35,53,23,12,6,11,40,71,SF
2006,34,8,85,7,15,0,0,7,15,13,18,2,17,19,4,4,4,9,13,27,C
2006,24,58,1497,219,468,22,63,197,405,118,147,23,112,135,220,54,11,119,162,578,PG
2006,24,18,269,33,80,6,19,27,61,27,30,4,15,19,32,7,0,23,38,99,PG
2006,24,40,1228,186,388,16,44,170,344,91,117,19,97,116,188,47,11,96,124,479,PG
2006,23,57,1592,273,567,87,196,186,371,111,147,31,119,150,158,48,6,89,145,744,SG
2006,25,6,93,11,30,1,4,10,26,3,4,7,17,24,6,4,0,6,8,26,SF
2006,25,50,538,59,110,2,11,57,99,29,43,41,56,97,22,16,7,24,92,149,PF
2006,23,19,282,38,104,2,14,36,90,9,12,9,16,25,52,10,0,15,13,87,PG
2006,23,2,21,3,7,0,1,3,6,3,3,1,2,3,2,0,0,1,1,9,PG
2006,23,17,261,35,97,2,13,33,84,6,9,8,14,22,50,10,0,14,12,78,PG
2006,24,8,45,5,16,0,0,5,16,3,4,2,8,10,0,0,0,5,10,13,C
2006,34,74,1259,156,345,80,202,76,143,39,59,29,130,159,123,39,27,52,99,431,SG
2006,36,20,342,25,65,12,32,13,33,24,29,1,30,31,26,13,1,22,25,86,SG
2006,22,19,141,15,37,1,7,14,30,8,10,7,21,28,8,9,2,9,17,39,SF
2006,20,29,268,28,70,0,0,28,70,12,19,18,50,68,3,3,7,11,18,68,PF
2006,22,57,495,34,80,0,1,34,79,33,53,61,83,144,7,15,11,38,111,101,PF
2006,29,82,2215,280,552,0,6,280,546,89,134,145,312,457,49,46,69,88,250,649,C
2006,27,81,2839,303,621,65,165,238,456,147,208,164,265,429,136,92,114,90,223,818,SF
2006,27,23,281,33,72,0,0,33,72,16,19,38,46,84,2,9,7,13,48,82,C
2006,27,18,119,12,32,0,0,12,32,12,16,7,26,33,2,2,1,7,8,36,PF
2006,26,59,1283,180,410,71,168,109,242,63,89,21,99,120,130,59,5,41,126,494,SG
2006,29,79,2959,425,930,197,446,228,484,115,146,44,209,253,207,76,22,89,248,1162,SG
2006,25,2,21,4,5,0,0,4,5,2,2,0,4,4,2,0,1,0,2,10,SF
2006,27,82,3167,597,1382,192,497,405,885,342,403,29,211,240,444,82,10,199,169,1728,PG
2006,19,68,1000,118,185,0,0,118,185,22,72,124,159,283,24,23,47,34,190,258,C
2006,29,81,2925,423,1012,184,425,239,587,465,520,41,211,252,699,71,8,170,160,1495,PG
2006,25,68,1781,206,470,76,184,130,286,72,91,26,120,146,306,42,5,83,107,560,PG
2006,19,29,175,26,67,3,13,23,54,10,12,12,26,38,10,5,7,12,36,65,PF
2006,30,81,2240,373,734,0,0,373,734,168,222,96,269,365,99,40,76,194,254,914,C
2006,30,39,1083,194,380,0,0,194,380,97,127,36,126,162,66,15,36,120,107,485,C
2006,30,42,1157,179,354,0,0,179,354,71,95,60,143,203,33,25,40,74,147,429,C
2006,25,39,848,114,288,33,98,81,190,80,105,29,77,106,45,39,3,41,78,341,SG
2006,25,33,1064,101,256,32,102,69,154,47,81,26,123,149,83,32,6,49,89,281,SF
2006,21,82,2348,323,606,0,3,323,603,122,194,189,384,573,192,49,68,125,259,768,PF
2006,25,78,1710,209,467,102,243,107,224,63,76,86,198,284,56,49,31,32,216,583,PF
2006,29,33,250,20,47,1,2,19,45,5,9,19,33,52,12,9,9,8,44,46,C
2006,24,33,1025,219,399,0,0,219,399,99,137,73,212,285,88,30,8,69,105,537,PF
2006,21,70,2751,549,1087,0,13,549,1074,474,581,204,443,647,181,50,79,157,209,1572,C
2006,34,82,2755,232,536,104,245,128,291,51,84,35,285,320,126,79,30,67,191,619,SF
2006,30,68,652,37,124,3,22,34,102,11,14,31,57,88,24,21,6,13,85,88,SF
2006,29,60,1542,271,661,62,179,209,482,152,174,21,60,81,230,48,4,83,73,756,PG
2006,26,46,367,32,79,1,5,31,74,2,3,40,67,107,17,5,7,19,39,67,PF
2006,26,79,3099,756,1435,1,3,755,1432,440,568,236,554,790,208,81,201,173,227,1953,PF
2006,26,79,2165,409,791,0,2,409,789,164,224,181,259,440,45,19,32,85,227,982,C
2006,27,81,1711,207,527,39,118,168,409,158,212,73,134,207,104,44,14,99,153,611,SG
2006,23,72,1978,204,388,0,1,204,387,128,235,182,291,473,72,27,46,100,196,536,C
2006,36,75,2380,269,583,0,0,269,583,139,168,182,365,547,90,46,50,90,216,677,C
2006,33,27,246,21,54,5,13,16,41,7,12,1,21,22,35,8,1,22,22,54,PG
2006,33,4,31,5,8,0,1,5,7,0,0,0,2,2,2,0,0,3,1,10,PG
2006,33,23,215,16,46,5,12,11,34,7,12,1,19,20,33,8,1,19,21,44,PG
2006,27,80,3277,978,2173,180,518,798,1655,696,819,71,354,425,360,147,30,250,233,2832,SG
2006,29,73,1758,181,417,86,243,95,174,43,55,31,178,209,127,87,20,52,180,491,SG
2006,32,42,346,63,127,2,7,61,120,13,21,21,52,73,16,6,13,33,62,141,C
2006,25,57,570,51,144,1,6,50,138,10,23,4,33,37,76,20,0,36,45,113,PG
2006,26,39,340,22,88,10,54,12,34,16,17,4,22,26,48,26,2,25,63,70,PG
2006,25,75,2708,494,1086,41,120,453,966,289,332,114,352,466,186,127,18,175,238,1318,SF
2006,20,55,740,117,215,0,0,117,215,58,77,67,116,183,25,17,31,62,127,292,C
2006,26,79,1875,257,633,92,242,165,391,79,114,51,181,232,40,33,45,65,142,685,SF
2006,18,46,338,33,82,0,0,33,82,8,27,34,46,80,9,4,22,17,56,74,C
2006,23,15,162,21,52,2,9,19,43,10,16,3,9,12,19,7,0,14,10,54,PG
2006,24,61,505,67,174,5,20,62,154,60,84,37,74,111,20,13,7,35,87,199,PF
2006,24,64,1487,132,312,7,43,125,269,78,92,30,111,141,288,42,4,101,93,349,SG
2006,31,56,1857,302,649,1,11,301,638,111,156,132,536,668,115,79,184,92,158,716,C
2006,28,36,402,46,111,13,29,33,82,19,27,11,44,55,33,23,0,27,65,124,PF
2006,25,78,1275,192,476,72,185,120,291,138,168,34,123,157,35,47,11,48,120,594,SG
2006,30,45,589,53,137,4,15,49,122,40,55,9,53,62,101,24,9,40,71,150,PG
2006,29,79,2906,653,1518,125,367,528,1151,480,601,135,327,462,338,94,53,213,235,1911,SG
2006,36,78,2653,493,1112,70,190,423,922,289,335,40,247,287,491,74,11,175,225,1345,PG
2006,31,27,333,36,84,0,0,36,84,26,35,20,50,70,4,6,12,18,52,98,C
2006,31,23,299,31,72,0,0,31,72,26,35,19,44,63,2,6,10,16,48,88,C
2006,31,4,34,5,12,0,0,5,12,0,0,1,6,7,2,0,2,2,4,10,C
2006,23,79,2121,160,283,0,1,160,282,97,193,265,449,714,81,41,104,123,298,417,C
2006,34,42,448,42,108,0,8,42,100,8,8,20,41,61,19,13,2,17,38,92,SF
2006,22,74,2249,278,504,32,65,246,439,154,201,134,253,387,131,86,39,101,184,742,SF
2006,35,7,185,9,26,0,1,9,25,8,12,2,11,13,14,9,1,6,10,26,SG
2006,27,71,2019,304,736,17,63,287,673,246,320,39,154,193,339,108,6,154,177,871,PG
2006,28,27,230,25,71,4,16,21,55,19,24,2,12,14,42,3,2,14,30,73,PG
2006,27,79,1730,129,280,0,0,129,280,157,219,134,199,333,97,36,27,61,252,415,C
2006,27,71,1895,104,262,3,12,101,250,44,86,93,249,342,70,46,40,61,251,255,C
2006,25,66,1448,207,394,0,3,207,391,79,113,143,225,368,74,21,35,77,213,493,PF
2006,25,81,1535,261,511,36,84,225,427,84,101,88,186,274,74,37,32,61,205,642,PF
2006,25,79,2555,366,879,101,293,265,586,295,357,36,212,248,301,87,15,175,150,1128,SG
2006,30,50,1148,132,285,54,140,78,145,90,102,62,203,265,62,22,7,48,105,408,PF
2006,23,72,1865,336,597,0,0,336,597,307,486,145,287,432,19,28,56,179,239,979,C
2006,24,66,1761,196,369,0,1,196,368,93,132,159,382,541,25,34,160,107,244,485,C
2006,30,82,1934,171,347,0,0,171,347,127,215,273,367,640,51,27,106,115,263,469,C
2006,30,80,2283,230,550,23,101,207,449,284,336,19,153,172,284,52,8,89,96,767,SG
2006,25,62,1766,246,512,4,19,242,493,138,183,81,143,224,172,67,13,100,143,634,SG
2006,37,36,749,68,159,0,1,68,158,45,61,75,97,172,14,20,9,43,99,181,PF
2006,37,8,191,14,31,0,0,14,31,7,20,15,21,36,7,3,1,8,26,35,C
2006,26,54,1971,335,861,102,324,233,537,195,289,45,191,236,480,89,14,159,165,967,PG
2006,36,28,178,9,24,0,1,9,23,8,15,21,32,53,6,0,9,4,23,26,C
2006,25,6,17,2,7,0,2,2,5,2,3,3,1,4,1,2,0,1,3,6,PF
2006,25,4,12,1,4,0,1,1,3,0,0,2,1,3,1,1,0,1,2,2,PF
2006,25,1,5,1,3,0,1,1,2,2,3,1,0,1,0,1,0,0,0,4,PF
2006,26,42,1747,329,709,40,125,289,584,129,164,40,147,187,221,49,9,115,91,827,SG
2006,26,36,1460,255,595,33,117,222,478,146,181,25,139,164,173,42,8,98,99,689,SF
2006,23,68,726,91,226,20,60,71,166,45,67,28,85,113,44,21,15,36,86,247,SG
2006,32,1,7,0,1,0,0,0,1,2,2,1,1,2,0,0,0,0,0,2,SG
2006,32,23,378,71,160,20,47,51,113,18,25,13,38,51,33,13,1,19,28,180,PG
2006,20,78,2604,442,954,21,78,421,876,207,276,127,389,516,147,72,50,105,128,1112,SF
2006,23,81,2874,449,853,8,30,441,823,174,238,159,399,558,503,58,85,189,260,1080,PF
2006,27,19,234,17,46,10,20,7,26,18,18,5,11,16,40,11,1,18,40,62,PG
2006,23,23,246,29,69,25,57,4,12,5,6,4,17,21,16,7,0,10,22,88,PG
2006,22,69,1031,175,334,0,0,175,334,136,168,95,134,229,29,15,30,78,164,486,PF
2006,24,81,1510,75,154,1,2,74,152,39,72,145,229,374,23,44,146,36,253,190,C
2006,27,76,1920,357,821,65,170,292,651,156,194,30,147,177,149,58,6,113,157,935,SG
2006,28,31,371,37,88,0,0,37,88,24,30,23,62,85,8,10,7,14,45,98,C
2006,25,50,1137,178,405,13,43,165,362,101,121,11,67,78,109,49,4,82,116,470,PG
2006,23,74,2155,215,538,100,278,115,260,117,143,28,192,220,373,70,3,117,152,647,PG
2006,29,80,2784,574,1185,2,5,572,1180,335,533,231,650,881,253,70,162,198,219,1485,PF
2006,25,81,2578,331,816,74,260,257,556,196,252,78,321,399,237,60,32,120,199,932,SF
2006,25,36,265,33,63,0,1,33,62,14,41,21,28,49,14,12,0,14,44,80,SF
2006,24,40,296,31,64,0,0,31,64,8,11,18,30,48,5,3,15,12,76,70,C
2006,33,32,394,34,103,13,42,21,61,20,24,3,30,33,69,11,2,21,34,101,PG
2006,33,13,112,4,17,1,4,3,13,0,0,1,13,14,25,3,0,3,11,9,PG
2006,33,19,282,30,86,12,38,18,48,20,24,2,17,19,44,8,2,18,23,92,PG
2006,20,49,886,132,318,28,82,104,236,42,59,22,83,105,78,32,11,58,69,334,SG
2006,29,72,1579,151,284,1,5,150,279,49,74,99,240,339,47,54,45,65,211,352,C
2006,27,57,1348,216,425,0,2,216,423,128,192,94,183,277,76,29,44,100,160,560,PF
2006,27,80,1139,154,341,43,116,111,225,52,65,76,87,163,60,41,15,39,122,403,SG
2006,25,67,1393,131,268,0,1,131,267,115,217,171,331,502,38,40,10,85,166,377,PF
2006,25,41,788,88,173,0,1,88,172,66,120,114,162,276,23,24,5,41,95,242,PF
2006,25,26,605,43,95,0,0,43,95,49,97,57,169,226,15,16,5,44,71,135,PF
2006,22,66,971,97,255,22,78,75,177,36,46,23,62,85,84,37,6,57,86,252,SG
2006,24,12,82,6,25,1,3,5,22,5,8,3,10,13,2,2,3,8,13,18,SF
2006,21,80,2406,345,883,97,271,248,612,161,222,77,188,265,446,102,8,182,181,948,PG
2006,32,77,2038,286,695,110,279,176,416,98,115,31,216,247,116,37,7,62,97,780,SG
2006,31,82,2589,364,887,117,295,247,592,244,293,36,175,211,352,125,8,156,237,1089,PG
2006,23,18,239,30,89,7,26,23,63,17,23,7,23,30,33,7,5,15,28,84,PG
2006,27,3,39,9,17,1,1,8,16,1,2,1,6,7,1,0,0,2,5,20,PF
2006,24,3,13,2,3,0,0,2,3,0,0,1,2,3,0,0,1,2,7,4,PF
2006,22,72,2557,328,789,35,104,293,685,187,248,63,248,311,473,104,7,219,196,878,PG
2006,29,23,276,27,51,0,0,27,51,33,43,31,47,78,2,4,2,26,76,87,C
2006,29,63,1581,138,250,0,4,138,246,96,159,224,350,574,50,41,27,64,191,372,C
2006,30,77,1824,152,300,0,0,152,300,41,67,143,281,424,33,44,125,80,215,345,C
2006,28,33,342,39,100,23,70,16,30,7,10,3,30,33,21,4,2,8,30,108,SG
2006,28,25,225,24,65,15,48,9,17,3,5,3,20,23,15,3,2,4,22,66,SG
2006,28,8,117,15,35,8,22,7,13,4,5,0,10,10,6,1,0,4,8,42,SG
2006,28,46,1734,249,575,18,70,231,505,231,290,60,159,219,262,51,11,156,142,747,PG
2006,28,24,659,84,190,7,13,77,177,83,109,14,57,71,83,23,6,58,62,258,SG
2006,22,65,1572,305,640,3,9,302,631,189,229,138,236,374,53,30,47,97,200,802,C
2006,27,74,885,171,309,0,1,171,308,41,89,91,141,232,24,25,43,35,171,383,C
2006,25,12,54,6,12,0,2,6,10,1,4,0,0,0,3,1,0,1,1,13,PG
2006,24,67,1301,130,325,39,137,91,188,78,101,39,146,185,94,41,47,75,135,377,SF
2006,29,76,2957,626,1191,8,30,618,1161,396,489,214,752,966,308,104,107,180,206,1656,PF
2006,29,57,938,101,242,50,129,51,113,30,37,31,77,108,38,12,9,38,108,282,PF
2006,25,80,3135,600,1194,3,12,597,1182,425,617,191,522,713,371,46,153,235,184,1628,PF
2006,28,71,1542,170,425,50,160,120,265,58,86,82,192,274,68,66,34,54,159,448,SF
2006,27,41,122,10,45,7,23,3,22,18,23,0,15,15,12,11,1,9,13,45,PG
2006,28,65,1813,309,669,83,217,226,452,280,360,42,188,230,235,101,26,121,156,981,SG
2006,28,37,956,166,383,18,59,148,324,43,57,15,55,70,63,16,4,63,87,393,SG
2006,34,3,22,1,7,0,2,1,5,0,0,0,1,1,2,0,0,1,0,2,PG
2006,23,61,1376,173,355,3,9,170,346,112,149,102,196,298,58,35,5,55,83,461,PF
2006,24,79,2174,334,652,1,3,333,649,176,258,237,428,665,56,52,49,106,190,845,PF
2006,22,80,2482,486,1152,166,382,320,770,211,268,43,176,219,240,75,5,180,238,1349,SG
2006,23,80,1581,198,414,29,87,169,327,108,133,57,187,244,60,37,13,92,228,533,SF
2006,23,22,175,21,54,2,10,19,44,14,15,5,22,27,7,5,2,13,31,58,SG
2006,23,6,38,6,16,1,5,5,11,4,4,1,6,7,3,2,0,5,5,17,SG
2006,23,3,20,1,5,1,4,0,1,2,2,0,3,3,1,0,0,1,3,5,SG
2006,23,13,117,14,33,0,1,14,32,8,9,4,13,17,3,3,2,7,23,36,SG
2006,22,78,1765,221,478,30,93,191,385,115,148,131,253,384,90,58,62,80,211,587,SF
2006,33,21,248,27,65,0,0,27,65,7,8,11,46,57,7,5,3,7,45,61,C
2006,23,27,135,6,28,0,2,6,26,13,21,10,14,24,7,3,0,5,13,25,SG
2006,20,32,374,66,138,6,20,60,118,29,37,10,31,41,18,13,4,22,41,167,SG
2006,24,10,153,28,66,10,19,18,47,4,5,1,14,15,5,2,0,12,13,70,SG
2006,23,80,1235,100,253,9,40,91,213,45,68,37,108,145,129,77,10,109,181,254,PG
2006,31,52,1245,98,204,0,2,98,202,41,53,75,152,227,89,51,9,39,113,237,SG
2006,23,70,1359,130,370,16,82,114,288,44,74,107,282,389,40,13,148,43,125,320,C
2006,26,12,108,19,38,5,15,14,23,9,14,1,16,17,9,7,0,9,14,52,SG
2006,27,80,2825,649,1322,55,120,594,1202,256,303,84,172,256,275,52,16,173,207,1609,SG
2006,30,12,49,7,14,0,0,7,14,12,18,3,8,11,0,4,0,6,5,26,C
2006,30,11,46,7,13,0,0,7,13,11,16,3,8,11,0,3,0,6,4,25,C
2006,30,1,3,0,1,0,0,0,1,1,2,0,0,0,0,1,0,0,1,1,C
2006,34,4,72,4,14,0,1,4,13,2,2,0,10,10,8,2,0,6,7,10,SF
2006,29,71,1944,322,678,14,39,308,639,227,313,158,210,368,98,59,14,109,202,885,SF
2006,25,76,2782,551,1220,66,191,485,1029,243,350,132,391,523,238,85,14,195,301,1411,PF
2006,32,72,824,135,273,0,0,135,273,77,123,54,100,154,39,7,13,61,131,347,C
2006,22,56,1275,190,405,5,21,185,384,169,236,26,99,125,177,53,16,84,121,554,PG
2006,23,67,1034,148,294,0,0,148,294,89,174,84,170,254,14,23,59,79,193,385,C
2006,27,66,818,86,221,9,31,77,190,37,56,12,59,71,70,31,5,43,85,218,PG
2006,25,81,2491,300,591,0,2,300,589,157,199,167,467,634,95,50,17,80,216,757,PF
2006,26,77,2514,286,616,7,23,279,593,131,176,82,134,216,203,43,29,124,201,710,SG
2006,22,40,535,59,105,0,1,59,104,29,45,67,112,179,14,26,14,12,76,147,PF
2006,24,21,516,77,183,17,47,60,136,25,30,19,57,76,27,16,1,22,38,196,SG
2006,26,79,1879,222,432,0,0,222,432,131,224,200,267,467,46,30,104,97,232,575,C
2006,23,80,2310,254,630,113,313,141,317,86,123,33,233,266,215,89,9,119,169,707,SG
2006,33,51,531,47,91,0,0,47,91,33,49,60,77,137,10,9,12,22,58,127,C
2006,23,1,3,0,1,0,0,0,1,0,0,0,0,0,0,0,0,2,1,0,PF
2006,33,21,613,119,243,2,8,117,235,78,102,15,65,80,48,24,6,35,50,318,SF
2006,25,81,2955,451,1078,126,341,325,737,256,314,29,259,288,514,94,21,188,251,1284,PG
2006,22,14,33,5,13,0,0,5,13,3,8,5,2,7,6,2,0,8,7,13,SG
2006,26,4,11,1,1,0,0,1,1,0,0,1,0,1,0,0,0,0,2,2,SF
2006,35,63,1182,112,292,53,144,59,148,44,68,71,171,242,79,43,51,41,115,321,PF
2006,27,81,1421,320,759,123,316,197,443,33,41,15,117,132,148,42,12,76,96,796,PG
2006,20,82,3021,468,881,0,2,468,879,356,598,288,734,1022,125,65,115,217,277,1292,PF
2006,25,59,1915,350,743,27,63,323,680,196,267,123,248,371,111,68,26,79,167,923,SF
2006,32,80,2537,394,859,0,4,394,855,154,191,168,367,535,112,49,8,133,235,942,PF
2006,29,36,800,127,333,40,101,87,232,48,52,8,36,44,106,12,4,40,55,342,PG
2006,27,36,1281,192,469,28,76,164,393,146,193,26,135,161,131,53,21,99,117,558,SG
2006,20,62,619,77,203,0,5,77,198,34,65,56,101,157,30,23,16,31,82,188,PF
2006,35,30,353,37,100,11,43,26,57,2,4,10,30,40,62,19,1,20,44,87,PG
2006,24,69,1312,175,291,0,0,175,291,71,138,110,161,271,17,12,76,64,120,421,C
2006,22,82,3086,344,688,56,158,288,530,263,349,117,364,481,255,135,21,153,198,1007,SF
2006,30,78,2283,450,889,0,5,450,884,317,380,245,346,591,91,38,136,155,280,1217,C
2006,25,43,237,32,60,0,1,32,59,10,20,19,37,56,2,6,25,16,47,74,C
2006,30,72,3103,815,1822,72,223,743,1599,675,829,44,188,232,532,140,10,248,121,2377,PG
2006,24,73,978,116,264,4,10,112,254,24,33,31,65,96,74,24,7,23,147,260,PG
2006,22,79,1599,189,428,20,76,169,352,128,160,18,142,160,219,41,2,102,138,526,SG
2006,32,71,1775,286,748,129,332,157,416,107,146,44,179,223,195,61,1,101,155,808,PG
2006,29,30,202,11,26,1,4,10,22,12,14,8,19,27,25,4,1,13,19,35,PG
2006,35,40,512,47,160,18,74,29,86,9,13,11,65,76,35,12,6,35,51,121,SF
2006,35,27,420,38,129,14,63,24,66,9,13,11,53,64,31,10,6,30,46,99,SF
2006,35,13,92,9,31,4,11,5,20,0,0,0,12,12,4,2,0,5,5,22,SF
2006,24,36,315,29,85,12,36,17,49,26,33,16,24,40,25,11,2,31,30,96,SF
2006,31,64,1027,174,369,1,2,173,367,66,82,86,131,217,44,13,8,65,126,415,C
2006,31,37,433,66,148,0,0,66,148,38,48,30,59,89,22,5,6,28,70,170,C
2006,31,27,594,108,221,1,2,107,219,28,34,56,72,128,22,8,2,37,56,245,C
2006,27,81,2910,472,1148,117,339,355,809,268,341,48,264,312,225,104,43,203,195,1329,SG
2006,30,45,406,56,121,0,0,56,121,25,40,39,52,91,12,3,23,51,104,137,C
2006,21,79,3361,875,1823,127,379,748,1444,601,814,75,481,556,521,123,66,260,181,2478,SF
2006,30,79,2925,576,1228,169,382,407,846,283,338,45,217,262,460,72,3,206,214,1604,PG
2006,29,82,3288,660,1494,147,373,513,1121,217,297,167,598,765,158,90,12,137,189,1684,SF
2006,27,75,2102,226,566,40,133,186,433,95,138,60,173,233,293,108,21,127,189,587,PG
2006,29,75,1557,170,429,86,236,84,193,121,133,19,134,153,227,40,4,116,108,547,PG
2006,21,59,1062,189,379,0,4,189,375,86,134,97,202,299,30,30,46,62,166,464,PF
2006,25,78,3059,495,1005,60,188,435,817,471,580,95,439,534,297,59,17,174,193,1521,SF
2006,24,77,1951,187,415,16,50,171,365,99,168,164,215,379,148,58,50,99,223,489,PF
2006,18,3,39,7,10,2,3,5,7,4,4,3,1,4,3,0,2,4,7,20,SF
2006,31,75,1981,267,603,51,155,216,448,106,141,31,137,168,324,63,22,115,132,691,PG
2006,25,58,924,132,306,56,160,76,146,34,42,19,77,96,55,25,26,46,86,354,SG
2006,38,18,81,7,17,0,0,7,17,1,2,5,19,24,2,1,2,5,23,15,C
2006,24,82,3340,632,1395,128,360,504,1035,261,330,98,237,335,536,103,31,267,187,1653,SG
2006,25,36,524,61,149,13,36,48,113,18,27,40,82,122,14,12,12,28,61,153,SF
2006,25,9,35,5,10,0,0,5,10,1,4,0,7,7,2,2,0,4,7,11,SF
2006,25,27,489,56,139,13,36,43,103,17,23,40,75,115,12,10,12,24,54,142,SF
2006,25,71,967,109,263,3,21,106,242,60,93,20,84,104,39,38,15,50,108,281,SF
2006,29,82,2089,190,491,140,371,50,120,32,50,14,119,133,169,37,1,55,112,552,PG
2006,22,14,87,4,10,0,0,4,10,6,13,10,21,31,2,1,3,3,14,14,PF
2006,34,75,2437,292,722,133,374,159,348,168,215,35,244,279,177,131,27,93,201,885,SG
2006,26,68,1837,233,559,63,187,170,372,122,160,18,152,170,154,55,20,107,142,651,SG
2006,25,75,1772,243,581,110,285,133,296,103,121,44,209,253,57,38,49,35,142,699,SF
2006,26,76,2089,298,736,115,335,183,401,88,121,105,271,376,63,68,22,74,200,799,PF
2006,23,78,2560,369,706,0,2,369,704,194,252,187,563,750,79,45,108,176,269,932,C
2006,24,51,665,79,177,21,53,58,124,28,33,12,59,71,37,7,3,20,89,207,SF
2006,25,28,213,31,69,0,0,31,69,18,23,24,36,60,3,2,3,15,69,80,C
2006,23,69,1492,158,342,10,30,148,312,77,111,114,193,307,88,50,29,84,209,403,SF
2006,32,80,2975,366,905,139,395,227,510,194,244,86,494,580,672,150,29,192,157,1065,PG
2006,24,69,2604,336,730,36,117,300,613,346,495,161,391,552,299,102,220,203,162,1054,SF
2006,21,61,519,77,173,2,13,75,160,57,81,38,78,116,15,10,13,16,87,213,PF
2006,30,69,2351,308,772,3,13,305,759,252,314,35,188,223,610,157,4,164,202,871,PG
2006,18,24,127,9,30,2,7,7,23,7,10,5,8,13,9,3,0,6,11,27,SF
2006,24,82,2563,327,761,184,438,143,323,101,119,27,243,270,163,65,26,98,224,939,SF
2006,22,80,2469,447,881,1,4,446,877,185,265,182,331,513,88,32,63,133,297,1080,PF
2006,37,65,1018,116,298,45,147,71,151,40,56,26,124,150,139,33,17,66,87,317,PF
2006,29,82,2033,238,552,112,286,126,266,51,75,80,326,406,115,29,72,65,273,639,PF
2006,20,6,28,2,11,0,0,2,11,0,2,4,5,9,2,0,0,3,2,4,C
2006,20,2,16,0,4,0,0,0,4,0,0,1,3,4,2,0,0,1,2,0,C
2006,20,4,12,2,7,0,0,2,7,0,2,3,2,5,0,0,0,2,0,4,C
2006,22,67,1129,137,230,0,0,137,230,71,123,109,194,303,43,30,20,51,124,345,SF
2006,32,26,458,75,191,25,78,50,113,16,31,5,42,47,41,21,4,31,39,191,SG
2006,32,12,238,42,103,10,35,32,68,5,13,2,26,28,18,8,2,11,21,99,SG
2006,32,14,220,33,88,15,43,18,45,11,18,3,16,19,23,13,2,20,18,92,SG
2006,26,78,2876,538,1151,142,370,396,781,350,428,111,279,390,182,102,50,141,191,1568,SF
2006,30,5,22,0,2,0,0,0,2,0,0,1,3,4,1,1,0,1,6,0,PG
2006,20,61,1525,149,349,1,8,148,341,53,77,41,142,183,273,46,32,111,160,352,PG
2006,23,13,107,14,36,2,9,12,27,0,0,2,3,5,12,5,0,7,6,30,PG
2006,28,51,1234,192,418,58,127,134,291,118,138,13,69,82,157,26,3,75,113,560,PG
2006,26,19,135,14,41,3,12,11,29,13,15,3,7,10,5,7,0,8,10,44,SG
2006,30,62,676,27,66,0,7,27,59,20,47,50,91,141,11,23,17,26,114,74,C
2006,26,32,943,167,375,24,71,143,304,212,256,28,141,169,66,19,4,78,95,570,SF
2006,27,82,2465,287,615,0,0,287,615,178,333,220,558,778,56,29,80,166,276,752,C
2006,28,60,2193,349,774,33,104,316,670,246,326,25,150,175,382,63,4,157,143,977,PG
2006,27,81,3263,716,1365,96,290,620,1075,241,298,249,710,959,143,160,137,125,223,1769,PF
2006,30,25,181,37,71,0,3,37,68,7,12,12,31,43,7,5,7,7,21,81,PF
2006,32,81,2077,265,671,128,395,137,276,92,123,105,387,492,60,59,41,90,160,750,PF
2006,23,23,241,24,60,1,3,23,57,22,29,8,23,31,10,8,7,15,17,71,SF
2006,34,40,339,34,97,16,40,18,57,18,24,2,18,20,57,17,0,15,42,102,PG
2006,28,56,1546,297,600,5,22,292,578,121,170,93,260,353,79,43,52,72,171,720,PF
2006,22,72,1913,262,546,66,179,196,367,188,222,58,203,261,97,55,9,81,138,778,SG
2006,28,70,2102,275,690,1,6,274,684,206,302,64,234,298,66,42,17,113,136,757,SF
2006,22,26,159,23,54,0,0,23,54,14,42,12,16,28,3,4,5,11,14,60,PF
2006,21,23,398,70,171,0,5,70,166,49,64,42,67,109,22,17,12,33,58,189,PF
2006,21,79,1362,241,535,67,180,174,355,78,106,29,114,143,63,44,22,86,176,627,SG
2006,31,36,353,33,99,10,45,23,54,12,21,15,53,68,23,8,5,19,52,88,SF
2006,31,82,1733,285,560,0,2,285,558,68,122,156,280,436,90,46,48,76,220,638,PF
2006,26,47,1745,410,1011,73,234,337,777,254,340,46,261,307,225,59,41,120,88,1147,SF
2006,31,28,486,63,143,3,16,60,127,20,29,11,39,50,52,11,2,29,37,149,SG
2006,33,14,121,3,12,0,2,3,10,1,2,3,17,20,11,5,0,2,7,7,PG
2006,26,66,1232,120,340,24,82,96,258,106,133,11,67,78,151,42,9,76,131,370,PG
2006,26,2,6,1,2,0,0,1,2,0,0,0,0,0,1,0,0,0,1,2,PF
2006,26,59,1541,230,459,0,0,230,459,144,201,137,236,373,61,16,73,83,214,604,C
2006,22,19,118,6,18,0,0,6,18,4,4,0,14,14,24,4,1,11,13,16,PG
2006,18,23,203,28,76,5,20,23,56,18,24,18,20,38,16,7,2,9,20,79,PG
2006,24,40,1286,235,510,2,10,233,500,87,163,24,158,182,73,42,39,99,100,559,SF
2006,20,55,767,119,234,0,2,119,232,28,50,44,107,151,41,14,77,51,92,266,C
2006,20,25,140,17,33,0,2,17,31,3,8,10,18,28,9,3,15,15,25,37,C
2006,20,30,627,102,201,0,0,102,201,25,42,34,89,123,32,11,62,36,67,229,C
2006,29,82,2937,404,872,5,27,399,845,313,424,92,259,351,674,106,18,256,213,1126,PG
2006,29,79,2923,434,877,34,88,400,789,280,338,122,493,615,374,61,62,180,234,1182,C
2006,25,74,2268,354,760,138,339,216,421,168,210,42,355,397,200,52,27,140,173,1014,SG
2006,25,57,1949,467,900,0,1,467,899,337,395,148,433,581,85,30,94,147,195,1271,C
2006,30,79,2979,429,1008,83,245,346,763,229,273,50,291,341,238,93,36,145,208,1170,SF
2006,28,80,1389,190,377,0,0,190,377,113,144,163,255,418,40,21,49,91,220,493,C
2006,22,26,343,29,87,9,34,20,53,10,14,11,41,52,19,7,5,12,41,77,SF
2006,22,23,336,29,85,9,33,20,52,8,12,11,40,51,19,6,5,12,41,75,SF
2006,22,3,7,0,2,0,1,0,1,2,2,0,1,1,0,1,0,0,0,2,SF
2006,30,47,583,54,124,0,2,54,122,46,62,44,86,130,27,7,15,40,92,154,C
2006,27,22,192,16,49,0,2,16,47,3,3,6,32,38,4,6,5,7,19,35,SF
2006,35,65,1302,188,315,0,1,188,314,133,224,125,234,359,11,13,173,79,177,509,C
2006,25,74,2516,363,838,58,181,305,657,251,319,195,548,743,101,47,26,108,191,1035,PF
2006,32,57,576,72,181,27,78,45,103,25,40,29,103,132,13,17,7,22,66,196,SF
2006,26,76,2112,321,768,37,141,284,627,172,242,33,120,153,197,68,11,135,133,851,SG
2006,26,48,1085,179,451,17,76,162,375,99,138,18,68,86,120,30,4,79,69,474,SG
2006,26,28,1027,142,317,20,65,122,252,73,104,15,52,67,77,38,7,56,64,377,SG
2006,39,64,955,50,95,0,0,50,95,69,91,100,206,306,4,17,57,35,128,169,C
2006,28,23,152,22,53,0,1,22,52,6,9,15,22,37,7,2,5,6,23,50,C
2006,25,25,405,42,124,17,57,25,67,25,36,4,45,49,22,13,5,20,52,126,PF
2006,25,11,97,12,32,2,14,10,18,5,8,4,7,11,5,3,0,4,13,31,SF
2006,30,22,237,40,80,0,0,40,80,13,15,23,19,42,7,8,4,10,32,93,PF
2006,29,64,1449,127,301,4,12,123,289,89,114,128,197,325,52,53,34,54,165,347,PF
2006,31,79,2796,541,1056,150,342,391,714,257,279,47,286,333,826,61,12,276,120,1489,PG
2006,23,62,1784,347,719,70,165,277,554,141,181,39,141,180,302,70,9,148,174,905,PG
2006,29,80,1515,172,334,0,2,172,332,18,30,114,195,309,33,21,88,53,209,362,C
2006,31,36,353,17,57,3,13,14,44,11,16,21,35,56,9,5,10,12,47,48,SG
2006,26,82,2239,383,831,93,238,290,593,204,242,89,411,500,117,40,52,120,252,1063,PF
2006,32,45,424,46,112,4,14,42,98,29,42,12,42,54,50,20,1,33,49,125,PG
2006,32,29,241,26,65,0,5,26,60,13,17,9,25,34,29,14,1,16,31,65,PG
2006,32,16,183,20,47,4,9,16,38,16,25,3,17,20,21,6,0,17,18,60,PG
2006,27,81,3089,751,1564,110,271,641,1293,539,598,115,613,728,226,58,83,156,164,2151,PF
2006,27,51,1802,380,805,3,10,377,795,261,368,102,374,476,133,27,117,151,177,1024,PF
2006,33,59,1806,480,800,0,0,480,800,221,471,172,369,541,113,23,104,168,230,1181,C
2006,30,59,490,44,93,0,2,44,91,15,27,57,66,123,27,9,11,28,91,103,C
2006,26,80,3221,445,925,80,215,365,710,216,313,181,557,738,443,75,64,213,256,1186,PF
2006,23,26,874,131,316,0,0,131,316,82,125,94,167,261,31,22,50,53,88,344,PF
2006,26,82,2945,519,1128,80,234,439,894,354,454,211,535,746,194,40,73,163,285,1472,PF
2006,33,70,1069,75,174,1,3,74,171,41,49,13,85,98,101,33,3,29,103,192,SG
2006,30,48,919,107,240,0,0,107,240,24,47,50,170,220,23,22,33,55,122,238,C
2006,30,32,752,87,195,0,0,87,195,19,39,45,134,179,17,19,27,41,100,193,C
2006,30,16,167,20,45,0,0,20,45,5,8,5,36,41,6,3,6,14,22,45,C
2006,32,60,807,61,124,0,0,61,124,24,48,82,143,225,58,6,66,46,129,146,C
2006,34,32,355,35,58,0,0,35,58,5,8,31,46,77,14,10,12,17,50,75,PF
2006,21,69,1153,162,368,14,53,148,315,62,89,48,141,189,34,31,46,37,112,400,PF
2006,25,23,210,27,74,3,16,24,58,12,18,11,10,21,8,5,0,13,25,69,PG
2006,21,78,2452,307,681,0,2,307,679,297,404,264,349,613,129,89,39,180,286,911,C
2006,29,62,718,71,201,42,121,29,80,27,34,56,109,165,41,28,12,21,90,211,PF
2006,27,71,1376,171,403,1,16,170,387,98,150,17,117,134,190,47,14,110,125,441,PG
2006,26,57,646,109,292,39,103,70,189,17,21,8,53,61,94,24,2,61,57,274,PG
2006,24,82,2773,348,779,120,328,228,451,125,180,37,234,271,302,140,16,147,213,941,PG
2006,23,80,2715,623,1136,11,36,612,1100,253,358,38,223,261,460,83,4,249,161,1510,PG
2006,30,45,1056,188,379,0,7,188,372,138,226,73,81,154,60,42,12,82,79,514,SF
2006,30,26,736,139,256,1,6,138,250,65,112,45,45,90,67,34,9,68,71,344,SG
2006,20,78,2808,407,947,50,177,357,770,394,465,61,339,400,611,175,6,183,218,1258,PG
2006,22,53,813,87,212,35,96,52,116,32,49,16,64,80,25,19,6,42,103,241,SG
2006,37,81,2305,230,547,66,230,164,317,100,126,34,199,233,257,71,10,102,169,626,PG
2006,21,68,1332,137,266,0,2,137,264,80,130,140,264,404,69,21,105,107,199,354,C
2006,28,82,3140,478,1096,177,448,301,648,241,294,65,316,381,190,104,15,126,223,1374,SG
2006,20,68,1282,153,300,0,0,153,300,47,75,109,187,296,15,25,51,60,213,353,C
2006,35,29,228,24,61,9,33,15,28,2,5,4,19,23,13,6,1,11,20,59,SG
2006,28,79,3084,689,1462,111,314,578,1148,627,812,77,453,530,375,107,34,273,223,2116,SF
2006,23,52,1179,169,418,56,176,113,242,87,143,58,105,163,44,33,10,78,132,481,SF
2006,23,56,596,66,183,13,56,53,127,46,66,14,60,74,53,20,4,43,91,191,PG
2006,21,1,18,0,2,0,0,0,2,3,6,0,7,7,0,0,1,2,0,3,C
2006,30,45,771,70,154,0,0,70,154,29,38,73,145,218,24,37,20,26,115,169,C
2006,29,67,1914,159,395,117,290,42,105,48,61,33,286,319,89,54,20,58,196,483,SF
2006,30,33,353,37,71,0,0,37,71,10,17,27,37,64,9,2,2,16,50,84,C
2006,30,24,321,32,64,0,0,32,64,10,17,26,36,62,7,2,2,14,44,74,C
2006,30,9,32,5,7,0,0,5,7,0,0,1,1,2,2,0,0,2,6,10,C
2006,23,37,429,37,81,0,0,37,81,36,45,28,53,81,9,7,4,22,52,110,PF
2006,22,29,150,21,58,6,27,15,31,12,12,5,10,15,11,6,0,10,10,60,PG
2006,25,82,2898,455,999,64,183,391,816,182,238,104,242,346,186,62,39,91,96,1156,SF
2006,28,25,279,40,84,3,18,37,66,21,24,8,35,43,15,11,5,24,25,104,SG
2006,26,56,1395,131,239,0,0,131,239,82,154,146,245,391,43,20,130,76,149,344,C
2006,25,77,1974,262,643,138,354,124,289,93,114,64,294,358,136,61,29,93,210,755,PF
2006,25,47,1089,154,384,72,196,82,188,55,62,39,148,187,72,32,15,53,130,435,PF
2006,25,30,885,108,259,66,158,42,101,38,52,25,146,171,64,29,14,40,80,320,PF
2006,22,57,487,44,97,0,0,44,97,43,71,55,78,133,19,19,12,21,83,131,PF
2006,24,74,2545,536,1229,16,55,520,1174,245,343,193,399,592,144,57,14,165,185,1333,PF
2006,32,55,1301,108,189,0,0,108,189,54,83,89,190,279,28,18,88,47,143,270,C
2006,33,29,412,52,96,0,0,52,96,31,41,13,51,64,9,5,19,24,59,135,C
2006,26,80,3130,682,1516,163,413,519,1103,501,571,78,264,342,229,95,5,170,157,2028,SG
2006,24,72,997,119,295,0,1,119,294,87,120,53,71,124,41,23,15,52,163,325,SF
2006,24,32,291,25,74,0,0,25,74,25,40,13,16,29,7,5,4,15,45,75,SF
2006,24,40,706,94,221,0,1,94,220,62,80,40,55,95,34,18,11,37,118,250,SF
2006,25,75,2877,641,1438,183,477,458,961,276,410,105,333,438,232,97,37,167,206,1741,SG
2006,25,55,1442,163,459,64,188,99,271,61,91,65,165,230,88,39,6,56,134,451,SF
2006,24,79,2625,334,799,43,149,291,650,199,227,47,188,235,550,123,22,162,178,910,PG
2006,22,16,88,14,31,5,10,9,21,2,2,0,6,6,5,1,0,3,6,35,PG
2006,23,33,181,20,44,0,2,20,42,11,23,26,23,49,5,8,2,5,30,51,C
2006,25,66,1303,157,365,2,21,155,344,106,134,62,157,219,77,81,10,74,141,422,SF
2006,39,80,1863,219,513,60,175,159,338,52,79,55,212,267,89,44,40,62,206,550,PF
2006,21,72,1544,230,565,58,146,172,419,152,202,56,111,167,147,59,1,114,201,670,PG
2006,33,46,1236,180,446,31,115,149,331,166,217,15,114,129,113,20,10,65,101,557,SF
2006,33,26,747,110,239,28,57,82,182,82,101,13,69,82,68,10,3,50,55,330,SG
2006,31,72,1119,105,281,1,1,104,280,107,137,84,175,259,67,43,14,80,145,318,PF
2006,24,67,1515,130,308,0,7,130,301,57,75,38,132,170,79,51,16,47,155,317,SG
2006,29,76,1010,34,77,0,2,34,75,37,74,122,149,271,27,33,31,38,179,105,C
2006,25,47,1111,181,469,57,164,124,305,55,77,18,85,103,50,38,13,65,79,474,SG
2006,26,82,2059,219,521,26,87,193,434,155,200,48,172,220,223,73,13,125,178,619,SG
2006,22,12,39,5,7,0,0,5,7,0,2,5,13,18,5,0,4,0,5,10,PF
2006,25,16,113,16,33,2,3,14,30,7,10,4,19,23,3,5,0,8,20,41,SG
2006,27,71,938,74,193,31,87,43,106,26,36,27,87,114,51,21,19,50,127,205,PF
2006,23,20,149,16,26,0,0,16,26,4,13,8,21,29,7,1,3,5,21,36,C
2006,20,27,212,18,31,0,0,18,31,8,17,14,35,49,1,3,8,14,41,44,C
2006,22,43,414,58,120,0,0,58,120,30,34,38,50,88,7,13,1,24,70,146,PF
2006,25,75,2538,366,808,105,250,261,558,165,200,91,242,333,172,86,21,123,254,1002,SF
2006,24,59,753,77,151,10,20,67,131,39,50,63,134,197,29,19,21,28,95,203,SF
2006,29,38,429,38,69,0,0,38,69,12,27,30,71,101,17,11,20,18,54,88,PF
2006,29,27,515,44,91,0,0,44,91,15,29,46,81,127,13,14,23,27,65,103,C
2006,30,22,210,30,72,15,38,15,34,5,8,3,13,16,9,5,6,4,28,80,SG
2006,30,21,208,30,71,15,37,15,34,5,8,3,13,16,9,5,6,4,27,80,SG
2006,22,23,127,15,27,2,4,13,23,6,12,3,11,14,9,8,0,4,20,38,SG
2006,20,55,989,144,366,52,140,92,226,83,101,19,91,110,58,37,4,54,90,423,SG
2006,30,44,887,145,305,0,2,145,303,89,115,83,147,230,31,24,13,40,120,379,PF
2006,20,80,2559,329,774,34,110,295,664,210,292,176,355,531,191,64,208,162,260,902,SF
2006,32,82,2351,163,399,1,10,162,389,64,93,38,160,198,346,76,19,116,218,391,PG
2006,22,68,1310,205,453,46,129,159,324,86,117,55,106,161,102,29,23,70,106,542,SG
2006,27,62,1329,236,491,2,5,234,486,94,115,76,170,246,88,35,16,85,157,568,PF
2006,24,42,590,53,123,0,0,53,123,41,57,54,92,146,8,21,19,30,118,147,C
2006,31,55,1525,242,603,36,130,206,473,195,221,32,121,153,160,37,10,121,96,715,SG
2006,24,82,2648,359,781,2,15,357,766,180,242,59,182,241,160,58,17,123,178,900,SG
2006,28,71,2601,445,1018,162,404,283,614,238,260,79,336,415,136,45,10,103,171,1290,SF
2006,28,31,1147,171,424,71,179,100,245,98,105,34,131,165,68,19,2,51,82,511,SF
2006,28,40,1454,274,594,91,225,183,369,140,155,45,205,250,68,26,8,52,89,779,SF
2006,28,25,116,16,41,3,7,13,34,8,14,8,14,22,4,3,1,5,22,43,SF
2006,32,27,862,114,287,36,104,78,183,53,62,23,72,95,128,19,1,55,49,317,PG
2006,23,61,1236,204,492,82,216,122,276,99,110,12,104,116,75,27,3,82,118,589,SG
2006,23,3,50,9,27,0,1,9,26,8,9,6,10,16,2,1,3,1,4,26,C
2006,23,66,1222,200,444,0,0,200,444,133,204,118,232,350,59,19,56,95,209,533,C
2006,20,47,987,124,241,0,0,124,241,53,91,94,170,264,8,15,56,49,142,301,C
2006,26,66,1344,225,458,0,2,225,456,136,209,103,188,291,25,38,50,91,198,586,C
2006,28,72,2729,493,1012,102,255,391,757,278,310,77,236,313,213,40,19,136,150,1366,SF
2006,28,40,1555,292,590,58,143,234,447,163,182,36,154,190,112,21,15,86,90,805,SF
2006,28,32,1174,201,422,44,112,157,310,115,128,41,82,123,101,19,4,50,60,561,SF
2006,20,17,144,23,38,0,0,23,38,1,6,19,17,36,2,2,7,2,25,47,C
2006,23,51,465,53,136,4,17,49,119,30,43,16,37,53,45,30,4,34,47,140,SG
2006,29,67,1210,182,389,0,1,182,388,58,83,65,164,229,53,21,14,103,177,422,PF
2006,20,68,1641,228,578,57,162,171,416,130,175,19,101,120,247,66,6,115,167,643,PG
2006,28,80,2798,516,1099,171,416,345,683,168,210,31,127,158,306,100,27,135,196,1371,PG
2006,30,17,131,13,40,10,30,3,10,2,2,5,9,14,9,10,1,6,19,38,SG
2006,27,71,1121,131,246,0,0,131,246,75,125,99,180,279,14,20,68,51,148,337,C
2006,25,22,150,10,19,0,0,10,19,8,14,12,27,39,1,0,3,7,35,28,PF
2006,25,15,124,7,13,0,0,7,13,8,14,8,23,31,1,0,3,7,32,22,PF
2006,25,7,26,3,6,0,0,3,6,0,0,4,4,8,0,0,0,0,3,6,PF
2006,30,16,127,6,15,0,0,6,15,3,4,10,10,20,2,3,2,8,17,15,C
2006,30,3,25,2,2,0,0,2,2,0,0,0,0,0,1,0,1,2,3,4,C
2006,30,11,66,3,7,0,0,3,7,3,4,3,7,10,1,2,0,4,10,9,C
2006,30,2,36,1,6,0,0,1,6,0,0,7,3,10,0,1,1,2,4,2,C
2006,28,82,2293,305,604,0,1,305,603,138,204,199,419,618,168,72,39,135,196,748,PF
2006,33,53,1411,190,391,0,0,190,391,75,92,102,313,415,57,23,54,57,193,455,C
2006,28,3,32,6,16,1,6,5,10,0,0,0,4,4,2,0,1,1,1,13,SF
2006,28,26,634,107,246,45,105,62,141,28,42,22,105,127,18,16,6,32,77,287,PF
2006,22,10,43,11,25,4,11,7,14,2,2,4,7,11,1,3,1,2,6,28,SG
2006,27,42,1122,158,386,16,70,142,316,58,91,35,98,133,211,49,6,109,96,390,PG
2006,26,51,732,100,165,0,0,100,165,57,87,78,134,212,13,14,32,39,107,257,C
2006,22,5,13,1,4,0,0,1,4,1,2,0,2,2,0,0,0,2,0,3,PF
2006,22,12,86,12,33,1,3,11,30,8,12,9,11,20,3,1,2,4,8,33,SF
2006,23,23,161,15,30,0,0,15,30,15,27,11,26,37,8,3,10,7,30,45,C
2006,26,78,2615,398,877,114,283,284,594,255,296,70,263,333,216,70,21,130,234,1165,SF
2006,28,8,114,9,24,1,3,8,21,3,6,3,14,17,6,1,0,2,8,22,SF
2006,23,54,586,106,233,24,70,82,163,39,50,18,34,52,92,14,2,53,55,275,PG
2006,34,65,986,136,343,55,154,81,189,28,41,6,85,91,123,16,3,57,60,355,PG
2006,30,53,1090,164,387,50,136,114,251,94,113,54,138,192,37,31,11,71,121,472,SF
2006,23,48,760,79,150,0,1,79,149,61,119,77,158,235,19,31,19,27,118,219,C
2006,30,80,1234,107,245,1,6,106,239,59,81,16,75,91,123,42,1,52,140,274,SG
2006,21,81,2361,435,940,70,214,365,726,113,160,181,340,521,88,60,63,99,247,1053,PF
2006,28,51,818,114,261,1,3,113,258,41,60,62,121,183,39,26,23,33,157,270,C
2006,24,41,406,26,66,0,0,26,66,21,44,33,53,86,11,12,11,21,78,73,PF
2006,21,82,1449,108,312,59,172,49,140,46,52,33,126,159,139,48,3,50,150,321,PG
2006,24,75,2892,699,1413,13,76,686,1337,629,803,107,323,430,503,146,58,268,217,2040,SG
2006,20,16,73,6,38,2,17,4,21,6,8,5,3,8,4,3,0,1,12,20,SG
2006,29,82,2199,391,898,137,383,254,515,81,129,103,318,421,166,47,30,150,187,1000,PF
2006,29,7,22,0,2,0,0,0,2,2,2,0,3,3,0,0,1,2,7,2,PF
2006,31,82,2890,237,465,0,4,237,461,123,296,301,622,923,158,146,181,88,164,597,C
2006,23,55,1895,317,589,14,50,303,539,188,306,123,289,412,96,138,115,99,150,836,SF
2006,31,80,2780,459,1067,155,434,304,633,136,183,90,457,547,182,82,130,85,232,1209,PF
2006,23,2,3,1,1,0,0,1,1,0,2,0,0,0,0,0,0,1,0,2,SG
2006,25,69,1333,135,328,18,55,117,273,57,76,88,159,247,156,41,15,78,119,345,SF
2006,23,68,724,101,228,0,0,101,228,76,115,43,101,144,30,14,21,56,113,278,PF
2006,26,70,1578,219,509,110,272,109,237,75,111,24,134,158,289,68,10,136,159,623,PG
2006,26,46,975,121,282,68,172,53,110,37,59,17,69,86,160,37,7,75,95,347,PG
2006,26,24,603,98,227,42,100,56,127,38,52,7,65,72,129,31,3,61,64,276,PG
2006,32,75,2893,617,1422,21,77,596,1345,263,348,184,557,741,256,103,62,182,219,1518,PF
2006,19,61,1070,139,348,65,182,74,166,61,71,29,101,130,34,21,14,43,90,404,SF
2006,29,52,1684,284,613,10,45,274,568,129,190,142,259,401,144,94,25,126,156,707,SG
2006,26,58,866,86,222,14,49,72,173,65,87,22,89,111,62,34,1,41,65,251,SF
2006,35,71,2372,226,561,99,271,127,290,151,187,24,154,178,204,59,6,120,212,702,SG
2006,25,74,2526,530,1036,3,11,527,1025,199,236,168,380,548,92,61,64,105,214,1262,PF
2006,22,71,2418,333,684,84,218,249,466,86,101,57,232,289,329,84,46,133,197,836,PG
2006,23,23,212,23,57,0,0,23,57,3,6,16,27,43,17,7,8,14,41,49,C
2006,23,48,657,90,168,0,2,90,166,38,59,46,127,173,18,15,21,32,103,218,C
2006,23,29,872,167,282,0,0,167,282,74,94,72,165,237,34,18,13,40,80,408,PF
2006,26,82,1525,193,435,14,56,179,379,136,162,79,113,192,107,72,12,85,144,536,SF
2006,26,47,348,29,90,3,19,26,71,25,41,9,30,39,32,14,1,24,34,86,PG
2006,26,37,243,17,59,2,14,15,45,6,12,6,21,27,18,8,1,15,27,42,PG
2006,26,10,105,12,31,1,5,11,26,19,29,3,9,12,14,6,0,9,7,44,PG
2006,34,48,791,91,176,0,0,91,176,40,58,64,117,181,17,17,21,30,138,222,C
2006,34,14,99,10,19,0,0,10,19,5,6,5,10,15,1,4,3,5,28,25,C
2006,34,34,692,81,157,0,0,81,157,35,52,59,107,166,16,13,18,25,110,197,C
2006,31,1,10,0,3,0,2,0,1,1,2,0,3,3,0,0,0,0,0,1,PG
2006,21,80,2307,339,805,91,219,248,586,95,135,35,159,194,359,60,17,145,233,864,PG
2006,33,28,352,29,75,5,18,24,57,28,38,10,40,50,15,7,2,15,55,91,SF
2006,30,59,1874,268,606,107,288,161,318,85,98,6,133,139,287,53,5,100,101,728,PG
2006,19,30,145,23,52,2,9,21,43,8,13,3,16,19,10,5,0,13,13,56,PG
2006,19,79,1952,235,531,13,53,222,478,189,253,122,261,383,63,48,24,83,227,672,PF
2006,23,58,1531,267,629,73,191,194,438,96,113,30,113,143,230,52,7,105,146,703,PG
2006,32,37,362,43,103,2,2,41,101,38,49,21,46,67,14,7,4,30,56,126,SF
2006,27,27,324,28,59,0,1,28,58,6,14,44,66,110,4,9,23,16,49,62,C
2006,24,49,1013,129,254,22,60,107,194,49,76,44,146,190,47,32,13,61,96,329,SF
2006,26,56,2207,350,867,78,253,272,614,206,305,75,211,286,203,122,41,131,164,984,SF
2006,26,16,603,109,237,18,54,91,183,74,121,26,52,78,35,42,11,43,45,310,SF
2006,26,40,1604,241,630,60,199,181,431,132,184,49,159,208,168,80,30,88,119,674,SF
2006,21,39,370,29,81,1,15,28,66,11,22,8,22,30,12,4,3,21,42,70,SG
2006,21,7,135,21,51,6,17,15,34,14,16,3,15,18,5,1,0,8,8,62,SG
2006,20,20,132,20,43,3,6,17,37,15,17,2,30,32,8,3,1,14,12,58,SF
2006,30,78,1689,194,406,0,2,194,404,66,117,142,253,395,48,52,46,67,201,454,C
2006,24,2,32,2,3,0,0,2,3,0,0,1,3,4,7,0,0,4,4,4,PG
2007,30,80,2015,310,654,3,20,307,634,170,234,122,276,398,109,53,40,116,243,793,C
2007,22,61,495,75,135,0,1,75,134,24,36,35,42,77,13,17,4,22,47,174,SG
2007,22,32,214,22,70,5,15,17,55,20,33,1,20,21,7,4,3,15,27,69,SG
2007,21,63,1392,241,479,0,2,241,477,83,115,144,168,312,24,22,73,43,186,565,C
2007,28,60,638,107,258,0,1,107,257,28,34,42,77,119,16,17,16,21,85,242,PF
2007,31,55,2219,505,1153,165,443,340,710,279,309,57,190,247,228,82,11,154,113,1454,SG
2007,25,33,805,133,259,8,33,125,226,105,134,35,89,124,56,49,12,75,87,379,SG
2007,30,82,3040,383,1020,192,529,191,491,130,177,29,253,282,444,129,10,170,195,1088,PG
2007,24,11,89,6,15,0,0,6,15,4,10,13,15,28,1,1,8,5,15,16,PF
2007,24,10,87,6,15,0,0,6,15,4,10,13,15,28,1,1,8,5,15,16,PF
2007,24,17,256,37,81,5,20,32,61,19,23,11,21,32,21,7,0,22,33,98,SG
2007,32,50,1190,126,294,54,152,72,142,93,106,29,84,113,133,52,7,56,115,399,SF
2007,22,65,2486,691,1453,40,149,651,1304,459,568,143,248,391,249,77,23,234,203,1881,SF
2007,26,28,248,27,65,0,0,27,65,18,29,22,44,66,10,6,2,17,39,72,C
2007,25,74,2942,647,1548,205,584,442,964,606,718,61,277,338,443,139,13,236,249,2105,PG
2007,21,57,1278,200,371,0,7,200,364,106,171,98,151,249,65,59,19,84,134,506,SG
2007,38,81,1275,156,377,72,214,84,163,73,93,34,101,135,191,70,6,76,102,457,PG
2007,22,56,634,68,125,0,0,68,125,40,67,58,91,149,10,12,26,35,79,176,C
2007,27,72,1304,203,478,14,51,189,427,132,166,31,103,134,202,39,2,90,131,552,PG
2007,32,75,2064,310,715,116,306,194,409,252,311,18,121,139,346,50,4,127,136,988,PG
2007,22,2,7,1,3,0,0,1,3,0,0,1,2,3,2,0,0,0,2,2,PF
2007,23,41,669,98,220,34,79,64,141,61,78,26,68,94,28,22,10,39,49,291,SG
2007,22,68,1064,139,275,5,27,134,248,51,90,97,197,294,44,57,44,49,146,334,SF
2007,25,45,503,84,196,5,29,79,167,48,60,10,28,38,60,23,3,40,70,221,PG
2007,24,80,2613,529,1111,190,438,339,673,196,232,22,192,214,317,96,15,146,210,1444,SG
2007,22,33,191,28,78,6,21,22,57,16,24,7,18,25,24,1,1,14,19,78,PG
2007,21,65,1629,267,625,100,268,167,357,117,142,52,203,255,50,32,53,107,180,751,PF
2007,26,76,1813,275,628,106,290,169,338,90,123,91,259,350,156,73,41,105,188,746,PF
2007,24,6,29,4,8,0,0,4,8,0,0,1,4,5,7,0,0,4,4,8,PG
2007,25,28,203,24,83,0,1,24,82,17,18,19,22,41,5,6,4,11,21,65,C
2007,35,75,1631,202,425,128,287,74,138,103,117,17,143,160,138,56,12,61,88,635,SG
2007,21,21,162,15,44,0,1,15,43,12,16,13,30,43,3,2,3,10,16,42,PF
2007,31,47,405,49,76,3,7,46,69,37,47,21,53,74,16,12,18,32,65,138,PF
2007,23,13,81,8,16,0,0,8,16,4,7,7,23,30,4,3,0,4,13,20,PF
2007,30,66,1575,176,360,0,1,176,359,52,77,92,252,344,35,29,30,61,185,404,PF
2007,28,82,2988,292,654,157,373,135,281,88,113,67,271,338,175,79,60,72,190,829,SF
2007,27,82,2848,426,974,127,361,299,613,131,168,57,181,238,247,97,4,104,213,1110,SG
2007,30,78,2917,410,950,205,496,205,454,118,152,48,203,251,196,50,22,83,233,1143,SG
2007,28,82,2784,471,1166,173,481,298,685,288,347,39,224,263,388,88,6,197,139,1403,PG
2007,20,82,2382,348,581,0,0,348,581,87,167,251,511,762,88,67,136,119,304,783,C
2007,30,70,2533,348,815,109,316,239,499,386,437,23,214,237,502,84,17,140,161,1191,PG
2007,26,82,2225,209,509,67,208,142,301,43,64,21,148,169,408,61,8,129,121,528,PG
2007,26,33,583,45,129,19,68,26,61,11,20,7,38,45,84,10,3,28,49,120,PG
2007,26,49,1642,164,380,48,140,116,240,32,44,14,110,124,324,51,5,101,72,408,PG
2007,23,14,166,9,30,1,5,8,25,6,6,6,9,15,17,5,0,12,9,25,PG
2007,20,56,682,86,197,4,27,82,170,30,49,77,114,191,39,17,32,49,94,206,PF
2007,31,82,2544,427,839,9,31,418,808,147,195,136,369,505,67,43,58,159,239,1010,C
2007,26,59,990,99,245,53,137,46,108,47,63,16,77,93,59,28,2,46,98,298,SG
2007,22,66,2258,348,629,1,5,347,624,112,194,168,416,584,198,49,35,150,216,809,C
2007,26,56,653,106,237,36,94,70,143,27,38,64,92,156,22,17,11,25,67,275,PF
2007,22,61,669,99,171,0,0,99,171,56,103,64,112,176,10,11,21,33,94,254,PF
2007,30,44,380,31,66,1,2,30,64,6,10,27,54,81,18,4,29,9,71,69,C
2007,25,74,2557,647,1154,0,0,647,1154,255,372,235,632,867,221,70,21,194,217,1549,PF
2007,22,69,2658,543,1094,12,35,531,1059,463,590,186,555,741,175,39,90,179,163,1561,C
2007,35,82,2464,189,467,89,232,100,235,43,73,23,200,223,117,62,25,65,175,510,SF
2007,30,66,2031,323,769,95,239,228,530,220,245,49,90,139,291,56,2,120,92,961,PG
2007,30,31,877,156,378,41,110,115,268,119,131,23,40,63,132,25,2,52,31,472,PG
2007,30,35,1154,167,391,54,129,113,262,101,114,26,50,76,159,31,0,68,61,489,PG
2007,23,23,199,11,39,2,13,9,26,2,6,3,20,23,9,5,2,9,32,26,SG
2007,27,80,3077,645,1211,1,1,644,1210,351,461,268,476,744,235,77,179,202,238,1642,PF
2007,21,56,675,102,193,0,9,102,184,56,83,37,38,75,24,37,6,24,44,260,SG
2007,27,58,838,122,274,1,3,121,271,43,68,80,104,184,23,11,23,38,161,288,C
2007,25,38,271,42,74,0,1,42,73,9,15,26,48,74,2,6,4,29,26,93,PF
2007,22,49,450,32,98,6,28,26,70,24,37,8,32,40,83,22,7,31,51,94,PG
2007,28,58,1662,233,555,81,227,152,328,123,155,55,196,251,149,44,9,91,139,670,SG
2007,24,41,1132,143,242,0,1,143,241,59,134,81,163,244,75,39,49,76,124,345,C
2007,37,72,1456,170,418,0,2,170,416,96,122,129,218,347,48,24,52,85,187,436,PF
2007,21,23,202,28,74,7,25,21,49,10,14,6,15,21,10,7,3,14,24,73,SG
2007,28,77,3140,813,1757,137,398,676,1359,667,768,75,364,439,413,111,36,255,205,2430,SG
2007,30,76,1372,123,299,32,103,91,196,27,34,35,123,158,70,47,7,40,152,305,SG
2007,33,23,164,23,65,6,22,17,43,8,13,12,35,47,5,3,2,7,19,60,C
2007,26,63,2474,451,975,18,72,433,903,283,328,147,320,467,233,134,17,181,188,1203,SF
2007,21,11,103,16,35,0,0,16,35,9,10,6,16,22,5,2,0,10,16,41,C
2007,27,81,2223,314,788,134,363,180,425,56,87,42,214,256,63,40,54,67,148,818,SF
2007,19,82,1793,247,443,0,3,247,440,143,214,139,345,484,94,12,128,115,249,637,C
2007,25,77,1614,263,505,25,75,238,430,117,143,21,113,134,387,63,5,110,136,668,PG
2007,32,70,2369,312,659,0,2,312,657,161,221,164,652,816,223,87,231,122,183,785,C
2007,29,28,313,42,85,18,44,24,41,25,27,13,46,59,31,22,1,23,42,127,PF
2007,22,67,1169,182,392,25,72,157,320,53,87,39,89,128,26,38,23,43,118,442,SF
2007,26,72,1878,285,658,111,267,174,391,188,208,35,172,207,91,53,9,73,176,869,SG
2007,31,2,37,3,8,0,2,3,6,0,0,0,3,3,11,0,1,6,4,6,PG
2007,30,82,3126,726,1598,156,437,570,1161,462,576,114,378,492,393,82,30,217,266,2070,SG
2007,37,58,1407,261,625,32,109,229,516,160,182,27,140,167,270,28,8,101,126,714,PG
2007,32,18,95,7,22,0,0,7,22,8,12,12,19,31,0,3,10,6,10,22,C
2007,24,73,2525,292,468,0,1,292,467,106,201,320,584,904,66,37,129,126,244,690,C
2007,23,55,2024,261,518,26,77,235,441,167,210,123,217,340,127,58,36,80,118,715,SG
2007,36,7,82,5,17,1,6,4,11,2,3,3,8,11,8,3,1,5,11,13,SG
2007,28,42,1054,91,278,6,28,85,250,33,60,12,69,81,185,72,4,75,131,221,PG
2007,28,82,913,75,170,0,0,75,170,54,83,71,100,171,60,13,8,37,147,204,C
2007,28,80,1844,55,151,0,2,55,149,59,127,90,226,316,46,40,38,73,273,169,PF
2007,22,52,777,87,228,13,47,74,181,48,82,28,76,104,83,32,3,57,75,235,SF
2007,26,82,2378,318,636,0,2,318,634,154,199,229,437,666,82,48,66,123,289,790,C
2007,24,4,35,0,3,0,0,0,3,0,4,2,3,5,8,0,0,2,6,0,PG
2007,26,65,1018,185,408,46,115,139,293,34,47,61,154,215,65,25,27,51,134,450,PF
2007,26,59,2198,354,886,103,322,251,564,228,272,44,145,189,259,57,8,162,114,1039,SG
2007,31,61,727,78,222,26,91,52,131,45,52,33,153,186,44,14,6,33,68,227,PF
2007,24,81,2849,585,1016,1,1,584,1015,405,659,195,376,571,68,34,40,295,265,1576,C
2007,25,82,2535,356,658,0,2,356,656,167,224,239,494,733,64,47,159,161,287,879,C
2007,31,76,1915,209,334,0,0,209,334,119,191,217,349,566,44,24,82,107,239,537,C
2007,31,80,1761,172,389,19,63,153,326,208,250,18,133,151,290,39,9,69,79,571,SG
2007,26,45,800,129,281,6,26,123,255,56,80,26,56,82,57,27,7,55,56,320,SG
2007,27,63,2221,452,1030,85,280,367,750,275,369,51,225,276,509,135,29,193,181,1264,PG
2007,37,46,464,33,74,0,0,33,74,17,26,59,78,137,12,10,34,15,59,83,C
2007,22,31,180,22,52,0,0,22,52,7,10,21,23,44,7,6,5,8,28,51,C
2007,27,81,3021,506,1089,123,310,383,779,239,285,54,261,315,385,80,23,210,189,1374,SF
2007,24,82,1372,156,376,46,138,110,238,70,89,67,199,266,88,46,8,61,97,428,SG
2007,21,82,3071,630,1218,1,7,629,1211,279,359,148,431,579,204,97,48,153,167,1540,SF
2007,24,73,2268,306,569,15,45,291,524,82,120,91,226,317,352,28,38,154,177,709,PF
2007,24,64,1177,100,292,49,170,51,122,35,53,27,83,110,55,30,7,37,132,284,SG
2007,28,50,444,54,151,16,61,38,90,42,53,7,36,43,70,14,1,27,55,166,PG
2007,24,26,288,34,80,18,50,16,30,12,15,3,15,18,35,4,0,13,27,98,PG
2007,23,59,760,127,266,0,0,127,266,112,140,75,128,203,25,8,26,67,122,366,PF
2007,23,17,222,44,83,0,0,44,83,35,44,21,42,63,5,3,11,18,35,123,PF
2007,23,42,538,83,183,0,0,83,183,77,96,54,86,140,20,5,15,49,87,243,PF
2007,25,81,1480,71,151,0,1,71,150,48,86,166,272,438,30,40,113,63,244,190,C
2007,28,81,1926,299,703,79,226,220,477,101,116,27,131,158,123,76,9,101,177,778,SG
2007,28,55,1243,189,444,52,143,137,301,60,72,16,69,85,82,49,7,77,112,490,SG
2007,28,26,683,110,259,27,83,83,176,41,44,11,62,73,41,27,2,24,65,288,SG
2007,29,56,698,82,175,0,1,82,174,36,41,44,111,155,22,18,15,30,96,200,C
2007,26,66,1435,188,458,31,96,157,362,114,141,22,64,86,112,52,15,72,125,521,SG
2007,22,42,359,48,126,12,50,36,76,11,15,11,26,37,15,15,4,15,21,119,PG
2007,24,78,1906,197,483,88,245,109,238,76,101,23,146,169,310,69,6,105,150,558,PG
2007,30,80,2726,618,1131,1,9,617,1122,362,568,213,633,846,273,66,190,224,203,1599,C
2007,26,39,1051,166,370,36,104,130,266,78,101,40,147,187,117,38,12,71,83,446,PF
2007,26,43,1529,218,480,34,120,184,360,133,168,44,200,244,111,46,10,78,120,603,SG
2007,26,19,94,11,31,0,0,11,31,3,9,5,12,17,5,5,1,3,12,25,SF
2007,21,77,2638,480,1010,39,143,441,867,273,358,62,181,243,319,132,21,221,210,1272,SG
2007,30,70,1332,144,282,0,2,144,280,62,80,81,255,336,55,31,59,86,184,350,C
2007,28,24,244,23,60,0,0,23,60,24,35,12,27,39,14,2,6,23,39,70,PF
2007,28,6,65,6,20,0,0,6,20,7,12,3,11,14,4,4,2,5,12,19,C
2007,28,76,1732,234,542,48,133,186,409,122,155,93,128,221,74,38,14,57,126,638,SG
2007,26,66,1127,117,215,0,0,117,215,91,183,156,304,460,45,42,16,95,144,325,PF
2007,23,61,712,65,161,14,44,51,117,35,45,9,64,73,90,32,4,50,62,179,PG
2007,20,72,1090,124,294,45,137,79,157,27,38,22,97,119,137,44,7,73,77,320,PG
2007,25,8,32,5,15,2,8,3,7,1,1,0,1,1,9,1,0,1,2,13,SG
2007,22,78,2832,393,1024,103,312,290,712,204,256,51,216,267,545,118,10,230,180,1093,PG
2007,33,82,1823,273,663,104,286,169,377,90,98,34,189,223,108,32,16,46,76,740,SF
2007,32,82,2287,258,675,48,156,210,519,262,307,30,119,149,274,83,6,120,234,826,SG
2007,23,75,2243,393,902,21,69,372,833,240,293,53,183,236,595,101,8,231,186,1047,PG
2007,30,14,158,15,30,0,1,15,29,10,13,13,30,43,1,1,0,15,38,40,C
2007,30,75,1740,122,260,0,1,122,259,78,122,253,356,609,57,62,37,70,202,322,C
2007,23,82,1879,300,691,68,185,232,506,164,192,49,169,218,232,53,21,152,184,832,PG
2007,31,48,475,48,85,0,0,48,85,11,25,51,75,126,19,11,50,23,61,107,C
2007,29,44,1237,140,343,42,111,98,232,175,211,33,124,157,170,41,12,100,126,497,SG
2007,25,19,147,16,54,3,22,13,32,5,6,8,16,24,7,3,1,3,13,40,PF
2007,23,72,1896,298,689,3,18,295,671,85,108,91,304,395,67,36,42,100,216,684,PF
2007,28,54,840,108,228,0,1,108,227,42,90,94,152,246,29,22,32,49,141,258,C
2007,29,67,1909,222,529,66,193,156,336,57,78,48,282,330,125,78,15,64,90,567,PF
2007,25,79,1410,163,380,53,149,110,231,95,114,53,152,205,87,45,43,70,190,474,SF
2007,30,76,2995,638,1341,12,56,626,1285,416,498,183,792,975,313,89,126,205,184,1704,PF
2007,30,33,277,22,70,11,32,11,38,16,18,12,30,42,14,7,0,14,37,71,PF
2007,26,59,2133,462,858,3,11,459,847,299,400,149,432,581,201,29,126,162,137,1226,C
2007,20,78,2103,321,760,52,143,269,617,152,209,93,255,348,100,71,74,140,192,846,SF
2007,23,70,1239,122,264,11,47,111,217,66,82,59,114,173,56,24,22,49,108,321,SF
2007,29,60,1283,146,370,53,150,93,220,36,48,57,156,213,33,46,23,51,143,381,SF
2007,20,60,988,98,231,52,124,46,107,28,39,28,64,92,69,23,8,44,94,276,PG
2007,29,75,2060,396,854,128,323,268,531,320,372,59,268,327,263,109,27,157,155,1240,SG
2007,29,61,1188,176,381,52,122,124,259,71,87,24,105,129,63,28,5,64,122,475,SG
2007,25,13,81,8,17,0,0,8,17,1,2,2,6,8,1,0,0,9,19,17,C
2007,24,73,2275,338,723,16,42,322,681,189,233,125,282,407,119,48,13,105,169,881,PF
2007,25,80,2238,371,784,1,6,370,778,142,199,263,418,681,88,70,28,115,210,885,PF
2007,23,82,2704,609,1338,155,375,454,963,380,440,35,223,258,296,64,17,249,252,1753,SG
2007,24,79,1319,192,388,9,31,183,357,110,131,55,193,248,44,30,4,49,161,503,SF
2007,24,14,165,17,40,3,11,14,29,8,9,6,15,21,5,4,1,13,25,45,SG
2007,23,82,2785,398,868,110,288,288,580,236,294,114,267,381,114,67,61,135,245,1142,SF
2007,21,81,1780,310,739,95,258,215,481,128,159,68,140,208,83,41,24,120,198,843,SF
2007,25,74,1842,357,868,51,157,306,711,74,111,42,116,158,112,56,4,106,144,839,SG
2007,24,41,254,23,62,2,11,21,51,15,25,12,32,44,22,17,4,28,38,63,SG
2007,27,41,432,61,141,18,52,43,89,27,32,2,25,27,53,17,1,18,32,167,SG
2007,32,54,585,61,129,0,6,61,123,15,19,40,69,109,59,32,4,38,78,137,SF
2007,24,13,92,7,27,0,1,7,26,4,5,7,18,25,4,0,7,6,8,18,PF
2007,22,2,13,1,4,0,0,1,4,0,0,1,1,2,1,0,0,0,1,2,SF
2007,28,75,2763,547,1170,44,129,503,1041,347,403,75,207,282,285,59,15,159,232,1485,SG
2007,30,77,1965,322,656,13,39,309,617,237,309,117,236,353,99,52,11,118,232,894,SF
2007,26,78,2563,495,1083,127,293,368,790,168,242,151,345,496,149,65,24,169,269,1285,PF
2007,26,36,1208,223,487,54,118,169,369,72,101,71,155,226,51,25,10,91,116,572,PF
2007,26,42,1355,272,596,73,175,199,421,96,141,80,190,270,98,40,14,78,153,713,PF
2007,26,29,543,57,137,7,26,50,111,31,46,12,56,68,89,21,5,52,79,152,PG
2007,33,26,220,25,56,0,0,25,56,17,22,13,25,38,6,1,1,15,49,67,PF
2007,23,80,2081,292,593,14,50,278,543,215,261,45,151,196,296,96,21,146,242,813,PG
2007,24,24,190,30,58,0,0,30,58,11,22,9,33,42,6,5,12,26,47,71,C
2007,28,36,846,100,224,7,29,93,195,42,47,14,84,98,103,44,1,38,83,249,PG
2007,28,13,100,15,30,3,6,12,24,10,11,2,13,15,10,3,0,4,23,43,PG
2007,28,23,746,85,194,4,23,81,171,32,36,12,71,83,93,41,1,34,60,206,PG
2007,26,79,2483,353,717,0,4,353,713,138,203,188,466,654,97,49,26,110,236,844,PF
2007,27,76,2223,217,443,6,25,211,418,72,92,83,160,243,203,22,26,80,144,512,SG
2007,23,78,1714,192,335,0,0,192,335,55,89,204,317,521,47,70,18,64,281,439,PF
2007,25,81,1626,224,546,66,183,158,363,71,84,42,168,210,80,48,13,56,160,585,SF
2007,27,77,1740,198,355,0,0,198,355,115,210,195,282,477,47,34,88,90,208,511,C
2007,24,80,2211,306,700,177,401,129,299,83,105,31,221,252,194,76,5,137,133,872,SG
2007,34,38,418,43,67,0,0,43,67,33,47,48,59,107,10,9,12,12,62,119,PF
2007,27,48,936,174,330,53,115,121,215,41,53,28,111,139,26,17,7,32,76,442,PF
2007,24,64,1715,294,516,0,1,294,515,195,283,150,299,449,77,62,59,127,209,783,C
2007,34,65,2009,342,660,2,12,340,648,248,324,53,184,237,138,61,25,144,146,934,SG
2007,26,80,2839,475,1061,140,337,335,724,237,284,32,242,274,500,100,23,191,274,1327,PG
2007,23,12,136,19,60,5,23,14,37,8,12,4,12,16,8,3,2,6,8,51,SG
2007,23,9,65,6,12,0,0,6,12,3,4,2,6,8,12,4,0,3,6,15,SG
2007,23,4,37,2,5,0,0,2,5,2,2,1,2,3,10,3,0,1,3,6,SG
2007,23,5,28,4,7,0,0,4,7,1,2,1,4,5,2,1,0,2,3,9,SG
2007,22,27,185,20,36,0,0,20,36,24,40,11,20,31,1,4,7,16,40,64,C
2007,36,68,1124,90,251,50,149,40,102,38,64,73,156,229,77,45,41,44,105,268,PF
2007,28,56,946,180,421,75,175,105,246,33,36,14,78,92,67,27,3,27,69,468,SG
2007,21,82,3023,526,873,1,2,525,871,390,666,283,725,1008,158,70,156,317,245,1443,C
2007,26,70,2455,493,1075,92,239,401,836,243,294,130,345,475,127,82,56,123,180,1321,SF
2007,33,80,2123,309,665,0,0,309,665,155,188,138,332,470,131,29,8,112,205,773,PF
2007,30,34,554,74,195,28,80,46,115,26,32,8,40,48,73,14,2,40,23,202,PG
2007,28,70,2596,381,953,74,222,307,731,209,309,41,226,267,256,89,26,154,164,1045,SG
2007,21,60,670,87,185,0,0,87,185,53,79,78,109,187,18,14,21,32,98,227,PF
2007,36,52,745,94,244,38,119,56,125,30,33,9,38,47,93,34,7,35,56,256,PG
2007,25,70,1605,188,326,0,0,188,326,74,151,114,221,335,26,13,76,65,137,450,PF
2007,23,76,3062,443,991,48,155,395,836,452,551,77,357,434,432,152,33,261,200,1386,SG
2007,31,78,2130,385,793,0,1,385,792,155,192,242,357,599,123,48,98,141,257,925,C
2007,22,5,6,0,3,0,0,0,3,0,0,0,1,1,0,0,0,3,1,0,C
2007,26,21,79,5,16,0,0,5,16,7,8,3,8,11,6,3,5,5,17,17,C
2007,19,66,973,139,363,54,148,85,215,70,89,58,131,189,49,27,17,51,147,402,PF
2007,31,15,640,151,366,12,53,139,313,154,174,7,34,41,109,33,1,66,21,468,PG
2007,31,50,2121,430,947,50,144,380,803,331,436,16,136,152,359,90,12,202,74,1241,SG
2007,25,53,539,64,143,5,16,59,127,24,35,15,36,51,45,24,4,31,62,157,PG
2007,23,79,2651,320,705,63,180,257,525,243,279,18,190,208,417,86,9,187,202,946,PG
2007,33,56,1330,204,518,54,165,150,353,130,168,42,136,178,141,50,6,78,98,592,SG
2007,25,13,138,19,43,5,17,14,26,5,9,2,8,10,13,5,1,7,15,48,SF
2007,25,3,16,1,8,1,4,0,4,0,0,0,1,1,4,0,0,1,3,3,SF
2007,25,10,122,18,35,4,13,14,22,5,9,2,7,9,9,5,1,6,12,45,SF
2007,32,56,1025,159,388,0,1,159,387,90,103,62,130,192,58,21,7,65,89,408,PF
2007,28,37,1186,180,430,41,138,139,292,120,146,17,78,95,114,33,20,81,87,521,SG
2007,28,38,1293,229,514,59,173,170,341,123,153,44,83,127,173,51,14,102,113,640,SF
2007,31,41,273,33,79,0,0,33,79,10,18,21,45,66,3,6,15,23,73,76,C
2007,22,78,3190,772,1621,99,310,673,1311,489,701,83,443,526,470,125,55,250,171,2132,SF
2007,31,82,2069,297,703,80,215,217,488,154,184,25,138,163,297,55,7,129,171,828,PG
2007,30,70,2662,512,1139,138,379,374,760,226,307,134,428,562,136,80,36,104,194,1388,PF
2007,28,70,1555,136,325,32,85,104,240,67,88,54,130,184,145,75,16,88,172,371,SG
2007,30,37,664,91,221,32,86,59,135,59,64,10,38,48,111,13,0,59,53,273,SG
2007,30,26,309,37,101,12,44,25,57,27,31,5,16,21,61,13,1,31,22,113,PG
2007,22,69,2319,453,882,0,1,453,881,201,295,237,519,756,88,48,106,136,232,1107,C
2007,26,55,1956,303,665,52,145,251,520,239,326,48,192,240,148,34,8,120,123,897,SF
2007,25,55,1307,95,206,2,20,93,186,31,68,111,127,238,67,44,30,61,150,223,SF
2007,23,59,753,91,169,0,0,91,169,78,118,50,131,181,17,25,35,47,137,260,PF
2007,19,8,124,18,33,0,3,18,30,11,14,15,22,37,3,5,13,9,19,47,PF
2007,32,67,1301,142,343,25,73,117,270,46,61,22,79,101,201,33,3,76,119,355,PG
2007,32,40,562,60,146,11,29,49,117,21,29,13,35,48,78,16,1,31,68,152,PG
2007,32,27,739,82,197,14,44,68,153,25,32,9,44,53,123,17,2,45,51,203,PG
2007,26,39,419,50,154,19,88,31,66,16,21,10,47,57,17,16,12,27,39,135,SF
2007,25,57,2359,536,1139,119,312,417,827,235,314,53,186,239,249,60,11,176,115,1426,SG
2007,26,54,720,93,190,10,30,83,160,30,37,52,111,163,18,33,18,27,101,226,PF
2007,23,44,336,43,93,1,9,42,84,23,41,22,35,57,16,11,1,18,59,110,SF
2007,26,78,1671,220,461,5,12,215,449,138,174,47,106,153,68,39,22,92,192,583,SG
2007,30,60,1173,137,355,89,231,48,124,30,44,9,57,66,94,16,2,36,53,393,PG
2007,23,4,18,0,1,0,0,0,1,3,6,1,5,6,0,0,0,2,3,3,PF
2007,35,64,1594,178,422,78,222,100,200,59,75,31,159,190,109,68,10,47,124,493,SG
2007,35,29,561,57,151,22,74,35,77,25,34,14,47,61,33,22,2,23,54,161,SG
2007,35,35,1033,121,271,56,148,65,123,34,41,17,112,129,76,46,8,24,70,332,SG
2007,27,63,1319,139,361,39,128,100,233,95,114,23,92,115,108,48,16,67,121,412,SG
2007,27,39,870,96,249,32,101,64,148,73,88,16,66,82,55,30,12,50,80,297,SG
2007,27,24,449,43,112,7,27,36,85,22,26,7,26,33,53,18,4,17,41,115,SG
2007,26,76,1376,162,440,90,238,72,202,71,81,33,143,176,45,28,42,28,115,485,SF
2007,27,18,138,14,51,10,32,4,19,2,2,6,17,23,1,5,1,7,19,40,SF
2007,22,58,666,65,128,0,1,65,127,59,75,49,87,136,11,11,42,25,124,189,PF
2007,24,75,2176,294,652,0,1,294,651,166,224,160,428,588,79,41,116,147,251,754,C
2007,25,67,1767,278,563,108,210,170,353,66,74,26,154,180,81,38,2,70,135,730,SF
2007,24,33,231,27,70,0,6,27,64,19,26,20,37,57,21,10,1,16,53,73,PF
2007,33,80,2933,369,908,124,361,245,547,179,230,135,520,655,736,127,23,213,146,1041,PG
2007,22,48,967,139,304,13,46,126,258,78,98,29,68,97,41,53,1,46,57,369,SG
2007,25,70,2049,197,418,16,75,181,343,174,239,88,241,329,202,74,144,135,172,584,SF
2007,22,79,1488,200,474,83,221,117,253,115,135,77,189,266,45,28,14,79,200,598,PF
2007,31,45,1273,152,363,1,18,151,345,103,128,14,101,115,296,67,3,95,113,408,PG
2007,19,10,41,4,16,1,5,3,11,3,6,1,2,3,4,3,0,1,0,12,SF
2007,25,74,2288,372,845,132,307,240,538,191,209,30,229,259,105,57,20,117,188,1067,SF
2007,23,26,848,170,323,0,1,170,322,86,121,51,125,176,46,10,24,52,88,426,C
2007,30,27,352,39,102,2,23,37,79,20,26,25,45,70,8,7,11,13,57,100,PF
2007,23,11,55,4,9,0,0,4,9,3,5,5,6,11,2,0,3,2,14,11,C
2007,23,58,1731,240,400,0,0,240,400,141,173,196,406,602,104,48,23,92,155,621,PF
2007,27,60,2348,463,1005,151,387,312,618,265,315,91,305,396,145,68,39,118,143,1342,SF
2007,31,4,26,0,3,0,0,0,3,0,0,1,0,1,4,0,0,1,2,0,PG
2007,21,54,1611,208,449,5,16,203,433,82,116,56,128,184,274,59,29,108,135,503,PG
2007,20,10,175,14,38,3,8,11,30,25,28,12,19,31,32,14,1,12,20,56,PG
2007,24,47,383,62,156,15,59,47,97,15,19,9,27,36,33,17,0,15,38,154,PG
2007,29,56,1488,218,524,56,161,162,363,144,163,19,85,104,201,24,0,85,101,636,PG
2007,31,56,473,23,43,0,0,23,43,15,29,35,52,87,10,10,10,21,100,61,C
2007,27,75,2291,367,808,13,65,354,743,519,633,90,352,442,208,65,14,201,244,1266,SF
2007,28,81,1703,199,395,0,0,199,395,131,242,151,341,492,30,21,66,129,226,529,C
2007,24,1,27,2,10,0,0,2,10,1,2,0,2,2,0,2,0,1,4,5,PF
2007,29,74,2748,395,952,123,345,272,607,297,386,36,177,213,403,71,10,179,185,1210,PG
2007,28,80,3010,561,1071,80,252,481,819,201,248,172,613,785,134,156,122,114,216,1403,SF
2007,21,30,170,19,52,6,16,13,36,7,11,11,20,31,6,3,1,15,22,51,PF
2007,31,3,17,2,6,0,1,2,5,2,2,0,3,3,0,0,1,0,4,6,PF
2007,33,81,1360,209,493,95,271,114,222,53,80,86,237,323,46,39,43,67,130,566,PF
2007,24,40,361,32,89,4,18,28,71,31,45,8,21,29,13,12,5,19,22,99,SG
2007,35,31,220,33,94,13,37,20,57,15,21,2,10,12,43,3,0,12,22,94,PG
2007,29,2,63,8,16,0,1,8,15,3,12,6,14,20,1,0,0,5,10,19,PF
2007,23,80,2818,505,1067,127,333,378,734,481,570,69,273,342,173,98,11,135,181,1618,SG
2007,29,75,2575,407,900,0,0,407,900,214,323,124,221,345,115,52,22,192,174,1028,SF
2007,26,62,492,59,179,33,102,26,77,14,16,7,38,45,35,13,6,19,66,165,SG
2007,23,67,943,131,262,0,0,131,262,72,137,88,98,186,14,30,60,53,110,334,C
2007,22,35,838,164,328,2,3,162,325,86,112,73,160,233,66,19,24,56,100,416,PF
2007,22,37,554,62,177,20,75,42,102,40,58,14,33,47,38,26,7,40,71,184,SG
2007,22,5,12,0,3,0,0,0,3,0,0,0,0,0,0,0,0,2,1,0,SG
2007,32,82,1729,284,540,0,0,284,540,96,139,165,331,496,72,61,65,75,240,664,PF
2007,24,11,41,5,13,0,1,5,12,5,7,7,4,11,1,0,0,1,8,15,PF
2007,27,71,2539,638,1480,126,381,512,1099,345,488,56,322,378,458,92,36,213,136,1747,SG
2007,32,38,702,71,181,1,8,70,173,22,32,14,48,62,124,14,0,42,72,165,PG
2007,34,10,131,11,17,0,0,11,17,0,0,1,17,18,13,4,0,8,14,22,SF
2007,27,48,718,73,188,16,45,57,143,69,78,4,39,43,90,24,5,46,51,231,PG
2007,27,26,379,41,105,9,23,32,82,47,53,3,18,21,45,17,3,23,21,138,PG
2007,27,22,339,32,83,7,22,25,61,22,25,1,21,22,45,7,2,23,30,93,PG
2007,27,14,81,12,29,1,2,11,27,17,20,4,10,14,2,0,2,5,16,42,C
2007,23,12,71,11,17,0,0,11,17,7,18,9,12,21,0,1,0,9,8,29,PF
2007,19,37,373,40,116,7,32,33,84,14,23,11,24,35,25,11,4,28,60,101,SG
2007,21,80,1913,249,548,0,1,249,547,141,230,145,292,437,90,44,140,124,219,639,PF
2007,30,80,2966,424,909,5,35,419,874,222,283,97,255,352,625,110,10,222,184,1075,PG
2007,30,23,822,117,248,4,16,113,232,62,85,25,79,104,209,37,4,70,58,300,PG
2007,30,57,2144,307,661,1,19,306,642,160,198,72,176,248,416,73,6,152,126,775,PG
2007,30,63,1783,224,494,5,33,219,461,115,149,79,322,401,224,38,39,108,155,568,C
2007,26,70,2740,465,1010,202,498,263,512,161,203,52,326,378,298,54,18,179,138,1293,SG
2007,21,82,1472,209,398,1,3,208,395,140,208,183,240,423,62,67,74,94,236,559,PF
2007,26,48,1624,423,819,0,2,423,817,356,413,101,351,452,94,17,94,167,159,1202,C
2007,31,78,2841,388,882,101,246,287,636,200,239,52,215,267,198,92,24,145,186,1077,SG
2007,29,51,773,118,222,0,0,118,222,50,82,89,140,229,9,27,40,43,133,286,C
2007,31,79,2082,308,506,0,1,308,505,160,235,145,258,403,74,46,60,113,261,776,C
2007,21,5,44,1,6,0,0,1,6,2,6,1,8,9,1,2,1,2,4,4,C
2007,22,78,2326,355,944,87,258,268,686,120,169,54,176,230,163,28,6,130,179,917,PF
2007,36,77,1572,238,425,0,0,238,425,185,308,126,224,350,18,13,178,129,219,661,C
2007,26,68,1852,266,581,58,147,208,434,108,145,100,314,414,126,46,42,78,196,698,PF
2007,26,26,667,81,180,22,59,59,121,47,66,37,120,157,60,21,17,29,63,231,PF
2007,26,42,1185,185,401,36,88,149,313,61,79,63,194,257,66,25,25,49,133,467,PF
2007,27,69,1477,177,438,24,83,153,355,87,120,26,87,113,187,49,13,90,96,465,SG
2007,40,75,1289,85,153,0,0,85,153,60,87,164,324,488,13,22,76,38,156,230,C
2007,26,76,1532,226,495,112,265,114,230,132,164,27,226,253,61,30,26,69,183,696,SF
2007,30,75,1658,204,354,1,12,203,342,88,123,131,179,310,64,73,26,56,207,497,PF
2007,32,76,2682,517,971,156,343,361,628,222,247,30,239,269,884,57,6,287,117,1412,PG
2007,24,77,2331,376,875,65,194,311,681,183,221,50,186,236,330,73,5,184,225,1000,PG
2007,30,80,1676,230,421,0,1,230,420,34,50,115,245,360,74,37,84,56,193,494,C
2007,32,15,129,16,37,8,15,8,22,6,10,13,17,30,2,6,0,3,17,46,SF
2007,27,53,1406,273,584,80,209,193,375,123,145,42,259,301,57,27,24,104,164,749,PF
2007,22,68,792,65,177,17,53,48,124,37,43,42,81,123,65,25,9,40,77,184,PF
2007,23,35,191,18,50,13,39,5,11,2,2,4,22,26,6,5,0,4,21,51,SF
2007,28,78,2820,673,1341,72,173,601,1168,498,551,122,571,693,263,52,62,167,171,1916,PF
2007,20,16,119,10,32,0,0,10,32,11,17,7,14,21,9,6,8,8,26,31,C
2007,28,69,2459,498,1141,0,7,498,1134,343,447,153,508,661,167,50,182,203,232,1339,C
2007,34,40,1135,283,479,0,0,283,479,124,294,97,200,297,79,8,55,95,139,690,C
2007,31,79,1365,158,281,0,0,158,281,33,51,131,237,368,68,25,24,69,213,349,PF
2007,27,56,2202,319,681,54,182,265,499,198,283,102,445,547,270,53,32,163,182,890,PF
2007,24,67,2329,394,740,0,0,394,740,175,295,258,499,757,80,57,172,111,210,963,C
2007,27,80,2664,490,1061,129,336,361,725,296,387,160,419,579,156,36,38,125,257,1405,C
2007,34,53,919,81,187,0,2,81,185,37,45,8,66,74,130,21,1,47,76,199,PG
2007,31,24,234,19,46,0,0,19,46,2,3,14,34,48,5,8,13,17,48,40,C
2007,35,41,460,34,51,0,0,34,51,13,22,47,59,106,16,17,6,21,57,81,PF
2007,22,67,1532,246,567,10,37,236,530,143,181,65,152,217,52,61,74,66,150,645,PF
2007,22,72,2026,291,614,0,1,291,613,293,373,199,301,500,106,77,36,162,267,875,C
2007,30,31,231,16,56,8,33,8,23,6,13,16,38,54,8,5,3,9,35,46,PF
2007,30,24,198,15,49,8,29,7,20,6,11,11,34,45,8,4,3,8,33,44,PF
2007,30,7,33,1,7,0,4,1,3,0,2,5,4,9,0,1,0,1,2,2,PF
2007,27,82,1710,283,692,81,209,202,483,104,122,20,160,180,203,53,4,122,121,751,PG
2007,31,73,2437,328,687,115,261,213,426,132,158,60,223,283,153,73,11,71,135,903,SG
2007,25,82,2457,342,785,110,301,232,484,113,175,45,161,206,228,119,10,153,211,907,PG
2007,24,77,2499,570,1096,15,38,555,1058,274,350,34,216,250,420,82,6,191,137,1429,PG
2007,31,81,2508,475,867,3,19,472,848,241,376,190,250,440,232,110,25,199,232,1194,SF
2007,21,64,2353,381,871,50,143,331,728,292,357,54,226,280,569,118,3,161,154,1104,PG
2007,23,67,1534,222,490,60,148,162,342,100,126,23,135,158,105,55,17,102,145,604,SG
2007,38,68,1503,144,366,32,123,112,243,38,57,18,114,132,201,43,3,66,117,358,PG
2007,22,72,1576,132,269,0,3,132,266,60,100,113,259,372,94,23,96,113,214,324,C
2007,29,71,1515,222,517,106,295,116,222,84,123,32,205,237,47,45,12,53,126,634,SF
2007,21,81,1510,226,438,0,0,226,438,50,77,92,243,335,45,39,47,82,237,502,C
2007,36,11,73,9,25,7,18,2,7,2,2,2,7,9,4,0,1,5,6,27,SG
2007,29,47,1740,373,850,107,275,266,575,320,402,39,238,277,194,48,13,152,122,1173,SG
2007,24,72,1937,286,586,93,240,193,346,136,210,81,246,327,62,48,55,105,220,801,SF
2007,23,6,100,12,27,1,2,11,25,6,9,7,8,15,5,3,3,4,12,31,PF
2007,31,24,109,11,26,0,0,11,26,2,4,15,16,31,3,4,1,4,27,24,C
2007,30,71,1919,186,432,97,259,89,173,81,98,66,291,357,94,71,23,55,193,550,SF
2007,31,3,13,0,4,0,0,0,4,0,0,0,2,2,0,0,0,2,3,0,C
2007,23,63,720,79,177,0,2,79,175,106,144,97,118,215,10,14,22,47,104,264,C
2007,24,37,353,43,93,0,0,43,93,30,42,24,64,88,21,5,12,29,61,116,PF
2007,24,7,64,2,15,0,0,2,15,8,12,7,12,19,3,0,0,5,18,12,PF
2007,24,30,289,41,78,0,0,41,78,22,30,17,52,69,18,5,12,24,43,104,PF
2007,24,3,13,0,3,0,1,0,2,2,2,3,0,3,0,0,0,3,2,2,SF
2007,23,58,563,67,172,21,65,46,107,37,55,15,56,71,48,28,4,33,64,192,PG
2007,26,82,3001,459,997,81,210,378,787,172,224,144,285,429,227,51,55,98,116,1171,SF
2007,27,43,701,37,78,0,0,37,78,10,27,59,109,168,12,10,67,40,124,84,C
2007,23,42,408,48,131,20,57,28,74,25,37,6,24,30,65,15,0,21,32,141,PG
2007,26,55,986,134,316,40,118,94,198,53,73,53,127,180,66,25,18,69,125,361,PF
2007,23,13,179,23,48,0,0,23,48,12,22,19,35,54,4,7,10,9,23,58,PF
2007,25,68,2425,600,1286,14,48,586,1238,394,481,199,489,688,147,53,15,215,184,1608,PF
2007,33,2,44,1,3,0,0,1,3,3,4,2,5,7,0,1,3,1,6,5,C
2007,22,47,710,100,259,48,116,52,143,42,55,18,51,69,43,20,3,42,85,290,SG
2007,27,53,2036,477,1025,117,306,360,719,345,416,42,154,196,124,63,9,122,78,1416,SF
2007,22,42,622,80,195,38,98,42,97,54,60,10,42,52,36,12,0,21,52,252,PG
2007,25,41,318,40,107,0,0,40,107,26,30,15,31,46,17,5,3,22,44,106,PF
2007,24,27,244,15,43,0,0,15,43,3,10,21,50,71,13,5,6,14,45,33,C
2007,26,51,1675,306,734,110,301,196,433,92,140,71,188,259,172,54,32,82,129,814,SG
2007,22,5,19,3,6,2,3,1,3,0,0,1,1,2,0,1,0,1,2,8,SG
2007,26,49,1621,228,545,97,258,131,287,83,120,65,287,352,108,36,7,70,133,636,SF
2007,25,71,2091,301,695,49,139,252,556,128,159,28,136,164,368,83,19,156,181,779,PG
2007,23,20,227,44,104,21,55,23,49,2,3,2,19,21,10,12,0,13,27,111,PG
2007,24,54,969,94,208,0,2,94,206,95,131,101,160,261,30,36,13,36,133,283,PF
2007,26,21,241,16,54,0,2,16,52,19,22,9,33,42,17,13,1,16,28,51,SG
2007,26,10,37,3,8,0,0,3,8,4,5,1,5,6,2,4,1,0,4,10,SF
2007,40,50,955,81,218,25,66,56,152,16,36,31,91,122,51,12,23,30,98,203,C
2007,22,64,1356,227,523,83,213,144,310,108,139,55,97,152,90,50,6,72,160,645,PG
2007,20,67,862,101,239,24,85,77,154,21,26,20,71,91,218,35,2,77,72,247,PG
2007,20,78,1831,188,450,6,29,182,421,119,184,74,218,292,297,128,8,137,181,501,PG
2007,34,29,246,38,86,21,47,17,39,11,12,3,20,23,16,5,2,9,22,108,SF
2007,32,65,810,74,186,2,8,72,178,42,52,47,128,175,65,26,9,65,120,192,PF
2007,25,81,1700,177,379,2,10,175,369,68,87,60,130,190,86,70,32,33,179,424,SG
2007,22,57,2015,349,765,55,146,294,619,202,241,58,192,250,230,67,10,116,139,955,SG
2007,30,30,271,5,18,0,0,5,18,7,19,35,27,62,6,6,8,12,43,17,PF
2007,27,79,2135,236,517,40,112,196,405,159,204,47,217,264,254,73,27,119,177,671,SG
2007,23,22,125,9,14,0,1,9,13,6,14,15,33,48,5,2,7,10,17,24,C
2007,28,54,1027,77,191,44,110,33,81,18,23,24,81,105,59,23,18,44,130,216,PF
2007,24,11,118,7,23,0,0,7,23,5,7,10,15,25,1,2,4,4,25,19,C
2007,22,71,868,109,256,15,42,94,214,23,45,35,118,153,60,33,11,60,100,256,SG
2007,20,28,169,18,49,0,0,18,49,17,29,16,29,45,0,3,12,11,33,53,C
2007,23,8,93,9,23,0,0,9,23,5,7,5,6,11,4,2,0,3,13,23,PF
2007,21,43,534,55,132,0,0,55,132,16,33,44,63,107,12,8,23,22,75,126,PF
2007,25,53,376,30,82,3,14,27,68,22,29,36,70,106,17,15,17,17,45,85,PF
2007,30,67,1523,124,253,0,0,124,253,46,79,106,279,385,58,18,64,75,195,294,PF
2007,23,20,72,14,26,1,2,13,24,9,13,7,7,14,1,1,2,9,11,38,C
2007,23,82,1537,246,463,0,6,246,457,116,186,149,267,416,49,51,18,74,223,608,PF
2007,21,63,1471,284,644,149,382,135,262,102,126,30,113,143,91,49,9,85,147,819,SG
2007,31,65,1503,214,477,0,5,214,472,125,148,120,280,400,49,37,27,76,148,553,PF
2007,31,11,148,23,48,0,1,23,47,10,12,13,27,40,3,6,7,13,23,56,PF
2007,31,54,1355,191,429,0,4,191,425,115,136,107,253,360,46,31,20,63,125,497,PF
2007,21,72,2647,436,993,38,152,398,841,268,387,165,456,621,236,101,207,227,241,1178,SF
2007,23,8,28,2,8,0,0,2,8,1,2,1,5,6,0,1,0,2,4,5,PF
2007,33,82,1929,135,324,0,4,135,320,72,113,35,153,188,330,55,16,111,185,342,PG
2007,23,39,563,66,146,11,44,55,102,49,75,17,66,83,39,11,12,26,51,192,SF
2007,28,37,700,118,225,0,2,118,223,46,54,44,90,134,38,17,10,43,105,282,PF
2007,25,7,34,3,9,0,0,3,9,4,6,6,5,11,2,1,1,1,2,10,C
2007,24,31,272,23,72,5,29,18,43,34,42,5,17,22,28,7,1,29,33,85,SG
2007,32,67,1615,280,654,62,162,218,492,182,215,39,106,145,187,51,10,117,78,804,SF
2007,25,82,2419,347,753,74,183,273,570,152,216,55,161,216,218,65,19,119,155,920,SG
2007,29,13,425,83,196,34,84,49,112,31,38,11,43,54,11,8,4,19,29,231,SF
2007,33,62,1501,171,437,59,175,112,262,66,83,31,108,139,299,47,2,101,95,467,PG
2007,24,61,1034,177,425,56,155,121,270,61,68,6,68,74,61,21,2,55,88,471,SG
2007,24,82,2689,607,1055,0,3,607,1052,457,585,222,564,786,84,78,110,232,295,1671,C
2007,24,48,385,58,134,0,0,58,134,37,66,45,75,120,28,9,11,42,79,153,C
2007,27,54,1029,161,346,0,5,161,341,97,134,85,165,250,17,30,62,69,146,419,C
2007,29,32,900,161,388,44,106,117,282,113,126,16,82,98,55,18,3,54,65,479,SF
2007,24,47,369,56,140,3,17,53,123,11,21,14,39,53,45,17,3,25,34,126,SG
2007,30,12,103,8,28,0,0,8,28,8,13,10,18,28,5,4,1,6,16,24,PF
2007,21,78,1578,176,474,37,128,139,346,90,110,17,91,108,218,43,11,98,166,479,PG
2007,29,81,2846,514,1063,162,370,352,693,160,199,41,190,231,422,81,17,152,170,1350,SG
2007,28,65,1246,159,277,0,0,159,277,77,138,136,241,377,29,22,89,71,162,395,C
2007,29,62,1412,146,303,0,1,146,302,39,76,134,243,377,76,43,16,90,141,331,PF
2007,34,67,1208,126,259,0,1,126,258,56,71,86,293,379,24,24,29,35,156,308,C
2007,29,76,2054,299,723,136,356,163,367,102,144,63,315,378,171,55,28,106,228,836,PF
2007,20,72,966,134,282,0,2,134,280,106,175,89,180,269,40,46,76,94,162,374,PF
2007,23,6,50,6,15,0,2,6,13,5,6,3,5,8,2,0,0,1,2,17,SF
2007,28,72,2243,346,889,61,193,285,696,172,239,60,180,240,494,117,25,200,190,925,PG
2007,27,36,390,29,72,0,0,29,72,26,39,42,62,104,5,8,12,24,51,84,C
2007,27,23,258,20,50,0,0,20,50,14,24,24,40,64,2,7,11,21,34,54,C
2007,27,13,132,9,22,0,0,9,22,12,15,18,22,40,3,1,1,3,17,30,C
2007,21,17,83,11,22,0,0,11,22,8,14,11,12,23,3,2,0,6,12,30,SF
2007,24,72,1087,147,268,0,1,147,267,89,134,88,171,259,63,17,78,52,202,383,C
2007,27,73,2268,345,823,109,281,236,542,171,219,57,236,293,233,70,16,143,221,970,SF
2007,29,75,2144,237,514,89,219,148,295,66,89,95,184,279,112,71,17,73,207,629,SF
2007,24,73,948,127,344,33,115,94,229,53,60,11,71,82,122,27,1,56,70,340,PG
2007,24,81,1932,191,401,0,9,191,392,165,268,191,354,545,75,76,52,67,269,547,C
2007,31,64,760,71,167,1,2,70,165,49,65,8,60,68,131,24,2,40,74,192,PG
2007,22,39,984,180,383,29,86,151,297,73,89,62,166,228,36,24,12,54,108,462,PF
2007,22,13,103,7,15,3,7,4,8,5,7,2,9,11,5,2,1,6,10,22,SF
2007,29,73,1043,121,255,0,0,121,255,77,113,84,172,256,44,30,24,56,199,319,C
2007,22,73,935,105,268,60,161,45,107,43,49,28,79,107,64,41,1,30,103,313,SG
2007,25,51,1931,472,962,21,79,451,883,432,535,51,188,239,384,107,62,216,117,1397,SG
2007,30,78,1818,265,668,84,305,181,363,46,105,92,247,339,130,48,17,141,173,660,PF
2007,32,77,2697,192,424,1,5,191,419,109,267,303,518,821,186,111,156,101,153,494,C
2007,24,72,2640,478,952,39,120,439,832,309,447,142,376,518,185,144,69,160,209,1304,SF
2007,32,75,2419,357,843,104,296,253,547,108,137,90,453,543,127,75,118,94,225,926,C
2007,26,60,1982,264,557,48,124,216,433,108,145,87,215,302,257,60,21,118,117,684,SF
2007,24,82,2152,373,712,0,8,373,704,299,388,130,290,420,75,43,30,161,232,1045,PF
2007,27,77,2152,263,687,92,280,171,407,108,147,34,151,185,437,99,23,167,152,726,PG
2007,33,61,1821,289,639,4,11,285,628,102,160,124,313,437,188,60,41,107,143,684,PF
2007,33,18,544,89,230,2,5,87,225,18,28,37,112,149,61,18,15,33,36,198,PF
2007,33,43,1277,200,409,2,6,198,403,84,132,87,201,288,127,42,26,74,107,486,PF
2007,20,82,1759,195,492,91,250,104,242,93,132,43,197,240,52,35,19,76,126,574,SF
2007,30,28,590,85,207,1,7,84,200,46,82,26,94,120,31,24,13,57,62,217,SF
2007,36,35,352,22,75,9,38,13,37,20,28,3,32,35,37,12,4,17,32,73,SG
2007,26,52,1900,377,792,8,25,369,767,187,227,126,298,424,114,42,38,98,143,949,PF
2007,23,69,2219,306,717,65,178,241,539,168,197,32,176,208,304,74,34,140,152,845,SG
2007,24,6,137,18,41,2,7,16,34,12,15,3,17,20,5,3,1,5,7,50,SG
2007,24,82,2586,433,819,0,6,433,813,240,351,178,451,629,82,70,38,127,248,1106,PF
2007,27,82,2037,262,602,50,122,212,480,150,170,87,142,229,156,92,16,116,157,724,SF
2007,27,47,534,66,141,5,15,61,126,33,42,15,39,54,79,15,4,31,53,170,PG
2007,35,38,374,29,53,0,1,29,52,18,22,27,58,85,7,7,14,18,56,76,PF
2007,32,2,10,0,2,0,1,0,1,2,4,1,0,1,3,2,0,3,0,2,PG
2007,22,80,2950,494,1083,82,255,412,828,227,296,41,226,267,745,78,13,246,254,1297,PG
2007,34,21,121,19,47,8,19,11,28,8,14,3,14,17,7,3,0,7,12,54,SF
2007,34,16,88,15,34,8,17,7,17,4,7,1,13,14,6,2,0,5,6,42,SF
2007,34,5,33,4,13,0,2,4,11,4,7,2,1,3,1,1,0,2,6,12,SF
2007,31,61,1865,235,569,100,295,135,274,94,103,18,123,141,322,58,1,100,68,664,PG
2007,22,26,333,54,88,0,1,54,87,23,63,51,64,115,2,5,16,15,51,131,C
2007,20,61,688,93,211,12,37,81,174,64,92,17,53,70,110,22,1,46,42,262,PG
2007,21,79,1315,208,526,46,163,162,363,72,85,29,134,163,260,29,2,142,96,534,PG
2007,20,64,2179,306,706,11,45,295,661,216,265,84,253,337,121,52,30,127,191,839,PF
2007,24,68,2472,468,1049,79,228,389,821,159,186,54,275,329,416,85,6,203,201,1174,PG
2007,31,30,345,35,86,20,50,15,36,4,6,11,29,40,31,12,0,13,20,94,PG
2007,20,46,556,75,160,19,52,56,108,11,20,33,50,83,22,6,8,24,69,180,SG
2007,23,81,1514,166,365,2,4,164,361,110,144,131,304,435,44,52,39,96,199,444,PF
2007,33,68,1337,236,463,0,2,236,461,148,207,63,158,221,39,29,15,97,183,620,PF
2007,44,5,43,5,13,0,0,5,13,2,2,2,6,8,1,2,1,2,11,12,PF
2007,27,70,2641,458,1040,93,260,365,780,307,415,102,352,454,235,149,43,146,205,1316,SF
2007,22,63,1137,110,251,19,59,91,192,44,73,38,137,175,55,30,10,43,120,283,SG
2007,22,19,190,24,60,6,20,18,40,13,18,7,14,21,15,9,1,6,6,67,SG
2007,21,66,1292,162,364,5,34,157,330,64,86,40,232,272,95,41,46,65,112,393,SF
2007,31,67,1035,82,183,0,0,82,183,9,32,85,131,216,40,28,28,39,204,173,C
2008,31,6,51,3,14,0,0,3,14,4,4,6,4,10,4,1,0,1,9,10,PF
2008,22,75,970,99,241,10,48,89,193,68,87,36,101,137,52,31,8,34,83,276,SG
2008,23,26,165,21,65,3,19,18,46,6,12,4,9,13,8,0,1,6,17,51,SG
2008,23,12,77,5,27,0,8,5,19,5,6,1,3,4,4,0,1,3,11,15,SG
2008,23,14,88,16,38,3,11,13,27,1,6,3,6,9,4,0,0,3,6,36,SG
2008,23,12,177,15,57,10,34,5,23,30,31,1,18,19,19,6,0,16,20,70,PG
2008,22,76,2649,561,1160,1,7,560,1153,227,298,220,358,578,122,55,94,126,240,1350,PF
2008,29,73,1096,157,327,1,2,156,325,23,25,66,130,196,44,19,31,45,149,338,PF
2008,29,48,763,124,261,1,2,123,259,12,13,42,86,128,29,15,21,32,89,261,PF
2008,29,25,333,33,66,0,0,33,66,11,12,24,44,68,15,4,10,13,60,77,PF
2008,32,73,2624,439,986,180,452,259,534,215,237,75,193,268,225,65,16,127,147,1273,SG
2008,26,75,1373,169,389,18,57,151,332,138,181,34,134,168,114,62,21,109,168,494,SG
2008,26,3,10,1,4,0,0,1,4,1,2,0,1,1,0,0,0,0,1,3,C
2008,22,9,39,4,15,1,4,3,11,4,6,0,2,2,3,1,0,2,5,13,SG
2008,31,74,2526,364,924,143,407,221,517,98,137,28,232,260,392,98,18,160,139,969,PG
2008,25,16,64,8,16,0,0,8,16,2,7,7,5,12,0,1,1,2,13,18,PF
2008,29,5,34,2,7,0,0,2,7,2,4,2,7,9,0,0,4,1,6,6,C
2008,33,28,396,47,125,19,52,28,73,28,38,9,43,52,44,12,1,25,49,141,SG
2008,23,77,2806,728,1481,58,164,670,1317,464,590,178,393,571,259,98,39,253,253,1978,SF
2008,25,24,498,28,60,0,0,28,60,29,49,38,55,93,3,9,31,17,55,85,PF
2008,26,13,425,78,196,22,78,56,118,74,96,6,45,51,66,23,1,49,30,252,PG
2008,22,35,546,69,136,5,18,64,118,49,75,30,78,108,44,31,11,23,45,192,SF
2008,22,11,115,14,31,0,3,14,28,8,15,5,19,24,8,5,3,5,9,36,SF
2008,22,24,431,55,105,5,15,50,90,41,60,25,59,84,36,26,8,18,36,156,SF
2008,39,50,549,40,110,23,69,17,41,20,30,17,50,67,73,28,2,41,53,123,PG
2008,23,65,732,67,148,0,0,67,148,44,70,65,98,163,23,15,34,59,130,178,C
2008,28,62,1269,157,348,29,84,128,264,87,102,10,103,113,219,26,2,77,85,430,PG
2008,33,24,352,42,122,25,79,17,43,4,9,3,28,31,47,9,1,10,27,113,SG
2008,23,25,149,18,34,0,0,18,34,4,8,16,14,30,2,5,2,6,18,40,PF
2008,24,81,1732,261,587,71,195,190,392,99,138,107,217,324,75,45,34,58,159,692,SG
2008,23,65,952,91,186,1,12,90,174,41,95,83,133,216,40,44,30,37,132,224,SF
2008,26,36,569,86,191,40,102,46,89,27,35,4,41,45,61,14,13,37,65,239,PG
2008,26,24,310,44,109,25,65,19,44,12,16,3,17,20,25,8,8,16,38,125,PG
2008,26,12,259,42,82,15,37,27,45,15,19,1,24,25,36,6,5,21,27,114,PG
2008,25,82,2421,472,1021,164,422,308,599,175,213,40,191,231,216,75,18,117,195,1283,SG
2008,23,44,460,71,170,21,54,50,116,28,35,4,43,47,58,14,1,35,48,191,PG
2008,22,78,1861,280,725,90,261,190,464,142,169,50,238,288,89,23,37,88,211,792,PF
2008,27,73,1414,187,442,53,181,134,261,59,79,94,230,324,139,48,36,85,159,486,PF
2008,25,4,25,2,5,1,3,1,2,1,2,0,1,1,7,0,0,1,1,6,PG
2008,26,46,889,132,327,1,13,131,314,61,87,67,131,198,29,19,8,48,114,326,C
2008,36,31,554,77,160,48,112,29,48,19,20,12,43,55,54,17,3,18,43,221,SF
2008,22,79,1557,246,493,0,4,246,489,162,197,120,227,347,58,22,48,82,150,654,C
2008,32,15,103,17,25,0,0,17,25,7,10,9,17,26,3,2,4,4,20,41,PF
2008,29,80,2907,265,619,139,369,126,250,75,101,131,276,407,155,77,90,78,196,744,SF
2008,21,33,241,36,93,16,41,20,52,7,9,3,11,14,15,5,0,12,15,95,PG
2008,28,68,1628,185,486,74,217,111,269,70,87,31,136,167,210,52,2,76,121,514,SG
2008,31,75,2646,317,753,176,439,141,314,79,91,47,227,274,168,54,27,65,220,889,SG
2008,29,48,1573,248,603,93,248,155,355,78,100,16,144,160,290,54,4,119,97,667,PG
2008,29,15,473,78,192,24,61,54,131,23,31,11,45,56,75,19,2,38,34,203,PG
2008,29,33,1100,170,411,69,187,101,224,55,69,5,99,104,215,35,2,81,63,464,PG
2008,21,76,2078,340,543,0,0,340,543,116,187,256,488,744,75,56,94,85,262,796,C
2008,31,78,2522,393,877,137,342,256,535,401,437,42,170,212,529,101,17,160,130,1324,PG
2008,27,81,2424,261,640,121,298,140,342,49,64,31,164,195,413,55,4,113,133,692,PG
2008,21,82,1675,254,536,3,13,251,523,107,154,164,261,425,92,53,114,112,258,618,PF
2008,32,69,1542,238,515,17,44,221,471,88,138,69,194,263,41,33,34,70,133,581,C
2008,27,82,2198,241,588,148,409,93,179,81,110,42,224,266,104,59,10,53,164,711,SG
2008,23,78,2720,465,910,0,7,465,903,189,322,245,518,763,199,64,135,172,254,1119,C
2008,27,68,853,121,291,46,137,75,154,38,44,53,139,192,32,14,17,39,111,326,PF
2008,23,70,1773,238,434,0,0,238,434,99,217,192,317,509,55,36,61,68,155,575,PF
2008,31,31,204,9,27,0,0,9,27,6,10,6,32,38,8,6,18,4,35,24,C
2008,26,81,2827,709,1297,0,1,709,1296,290,393,197,647,844,233,100,41,210,293,1708,PF
2008,23,67,2425,507,1027,10,25,497,1002,472,559,174,409,583,171,63,67,153,157,1496,C
2008,36,81,2448,174,428,90,215,84,213,45,69,33,201,234,91,54,22,46,177,483,SF
2008,32,53,660,49,100,0,1,49,99,16,29,55,45,100,25,32,11,15,77,114,SF
2008,31,36,577,61,172,14,44,47,128,49,59,9,25,34,96,13,0,41,21,185,PG
2008,28,8,274,52,114,0,0,52,114,37,47,21,43,64,16,3,15,17,21,141,PF
2008,21,79,1803,182,486,7,36,175,450,88,110,82,210,292,111,76,25,89,188,459,SF
2008,22,76,2088,354,634,11,50,343,584,195,257,97,121,218,134,129,19,69,110,914,SG
2008,28,50,475,44,94,0,0,44,94,24,40,30,51,81,11,3,7,24,83,112,C
2008,28,20,267,17,43,0,0,17,43,3,5,14,30,44,6,0,3,15,35,37,C
2008,28,17,98,10,13,0,0,10,13,7,14,7,12,19,4,2,2,5,23,27,C
2008,28,13,110,17,38,0,0,17,38,14,21,9,9,18,1,1,2,4,25,48,C
2008,23,51,608,93,225,36,109,57,116,42,49,13,43,56,87,13,5,44,69,264,PG
2008,26,33,286,39,78,0,0,39,78,22,49,37,55,92,8,7,4,14,38,100,PF
2008,29,78,1762,217,531,45,146,172,385,107,142,65,198,263,175,52,7,99,144,586,SG
2008,25,38,713,72,142,0,0,72,142,40,98,51,137,188,45,22,23,51,82,184,C
2008,25,23,509,53,103,0,0,53,103,26,64,31,100,131,28,16,19,37,58,132,C
2008,25,15,204,19,39,0,0,19,39,14,34,20,37,57,17,6,4,14,24,52,C
2008,38,18,209,14,41,0,1,14,40,11,16,29,39,68,10,5,8,10,29,39,PF
2008,22,21,240,44,126,9,30,35,96,17,29,6,14,20,17,11,3,24,29,114,SG
2008,22,15,218,41,111,9,29,32,82,14,23,5,13,18,17,10,1,19,27,105,SG
2008,22,6,22,3,15,0,1,3,14,3,6,1,1,2,0,1,2,5,2,9,SG
2008,29,82,3192,775,1690,150,415,625,1275,623,742,94,423,517,441,151,40,257,227,2323,SG
2008,31,31,520,45,117,15,50,30,67,19,22,10,55,65,39,21,2,29,63,124,SG
2008,27,58,2314,439,943,66,185,373,758,236,262,93,295,388,284,128,20,150,160,1180,SF
2008,28,51,875,91,260,44,133,47,127,26,31,16,84,100,36,15,21,10,66,252,SF
2008,20,35,1008,189,297,0,0,189,297,82,118,105,251,356,61,12,72,52,98,460,C
2008,26,82,2484,367,707,79,184,288,523,109,120,34,202,236,678,87,6,126,134,922,PG
2008,33,79,2758,286,635,6,20,280,615,143,202,230,807,1037,259,85,285,118,216,721,C
2008,30,37,440,43,126,25,81,18,45,13,19,26,70,96,22,10,2,23,62,124,PF
2008,23,70,1039,158,392,38,120,120,272,55,81,50,99,149,32,39,23,34,96,409,SF
2008,27,80,2016,252,589,105,241,147,348,111,138,33,193,226,73,46,19,58,187,720,SG
2008,32,70,1960,218,476,45,129,173,347,64,85,27,173,200,388,107,28,124,172,545,PG
2008,31,76,2959,587,1287,98,273,489,1014,350,429,112,341,453,389,93,33,181,241,1622,SG
2008,38,55,1274,233,532,23,76,210,456,127,144,17,119,136,214,37,6,97,98,616,PG
2008,38,38,975,183,402,14,54,169,348,106,119,12,93,105,179,28,3,78,69,486,PG
2008,38,17,299,50,130,9,22,41,108,21,25,5,26,31,35,9,3,19,29,130,PG
2008,25,79,2783,377,605,0,1,377,604,175,295,322,606,928,81,45,84,136,243,929,C
2008,20,35,685,106,242,9,30,97,212,34,54,38,89,127,33,15,16,27,83,255,SF
2008,24,76,2274,327,573,22,60,305,513,222,275,174,199,373,117,71,43,98,129,898,SF
2008,29,70,702,36,82,0,1,36,81,46,74,40,76,116,37,10,6,22,106,118,C
2008,29,74,1172,53,113,0,1,53,112,34,74,64,114,178,25,23,25,48,194,140,C
2008,29,43,684,23,54,0,0,23,54,14,36,35,54,89,19,11,8,23,110,60,C
2008,29,31,488,30,59,0,1,30,58,20,38,29,60,89,6,12,17,25,84,80,C
2008,23,46,634,57,175,8,32,49,143,23,38,19,56,75,89,24,8,56,56,145,SG
2008,27,78,2223,322,641,0,2,322,639,123,167,254,476,730,113,47,60,118,250,767,PF
2008,20,53,1381,189,442,30,91,159,351,90,123,21,118,139,222,44,2,89,85,498,PG
2008,27,51,629,88,234,43,115,45,119,19,21,28,81,109,27,13,12,39,93,238,PF
2008,27,6,70,4,21,2,10,2,11,4,4,4,6,10,3,2,0,4,6,14,PF
2008,27,45,559,84,213,41,105,43,108,15,17,24,75,99,24,11,12,35,87,224,PF
2008,20,59,1441,196,514,79,238,117,276,47,57,20,157,177,75,23,9,63,157,518,SG
2008,27,80,3190,570,1391,176,494,394,897,329,381,37,170,207,398,81,17,192,144,1645,SG
2008,20,50,679,98,233,10,37,88,196,72,104,27,83,110,51,19,2,55,47,278,SG
2008,20,22,171,26,53,1,3,25,50,19,28,7,14,21,18,7,0,22,12,72,SG
2008,20,28,508,72,180,9,34,63,146,53,76,20,69,89,33,12,2,33,35,206,SG
2008,32,44,457,61,137,22,61,39,76,29,32,33,71,104,30,8,6,22,60,173,PF
2008,25,59,1530,297,544,0,0,297,544,187,300,111,164,275,32,14,29,126,157,781,C
2008,26,82,2724,339,661,0,1,339,660,186,263,304,545,849,45,40,192,155,269,864,C
2008,32,72,1755,178,277,0,0,178,277,84,146,207,332,539,63,24,106,80,226,440,C
2008,32,71,2161,205,447,17,74,188,373,170,219,23,180,203,340,69,2,91,78,597,PG
2008,27,74,1546,241,561,27,102,214,459,97,139,66,146,212,137,79,18,112,121,606,SG
2008,23,38,322,51,125,0,0,51,125,18,28,21,41,62,13,7,15,17,46,120,SF
2008,28,82,3196,650,1526,173,525,477,1001,318,424,96,289,385,623,191,43,232,247,1791,PG
2008,22,69,940,107,221,0,0,107,221,99,150,95,113,208,28,31,20,65,160,313,C
2008,23,22,194,24,65,0,0,24,65,6,10,25,22,47,10,6,6,9,33,54,PF
2008,28,82,2963,420,971,135,333,285,638,155,197,55,298,353,276,87,14,191,187,1130,SF
2008,25,82,1928,251,632,120,314,131,318,116,156,66,293,359,145,69,11,75,177,738,SG
2008,22,63,2128,429,896,8,22,421,874,204,265,136,258,394,155,57,29,120,117,1070,SF
2008,25,82,2308,308,646,13,41,295,605,96,129,97,281,378,317,61,39,155,166,725,PF
2008,25,54,542,55,134,21,66,34,68,22,31,23,39,62,37,8,3,16,61,153,SG
2008,22,6,18,1,4,0,1,1,3,3,5,2,0,2,1,0,0,0,0,5,SG
2008,29,67,1040,124,296,36,108,88,188,68,82,13,84,97,172,32,3,55,108,352,PG
2008,29,5,12,1,3,0,0,1,3,0,0,0,1,1,1,0,1,0,1,2,PF
2008,25,66,1356,159,430,74,233,85,197,64,71,26,89,115,251,35,4,55,107,456,PG
2008,24,30,305,64,134,0,0,64,134,40,47,38,47,85,10,7,3,20,43,168,PF
2008,26,79,1295,94,180,0,0,94,180,38,70,160,232,392,40,26,88,58,146,226,C
2008,26,52,894,67,115,0,0,67,115,24,40,111,159,270,26,20,63,42,100,158,C
2008,26,27,401,27,65,0,0,27,65,14,30,49,73,122,14,6,25,16,46,68,C
2008,29,53,668,106,258,30,72,76,186,21,26,15,60,75,97,21,2,54,62,263,PG
2008,29,36,424,59,160,17,39,42,121,18,19,9,38,47,65,21,2,35,38,153,PG
2008,29,17,244,47,98,13,33,34,65,3,7,6,22,28,32,0,0,19,24,110,PG
2008,30,24,257,28,63,0,0,28,63,1,2,16,33,49,7,10,10,12,44,57,C
2008,27,72,1334,198,423,22,65,176,358,163,193,7,94,101,133,36,5,61,131,581,PG
2008,23,74,876,132,335,42,122,90,213,48,52,17,66,83,53,30,12,59,80,354,PG
2008,22,73,1384,163,348,9,41,154,307,87,118,121,165,286,81,55,10,50,128,422,PF
2008,25,66,1490,133,344,54,155,79,189,65,80,19,97,116,263,48,2,71,92,385,PG
2008,31,78,2651,585,1178,0,4,585,1174,338,463,237,644,881,218,56,152,178,185,1508,C
2008,27,82,2953,532,1117,165,389,367,728,336,403,59,365,424,288,86,31,190,208,1565,SG
2008,27,5,21,1,3,0,0,1,3,2,2,1,7,8,1,1,0,0,0,4,SF
2008,27,4,18,1,3,0,0,1,3,2,2,1,7,8,1,1,0,0,0,4,SF
2008,19,80,2768,587,1366,59,205,528,1161,391,448,70,278,348,192,78,75,232,122,1624,SG
2008,22,81,3071,652,1227,12,52,640,1175,320,417,133,271,404,315,124,27,173,195,1636,SG
2008,31,63,813,92,236,0,1,92,235,26,37,50,150,200,24,15,20,47,96,210,C
2008,31,41,534,62,148,0,0,62,148,20,24,33,102,135,16,9,14,30,62,144,C
2008,31,22,279,30,88,0,1,30,87,6,13,17,48,65,8,6,6,17,34,66,C
2008,29,52,621,85,180,0,0,85,180,32,58,28,117,145,22,7,18,42,79,202,C
2008,29,75,1720,262,545,81,209,181,336,59,83,92,126,218,81,46,10,40,142,664,SG
2008,29,7,96,9,28,1,7,8,21,12,15,4,5,9,12,5,1,0,10,31,SG
2008,29,68,1624,253,517,80,202,173,315,47,68,88,121,209,69,41,9,40,132,633,SG
2008,27,81,1879,152,346,1,1,151,345,120,257,224,387,611,65,86,8,108,213,425,PF
2008,21,82,1690,291,631,114,307,177,324,53,78,39,144,183,225,77,5,108,105,749,PG
2008,22,26,269,46,82,0,2,46,80,15,22,34,55,89,11,8,11,13,25,107,PF
2008,22,4,9,2,5,0,0,2,5,0,0,1,2,3,0,0,0,0,0,4,PF
2008,22,22,260,44,77,0,2,44,75,15,22,33,53,86,11,8,11,13,25,103,PF
2008,23,79,2972,412,997,56,200,356,797,260,325,37,199,236,583,96,12,213,184,1140,PG
2008,21,9,70,6,16,0,0,6,16,2,4,14,11,25,2,0,3,8,19,14,C
2008,34,82,2204,315,761,132,357,183,404,64,80,27,227,254,114,29,10,56,93,826,SG
2008,33,82,2249,339,777,112,276,227,501,166,188,24,146,170,239,86,3,90,188,956,PG
2008,24,51,1199,246,524,15,51,231,473,110,125,23,77,100,313,54,0,102,93,617,PG
2008,31,77,1884,205,373,0,3,205,370,86,145,264,404,668,129,56,32,62,221,496,C
2008,24,39,1259,198,462,61,148,137,314,53,65,13,115,128,164,36,3,79,102,510,PG
2008,32,82,774,70,153,0,0,70,153,16,34,71,137,208,18,16,45,32,94,156,C
2008,30,10,163,20,54,7,25,13,29,0,2,4,10,14,8,2,0,6,7,47,SG
2008,30,10,199,19,57,4,17,15,40,13,23,8,15,23,30,9,5,14,25,55,PG
2008,24,78,1342,221,453,3,10,218,443,85,109,107,247,354,57,29,27,55,208,530,C
2008,29,51,534,64,154,0,1,64,153,33,63,67,77,144,11,20,24,34,83,161,C
2008,30,7,74,8,25,6,16,2,9,0,0,2,13,15,3,3,0,1,2,22,PF
2008,26,79,2096,348,752,113,289,235,463,162,208,52,212,264,128,96,50,128,232,971,SF
2008,22,4,45,9,23,3,12,6,11,0,2,3,1,4,1,0,0,4,4,21,SG
2008,31,71,2328,534,990,0,11,534,979,269,336,135,520,655,244,100,89,138,163,1337,PF
2008,31,31,284,27,80,8,37,19,43,4,5,9,35,44,13,6,1,17,35,66,PF
2008,27,66,2351,475,890,4,16,471,874,292,362,155,398,553,211,30,98,124,139,1246,C
2008,27,39,1433,279,557,4,15,275,542,176,215,94,248,342,116,16,56,80,85,738,C
2008,27,27,918,196,333,0,1,196,332,116,147,61,150,211,95,14,42,44,54,508,C
2008,21,81,3000,625,1355,134,387,491,968,248,316,140,359,499,158,111,79,190,230,1632,SF
2008,24,39,465,69,157,16,37,53,120,14,18,16,42,58,33,10,9,27,31,168,SG
2008,30,53,821,74,207,22,68,52,139,24,34,28,109,137,35,19,13,24,90,194,SF
2008,21,58,1765,201,465,118,268,83,197,85,105,30,104,134,145,47,14,76,163,605,PG
2008,29,14,154,12,31,5,15,7,16,9,9,1,21,22,22,7,2,9,18,38,PG
2008,29,13,149,12,29,5,14,7,15,9,9,1,21,22,21,7,2,8,18,38,PG
2008,29,1,5,0,2,0,1,0,1,0,0,0,0,0,1,0,0,1,0,0,PG
2008,30,74,2299,453,984,156,389,297,595,380,442,63,291,354,332,109,33,200,173,1442,SG
2008,30,56,831,133,302,36,99,97,203,23,26,16,80,96,62,24,4,52,82,325,SG
2008,30,22,279,41,102,12,34,29,68,1,1,6,25,31,16,13,1,21,24,95,SG
2008,30,12,110,13,41,5,15,8,26,6,8,1,13,14,11,3,1,8,9,37,SG
2008,30,22,442,79,159,19,50,60,109,16,17,9,42,51,35,8,2,23,49,193,SG
2008,25,82,2434,392,857,59,179,333,678,190,229,133,342,475,145,65,10,96,154,1033,PF
2008,26,69,2122,332,740,0,6,332,734,162,215,175,415,590,81,48,53,122,203,826,PF
2008,26,51,1564,232,523,0,3,232,520,110,151,117,306,423,50,35,30,91,144,574,PF
2008,26,18,558,100,217,0,3,100,214,52,64,58,109,167,31,13,23,31,59,252,PF
2008,24,72,2291,464,1069,142,346,322,723,266,293,40,181,221,213,55,8,150,171,1336,SG
2008,23,6,41,8,17,0,0,8,17,2,3,8,8,16,2,1,1,2,4,18,C
2008,25,38,331,49,113,2,3,47,110,38,45,18,49,67,15,3,0,23,47,138,SF
2008,25,22,128,34,58,7,14,27,44,12,16,4,18,22,9,4,1,10,14,87,SF
2008,24,80,2876,537,1205,171,423,366,782,322,378,93,393,486,166,95,84,171,290,1567,SF
2008,23,61,613,103,204,0,1,103,203,56,99,70,98,168,41,21,16,57,117,262,C
2008,22,30,362,52,151,15,39,37,112,34,41,13,51,64,29,8,4,32,45,153,SF
2008,22,29,358,49,148,15,39,34,109,34,41,11,51,62,29,8,4,32,43,147,SF
2008,22,1,4,3,3,0,0,3,3,0,0,2,0,2,0,0,0,0,2,6,SF
2008,21,80,2253,320,749,21,76,299,673,177,238,101,278,379,119,46,49,158,198,838,SF
2008,21,8,44,4,16,1,8,3,8,8,8,0,4,4,8,1,0,7,3,17,PG
2008,21,9,30,3,9,1,3,2,6,3,4,0,6,6,3,1,0,2,2,10,SG
2008,26,74,1970,379,870,51,179,328,691,112,148,32,150,182,151,54,22,109,119,921,SG
2008,25,7,61,3,11,0,1,3,10,0,0,0,6,6,3,3,1,7,9,6,SG
2008,33,22,222,24,60,0,0,24,60,3,7,19,18,37,22,12,1,16,19,51,SG
2008,33,13,85,6,16,0,0,6,16,2,2,9,13,22,5,5,1,5,8,14,SF
2008,29,72,2424,499,1030,62,141,437,889,184,221,75,160,235,299,73,10,132,171,1244,SG
2008,36,16,325,22,60,8,19,14,41,8,9,3,32,35,35,19,1,13,24,60,SF
2008,31,76,1374,237,474,2,10,235,464,146,205,96,144,240,82,45,14,95,162,622,SF
2008,27,81,2190,401,923,153,408,248,515,147,190,107,332,439,132,74,16,90,266,1102,C
2008,34,22,166,18,42,0,0,18,42,10,16,11,31,42,4,1,4,11,34,46,C
2008,24,64,2022,321,693,56,167,265,526,248,301,28,145,173,369,90,10,161,190,946,PG
2008,24,39,1184,187,387,25,70,162,317,161,196,17,74,91,206,56,2,93,127,560,PG
2008,24,25,838,134,306,31,97,103,209,87,105,11,71,82,163,34,8,68,63,386,PG
2008,24,17,159,27,54,0,2,27,52,8,13,24,30,54,3,6,3,9,16,62,PF
2008,25,55,702,90,170,0,0,90,170,49,96,43,75,118,14,20,59,58,164,229,C
2008,29,57,606,58,180,11,31,47,149,38,45,5,50,55,86,30,3,28,75,165,PG
2008,27,49,1805,237,507,0,0,237,507,115,142,107,336,443,68,39,18,67,145,589,PF
2008,28,63,773,57,135,2,9,55,126,7,10,20,63,83,41,13,3,22,90,123,SG
2008,28,37,463,37,80,1,4,36,76,1,2,11,33,44,26,9,1,14,55,76,SG
2008,28,26,310,20,55,1,5,19,50,6,8,9,30,39,15,4,2,8,35,47,SG
2008,19,71,931,146,318,4,21,142,297,38,58,68,162,230,44,14,40,56,128,334,C
2008,24,79,1575,113,221,0,3,113,218,11,24,132,295,427,91,85,43,62,212,237,PF
2008,26,82,1287,217,504,73,194,144,310,45,60,35,143,178,62,47,6,47,137,552,SF
2008,28,80,2228,316,599,0,0,316,599,216,294,273,303,576,71,31,133,108,216,848,C
2008,25,73,1379,206,477,79,225,127,252,66,81,18,117,135,138,44,9,70,75,557,SG
2008,28,45,373,56,144,20,64,36,80,21,25,22,51,73,18,7,1,12,24,153,PF
2008,28,17,174,25,65,9,26,16,39,9,10,10,26,36,4,4,0,4,12,68,PF
2008,28,28,199,31,79,11,38,20,41,12,15,12,25,37,14,3,1,8,12,85,PF
2008,25,16,266,29,71,0,1,29,70,27,49,30,57,87,15,9,14,21,46,85,PF
2008,35,70,2222,358,712,33,104,325,608,170,196,74,279,353,203,65,56,96,153,919,SF
2008,27,75,2380,330,797,84,240,246,557,118,142,28,216,244,452,87,19,157,224,862,PG
2008,23,60,532,46,94,0,0,46,94,55,82,53,54,107,14,10,30,25,96,147,PF
2008,21,81,2540,333,668,0,5,333,663,155,212,248,537,785,124,60,76,137,267,821,C
2008,37,45,583,38,119,18,70,20,49,18,28,35,74,109,47,21,19,22,55,112,PF
2008,29,78,1480,217,531,117,298,100,233,33,36,19,148,167,152,59,10,76,114,584,PG
2008,22,82,3088,583,974,0,4,583,970,529,897,279,882,1161,110,74,176,263,274,1695,C
2008,27,76,2757,567,1247,67,210,500,1037,312,384,120,412,532,164,59,32,114,202,1513,SF
2008,34,50,353,23,64,0,0,23,64,11,14,21,60,81,17,5,2,17,62,57,PF
2008,31,9,93,9,31,4,12,5,19,6,6,0,7,7,9,3,0,7,4,28,PG
2008,29,40,1210,180,478,43,126,137,352,88,108,27,116,143,94,60,11,72,91,491,PG
2008,29,28,810,125,323,24,68,101,255,62,80,12,75,87,87,39,6,44,48,336,SG
2008,22,70,925,161,333,0,2,161,331,75,124,90,169,259,28,25,28,47,107,397,PF
2008,37,24,215,22,64,7,26,15,38,7,9,4,9,13,33,13,2,13,30,58,PG
2008,26,19,120,15,28,0,0,15,28,9,20,10,19,29,0,0,6,7,20,39,C
2008,24,82,3242,582,1277,101,307,481,970,365,506,85,361,446,391,171,49,214,187,1630,SF
2008,32,73,2222,417,879,0,1,417,878,195,243,263,419,682,104,34,120,135,247,1029,C
2008,27,42,326,39,84,0,0,39,84,5,12,28,44,72,10,7,26,12,70,83,C
2008,27,16,130,9,23,0,0,9,23,1,2,13,18,31,4,3,10,4,32,19,C
2008,27,26,196,30,61,0,0,30,61,4,10,15,26,41,6,4,16,8,38,64,C
2008,32,82,3424,712,1556,95,275,617,1281,645,797,47,196,243,586,160,12,245,109,2164,SG
2008,26,75,1437,149,378,35,107,114,271,85,117,38,80,118,160,45,7,75,166,418,PG
2008,24,82,2229,267,620,65,190,202,430,215,248,31,203,234,313,61,1,178,129,814,SG
2008,34,46,891,116,296,53,144,63,152,40,49,23,87,110,76,32,3,31,59,325,SG
2008,34,26,498,88,210,28,82,60,128,24,32,10,61,71,63,13,2,28,37,228,PG
2008,26,14,228,26,80,11,30,15,50,16,23,7,26,33,17,8,0,9,22,79,SF
2008,29,73,2855,488,1204,182,501,306,703,308,370,67,251,318,300,92,29,197,171,1466,SF
2008,26,53,547,39,115,16,72,23,43,13,17,12,53,65,20,5,1,16,34,107,SG
2008,32,2,5,1,1,0,0,1,1,2,2,0,3,3,0,0,0,0,0,4,C
2008,23,75,3027,794,1642,113,359,681,1283,549,771,133,459,592,539,138,81,255,165,2250,SF
2008,32,54,720,101,290,31,97,70,193,39,48,14,55,69,60,21,2,36,56,272,PG
2008,32,33,537,79,226,24,74,55,152,33,42,11,41,52,54,17,2,29,44,215,PG
2008,32,21,183,22,64,7,23,15,41,6,6,3,14,17,6,4,0,7,12,57,PG
2008,31,79,3061,618,1417,120,354,498,1063,333,438,215,591,806,120,106,34,113,195,1689,PF
2008,29,75,2189,227,528,46,127,181,401,121,163,38,184,222,311,97,32,128,180,621,SG
2008,23,82,2919,721,1441,0,5,721,1436,284,394,308,603,911,117,74,119,167,222,1726,C
2008,27,82,3200,619,1328,77,213,542,1115,542,679,93,249,342,252,76,21,199,225,1857,SF
2008,26,73,1325,108,270,4,25,104,245,49,93,118,125,243,66,36,23,64,132,269,SF
2008,20,66,1647,219,520,6,21,213,499,122,145,106,238,344,55,36,56,90,153,566,PF
2008,24,43,549,61,125,0,0,61,125,57,83,32,62,94,13,13,10,42,80,179,PF
2008,20,62,764,92,165,0,0,92,165,37,55,87,148,235,29,24,82,39,141,221,PF
2008,33,69,1531,155,355,42,93,113,262,35,43,22,115,137,262,52,9,84,115,387,PG
2008,33,42,1121,115,267,27,63,88,204,26,32,17,81,98,202,42,8,50,86,283,PG
2008,33,27,410,40,88,15,30,25,58,9,11,5,34,39,60,10,1,34,29,104,PG
2008,27,5,28,7,14,3,9,4,5,0,2,0,1,1,1,1,0,0,4,17,SF
2008,26,82,3343,647,1497,169,444,478,1053,316,379,83,284,367,474,84,18,223,168,1779,SG
2008,27,8,63,9,19,1,3,8,16,2,2,5,9,14,4,0,1,5,11,21,PF
2008,27,6,53,7,14,1,2,6,12,0,0,5,8,13,3,0,1,2,10,15,PF
2008,27,2,10,2,5,0,1,2,4,2,2,0,1,1,1,0,0,3,1,6,PF
2008,24,25,222,26,64,9,23,17,41,23,28,11,27,38,11,5,1,14,46,84,C
2008,24,9,137,14,36,3,13,11,23,9,10,10,17,27,11,5,2,5,17,40,SF
2008,24,4,9,2,4,0,0,2,4,0,0,0,1,1,0,1,0,1,3,4,SF
2008,24,6,143,17,32,6,15,11,17,8,13,8,16,24,5,2,0,7,18,48,SF
2008,24,3,20,1,4,0,2,1,2,0,0,0,2,2,1,2,0,1,1,2,SF
2008,27,25,206,23,53,1,6,22,47,34,51,7,28,35,12,8,6,10,28,81,SG
2008,31,67,1336,151,363,115,276,36,87,20,28,5,67,72,126,19,1,36,66,437,SG
2008,24,56,472,25,47,0,1,25,46,28,58,69,71,140,10,10,25,17,88,78,PF
2008,36,47,922,66,180,34,116,32,64,10,14,18,114,132,69,26,8,29,72,176,SG
2008,28,70,1757,182,432,74,192,108,240,94,126,30,140,170,166,48,18,78,140,532,SG
2008,27,58,1276,143,327,91,205,52,122,86,98,43,118,161,34,24,15,28,96,463,SF
2008,23,35,145,12,30,0,2,12,28,11,20,19,23,42,0,3,5,11,28,35,PF
2008,25,56,2083,338,700,0,4,338,696,202,265,173,538,711,107,33,155,164,179,878,C
2008,26,81,1530,243,498,57,118,186,380,37,43,31,89,120,65,34,2,58,131,580,SF
2008,24,17,71,9,26,4,13,5,13,8,10,3,11,14,9,4,2,5,4,30,SG
2008,25,9,105,12,31,0,1,12,30,8,14,6,14,20,8,6,0,6,11,32,PF
2008,34,80,2906,305,793,119,312,186,481,135,165,94,506,600,806,136,26,266,165,864,PG
2008,34,51,1895,201,549,84,236,117,313,91,111,58,354,412,530,74,15,185,90,577,PG
2008,34,29,1011,104,244,35,76,69,168,44,54,36,152,188,276,62,11,81,75,287,PG
2008,23,11,96,16,38,3,7,13,31,5,6,3,9,12,2,3,0,3,11,40,SG
2008,26,72,2217,275,544,44,116,231,428,198,257,121,218,339,285,86,109,140,165,792,SF
2008,23,79,1889,311,659,94,277,217,382,164,213,92,241,333,95,44,19,89,181,880,SF
2008,32,74,1674,138,342,0,6,138,336,62,71,15,127,142,328,100,11,71,160,338,PG
2008,26,25,657,90,227,38,108,52,119,31,34,12,61,73,33,20,6,28,67,249,PF
2008,26,50,1075,165,348,73,188,92,160,88,96,9,90,99,68,22,23,47,125,491,SG
2008,24,45,812,123,300,0,2,123,298,52,69,35,165,200,27,9,17,41,111,298,C
2008,31,39,291,27,61,0,4,27,57,11,19,28,39,67,6,12,17,10,59,65,C
2008,24,42,711,135,219,0,1,135,218,72,109,96,111,207,21,17,7,26,98,342,PF
2008,24,2,10,1,4,0,0,1,4,0,0,0,2,2,0,0,0,0,1,2,SG
2008,25,15,303,32,71,0,0,32,71,19,32,26,27,53,3,13,22,15,35,83,PF
2008,23,56,865,95,237,7,34,88,203,38,48,12,45,57,113,29,0,56,73,235,PG
2008,24,81,2356,341,618,0,2,341,616,194,237,242,482,724,95,55,29,97,210,876,PF
2008,28,81,3076,516,1135,226,553,290,582,218,260,97,340,437,196,99,38,140,214,1476,PF
2008,21,82,2089,256,592,36,140,220,452,243,348,41,209,250,296,92,22,127,185,791,PG
2008,30,50,736,113,253,39,86,74,167,25,32,9,45,54,74,11,1,27,66,290,PG
2008,30,33,564,86,196,30,69,56,127,24,28,9,32,41,59,11,0,22,38,226,PG
2008,30,17,172,27,57,9,17,18,40,1,4,0,13,13,15,0,1,5,28,64,PG
2008,32,20,151,3,19,0,0,3,19,3,12,18,20,38,4,3,2,9,25,9,PF
2008,28,70,2502,458,1000,78,203,380,797,553,681,78,316,394,189,71,7,195,210,1547,SF
2008,29,31,286,18,55,0,0,18,55,20,44,19,70,89,7,1,10,30,50,56,C
2008,29,24,259,15,49,0,0,15,49,14,31,18,63,81,7,0,10,23,42,44,C
2008,29,7,27,3,6,0,0,3,6,6,13,1,7,8,0,1,0,7,8,12,C
2008,21,6,23,6,12,0,0,6,12,9,9,0,5,5,1,0,4,2,4,21,C
2008,30,24,805,111,265,28,74,83,191,83,116,17,42,59,113,21,2,48,57,333,PG
2008,29,63,2315,400,787,66,198,334,589,106,150,136,507,643,138,125,85,86,150,972,PF
2008,29,47,1713,304,578,58,167,246,411,77,108,86,378,464,98,95,70,49,117,743,PF
2008,29,16,602,96,209,8,31,88,178,29,42,50,129,179,40,30,15,37,33,229,PF
2008,32,19,130,23,43,1,4,22,39,12,19,9,27,36,4,3,10,8,23,59,C
2008,34,26,340,32,98,15,53,17,45,19,22,24,52,76,10,6,16,15,31,98,PF
2008,34,11,156,13,44,8,23,5,21,7,9,9,21,30,5,2,9,6,16,41,PF
2008,34,15,184,19,54,7,30,12,24,12,13,15,31,46,5,4,7,9,15,57,PF
2008,36,17,141,10,43,2,16,8,27,5,6,3,4,7,21,6,0,1,12,27,PG
2008,30,71,2159,376,699,2,11,374,688,123,212,105,356,461,90,88,85,91,235,877,PF
2008,24,61,2216,417,914,107,266,310,648,502,578,48,225,273,129,62,5,131,150,1443,SG
2008,30,59,1702,230,477,0,0,230,477,114,173,75,181,256,121,40,30,83,106,574,SF
2008,27,80,1708,266,600,130,327,136,273,62,71,17,113,130,134,40,18,69,140,724,PG
2008,24,82,1768,240,446,0,1,240,445,171,270,177,256,433,46,21,94,71,183,651,C
2008,23,75,2020,428,944,142,349,286,595,116,155,50,156,206,162,66,18,172,234,1114,SG
2008,30,6,33,1,1,0,0,1,1,1,2,1,6,7,0,0,5,4,7,3,C
2008,33,78,2285,293,600,0,2,293,598,97,156,204,462,666,89,61,53,75,246,683,PF
2008,28,66,2440,548,1307,86,295,462,1012,245,358,42,297,339,387,68,30,160,91,1427,SG
2008,22,70,695,39,103,1,6,38,97,14,32,53,86,139,40,20,26,40,76,93,SG
2008,33,54,1410,108,249,3,19,105,230,23,30,16,80,96,220,23,3,76,120,242,PG
2008,20,8,28,6,10,0,1,6,9,0,0,2,8,10,2,1,0,2,1,12,PF
2008,28,23,278,32,95,0,0,32,95,18,27,28,49,77,13,4,14,17,42,82,C
2008,20,60,689,113,236,30,77,83,159,41,52,16,62,78,53,32,8,27,98,297,SG
2008,22,70,1663,219,500,0,1,219,499,67,121,127,297,424,58,32,114,101,185,505,C
2008,31,82,3016,569,1156,3,34,566,1122,257,333,95,229,324,565,105,6,206,181,1398,PG
2008,31,72,2513,337,728,28,90,309,638,262,309,167,514,681,264,69,74,164,247,964,C
2008,27,70,2474,414,824,155,359,259,465,164,212,51,416,467,240,35,16,182,145,1147,SG
2008,22,82,1702,253,502,0,4,253,498,155,229,167,293,460,81,72,73,87,269,661,PF
2008,27,55,2044,432,852,0,2,432,850,345,406,172,422,594,129,25,111,183,171,1209,C
2008,32,77,2702,377,870,67,192,310,678,163,199,50,225,275,202,78,34,123,152,984,SG
2008,30,82,1650,272,528,0,1,272,527,95,163,194,300,494,72,45,60,101,230,639,C
2008,30,21,228,28,59,0,1,28,58,13,30,29,44,73,6,7,8,11,36,69,C
2008,30,61,1422,244,469,0,0,244,469,82,133,165,256,421,66,38,52,90,194,570,C
2008,27,78,2166,279,575,40,122,239,453,63,85,92,392,484,90,80,108,51,152,661,SF
2008,32,82,2385,282,489,0,2,282,487,134,182,160,334,494,84,35,46,110,310,698,PF
2008,22,18,181,21,58,0,0,21,58,14,29,12,25,37,2,4,2,9,37,56,C
2008,37,25,389,52,95,0,0,52,95,45,76,34,59,93,7,4,42,25,56,149,C
2008,27,75,2106,315,693,94,236,221,457,192,241,108,435,543,165,49,32,96,217,916,PF
2008,28,42,874,154,367,20,63,134,304,68,98,23,60,83,144,38,4,84,50,396,PG
2008,28,19,347,57,139,6,27,51,112,22,37,13,23,36,64,13,1,31,19,142,PG
2008,28,23,527,97,228,14,36,83,192,46,61,10,37,47,80,25,3,53,31,254,PG
2008,41,39,619,43,80,0,0,43,80,32,45,68,131,199,5,11,48,17,55,118,C
2008,27,75,1660,245,609,94,262,151,347,154,196,56,204,260,88,44,21,85,182,738,PF
2008,31,78,1664,174,368,53,147,121,221,63,89,113,224,337,95,69,40,59,199,464,PF
2008,33,81,2780,485,962,179,381,306,581,222,245,28,254,282,898,53,5,295,113,1371,PG
2008,27,82,2117,308,766,156,432,152,334,124,146,34,176,210,177,48,1,134,94,896,SG
2008,25,69,1961,283,603,64,154,219,449,125,151,28,215,243,383,63,4,141,167,755,PG
2008,31,71,1486,257,467,1,3,256,464,37,49,130,212,342,82,20,52,60,132,552,C
2008,33,41,650,71,158,15,45,56,113,20,26,41,73,114,14,27,7,31,64,177,SG
2008,33,2,17,2,7,0,2,2,5,0,0,0,0,0,1,0,0,0,0,4,SF
2008,33,6,31,3,9,1,2,2,7,0,0,6,5,11,3,1,1,3,5,7,SF
2008,23,14,44,6,23,3,13,3,10,0,0,0,5,5,1,0,3,4,4,15,SF
2008,23,3,14,1,8,0,3,1,5,0,0,0,1,1,0,0,0,2,0,2,SF
2008,23,11,30,5,15,3,10,2,5,0,0,0,4,4,1,0,3,2,4,13,SF
2008,22,74,1534,177,367,0,1,177,366,134,194,174,242,416,84,68,64,89,173,488,C
2008,28,82,2021,379,877,126,346,253,531,196,243,48,294,342,95,25,43,133,245,1080,SF
2008,24,35,264,49,102,34,71,15,31,3,4,4,31,35,6,2,3,4,17,135,SF
2008,29,77,2769,630,1314,79,220,551,1094,478,544,95,564,659,266,51,71,160,198,1817,PF
2008,21,24,99,16,29,0,0,16,29,3,5,10,19,29,4,4,9,7,27,35,C
2008,29,42,1206,225,512,0,5,225,507,121,163,82,201,283,93,20,87,106,129,571,C
2008,35,61,1748,331,558,0,0,331,558,170,338,166,388,554,93,32,88,181,228,832,C
2008,35,33,945,191,329,0,0,191,329,88,178,99,159,258,45,19,54,98,134,470,C
2008,35,28,803,140,229,0,0,140,229,82,160,67,229,296,48,13,34,83,94,362,C
2008,32,82,1644,180,296,0,1,180,295,37,61,153,277,430,95,37,20,51,203,397,PF
2008,28,77,2921,417,795,31,113,386,682,229,328,197,622,819,273,75,72,156,222,1094,PF
2008,25,82,2718,460,860,0,0,460,860,213,374,255,621,876,70,62,138,164,241,1133,C
2008,28,72,2390,374,841,114,294,260,547,185,230,132,424,556,145,55,29,104,236,1047,C
2008,35,40,300,29,69,0,1,29,68,12,15,4,15,19,38,10,0,5,28,70,SG
2008,36,2,7,2,3,0,0,2,3,0,0,0,0,0,0,0,0,1,1,4,PF
2008,23,82,2186,417,964,40,101,377,863,218,294,96,280,376,106,59,63,107,173,1092,PF
2008,27,31,392,40,107,18,40,22,67,25,34,13,34,47,47,13,3,24,37,123,PG
2008,23,62,944,107,245,0,3,107,242,108,153,89,159,248,36,24,13,69,140,322,C
2008,28,80,1497,254,652,65,186,189,466,71,81,26,104,130,192,50,5,93,123,644,SG
2008,32,82,2634,395,829,133,304,262,525,102,125,50,284,334,183,79,17,87,157,1025,SG
2008,26,28,592,64,184,18,78,46,106,19,28,4,47,51,84,24,6,44,60,165,PG
2008,26,9,183,17,54,6,24,11,30,3,4,2,17,19,15,5,3,8,13,43,PG
2008,26,19,409,47,130,12,54,35,76,16,24,2,30,32,69,19,3,36,47,122,PG
2008,25,69,2312,515,1043,17,66,498,977,248,347,30,191,221,411,55,8,164,93,1295,PG
2008,32,20,327,39,86,0,2,39,84,24,43,24,40,64,17,21,7,27,37,102,SF
2008,22,80,3006,630,1291,92,249,538,1042,332,390,62,259,321,925,217,4,201,185,1684,PG
2008,24,51,1188,146,403,34,114,112,289,53,77,35,93,128,82,29,6,55,117,379,SG
2008,22,35,320,44,125,17,60,27,65,20,31,21,45,66,7,6,5,17,30,125,C
2008,23,78,1912,214,348,0,1,214,347,114,183,145,329,474,84,31,114,125,242,542,C
2008,22,7,38,3,10,0,0,3,10,4,6,6,7,13,1,0,2,1,6,10,C
2008,30,76,1796,215,516,113,287,102,229,65,85,36,170,206,67,47,7,41,125,608,SG
2008,22,72,1310,184,439,0,1,184,438,64,87,98,272,370,32,35,42,73,173,432,C
2008,37,16,113,12,33,11,26,1,7,4,4,1,11,12,10,0,1,6,11,39,SF
2008,30,80,2874,509,1098,143,365,366,733,409,485,53,358,411,363,101,36,221,200,1570,SF
2008,25,66,1316,170,387,66,183,104,204,66,98,67,175,242,49,66,43,48,200,472,SF
2008,32,22,173,12,23,0,0,12,23,15,22,14,23,37,3,3,6,5,43,39,C
2008,31,74,1821,173,414,106,279,67,135,93,115,30,292,322,114,72,19,65,182,545,PF
2008,24,56,809,154,269,0,1,154,268,137,193,95,132,227,15,15,16,43,127,445,C
2008,25,64,1228,145,315,0,3,145,312,63,87,115,216,331,47,14,23,65,130,353,C
2008,26,11,304,35,95,8,33,27,62,6,9,8,36,44,18,9,2,5,18,84,SF
2008,24,61,588,88,204,26,75,62,129,26,38,8,38,46,78,32,3,30,83,228,PG
2008,27,82,2694,421,940,53,146,368,794,185,241,109,289,398,268,42,33,91,90,1080,SF
2008,21,15,95,14,39,3,12,11,27,1,2,1,7,8,13,5,0,5,10,32,PG
2008,28,77,1819,144,250,0,1,144,249,83,122,195,454,649,27,13,93,95,234,371,C
2008,24,60,1340,158,373,64,159,94,214,85,98,11,107,118,178,46,4,55,90,465,PG
2008,27,65,1483,198,437,95,234,103,203,52,65,56,159,215,123,46,12,73,147,543,SF
2008,24,9,27,4,14,0,0,4,14,0,0,9,2,11,3,1,3,2,5,8,PF
2008,26,69,2244,486,1058,22,80,464,978,223,289,184,526,710,140,59,16,186,194,1217,C
2008,34,10,214,23,45,0,1,23,44,17,25,13,26,39,7,3,19,12,30,63,PF
2008,34,16,223,18,40,0,0,18,40,12,18,19,31,50,7,4,18,9,29,48,C
2008,28,72,2702,550,1243,130,359,420,884,402,490,85,224,309,247,65,13,181,120,1632,SG
2008,23,34,276,48,108,17,43,31,65,27,34,1,22,23,16,4,0,15,29,140,SG
2008,23,52,556,41,87,0,0,41,87,16,27,52,83,135,18,10,12,24,83,98,C
2008,27,82,3149,648,1468,243,599,405,869,249,331,80,361,441,258,116,57,166,241,1788,SF
2008,23,3,15,0,6,0,2,0,4,0,0,0,1,1,1,0,0,1,2,0,SF
2008,23,5,29,3,7,2,5,1,2,2,2,0,1,1,1,1,0,0,5,10,SG
2008,23,19,88,13,31,5,12,8,19,0,0,1,6,7,0,2,0,5,6,31,SF
2008,27,65,1841,199,555,69,214,130,341,60,88,56,259,315,116,44,15,69,153,527,SF
2008,26,61,1223,147,368,21,71,126,297,78,91,13,81,94,241,37,14,80,120,393,PG
2008,23,72,1883,331,782,97,292,234,490,154,196,51,171,222,212,60,1,103,186,913,PG
2008,21,72,628,69,196,17,58,52,138,25,38,13,45,58,123,24,0,53,57,180,PG
2008,21,77,2306,351,713,5,19,346,694,107,175,78,244,322,393,129,13,147,187,814,PG
2008,33,49,494,66,180,2,7,64,173,37,51,31,72,103,28,16,7,40,80,171,PF
2008,26,76,1505,131,335,9,21,122,314,40,60,54,118,172,88,43,33,29,132,311,SG
2008,23,74,2792,531,1170,73,215,458,955,281,373,81,267,348,430,79,16,136,147,1416,SG
2008,31,46,632,33,62,0,0,33,62,25,63,90,96,186,24,31,19,19,93,91,C
2008,27,71,1504,228,569,102,262,126,307,30,42,19,149,168,89,42,19,62,108,588,SG
2008,28,81,2517,381,799,39,120,342,679,214,260,76,273,349,208,93,31,170,171,1015,SG
2008,23,4,31,3,4,0,0,3,4,1,2,3,4,7,0,1,2,1,8,7,C
2008,29,48,512,29,94,15,46,14,48,15,20,22,57,79,40,9,8,26,63,88,PF
2008,27,82,2024,345,670,0,3,345,667,157,235,174,351,525,106,60,19,105,235,847,PF
2008,23,69,1436,180,421,29,88,151,333,75,104,50,205,255,129,61,30,93,128,464,SG
2008,21,13,62,11,24,0,0,11,24,8,17,7,9,16,1,0,7,0,9,30,C
2008,21,17,450,51,117,3,7,48,110,32,41,8,50,58,127,17,3,36,26,137,PG
2008,27,70,1521,209,496,60,171,149,325,53,70,67,159,226,80,50,5,78,140,531,SF
2008,22,14,87,4,14,0,0,4,14,0,10,6,12,18,0,2,5,6,8,8,PF
2008,22,7,68,2,6,0,0,2,6,0,8,5,10,15,0,2,5,4,7,4,PF
2008,22,7,19,2,8,0,0,2,8,0,2,1,2,3,0,0,0,2,1,4,PF
2008,24,3,11,0,1,0,0,0,1,0,0,1,1,2,1,0,0,0,2,0,C
2008,31,66,844,92,198,2,3,90,195,33,63,63,175,238,15,21,77,39,112,219,C
2008,24,77,1547,297,528,0,9,297,519,133,200,123,230,353,60,36,17,89,217,727,PF
2008,22,74,1421,311,674,157,390,154,284,128,178,43,109,152,128,62,12,112,144,907,SG
2008,21,76,1107,141,310,4,14,137,296,54,82,77,153,230,20,22,50,48,142,340,PF
2008,32,77,1726,312,653,0,3,312,650,154,204,163,238,401,66,34,47,71,186,778,PF
2008,32,50,1146,225,483,0,1,225,482,109,135,108,157,265,47,25,31,49,113,559,PF
2008,32,27,580,87,170,0,2,87,168,45,69,55,81,136,19,9,16,22,73,219,PF
2008,22,81,2873,518,1133,25,99,493,1034,333,469,161,506,667,272,123,227,245,269,1394,PF
2008,34,22,305,6,38,0,2,6,36,10,22,4,16,20,42,10,4,10,30,22,PG
2008,24,9,81,13,28,2,9,11,19,6,11,5,7,12,8,1,1,4,6,34,PF
2008,24,27,680,83,161,3,14,80,147,58,77,25,89,114,56,19,14,48,49,227,SF
2008,29,80,1554,214,467,0,2,214,465,67,73,81,190,271,135,53,16,86,181,495,C
2008,33,58,1412,213,526,60,184,153,342,132,148,33,100,133,145,28,10,86,82,618,SG
2008,26,82,2564,301,780,158,413,143,367,157,197,37,198,235,252,65,15,102,110,917,SG
2008,30,77,2711,451,1026,231,524,220,502,130,140,64,267,331,96,57,10,61,127,1263,SF
2008,30,26,259,39,89,0,7,39,82,14,29,31,23,54,16,7,1,10,41,92,SG
2008,34,60,1037,120,337,50,149,70,188,27,34,20,98,118,165,30,2,80,76,317,PG
2008,34,29,624,77,194,36,94,41,100,21,26,14,57,71,112,19,0,50,46,211,PG
2008,34,31,413,43,143,14,55,29,88,6,8,6,41,47,53,11,2,30,30,106,PG
2008,25,35,402,65,180,29,85,36,95,41,50,4,20,24,28,7,5,21,34,200,PG
2008,25,79,2677,714,1211,5,31,709,1180,556,691,178,541,719,118,64,163,174,294,1989,C
2008,22,33,270,29,92,6,25,23,67,9,19,9,19,28,30,12,6,11,36,73,SG
2008,21,57,1081,153,382,3,16,150,366,127,156,32,97,129,160,49,6,78,113,436,PG
2008,22,8,98,6,17,0,0,6,17,2,2,6,12,18,1,5,6,10,16,14,C
2008,28,56,844,135,265,0,2,135,263,73,109,64,135,199,26,15,54,51,113,343,PF
2008,28,35,549,93,177,0,2,93,175,52,81,46,83,129,22,10,36,39,74,238,PF
2008,28,21,295,42,88,0,0,42,88,21,28,18,52,70,4,5,18,12,39,105,PF
2008,30,75,1736,311,722,90,218,221,504,149,175,34,183,217,104,23,12,76,103,861,SF
2008,30,50,1180,236,513,71,166,165,347,113,134,16,120,136,69,14,5,56,67,656,SF
2008,30,25,556,75,209,19,52,56,157,36,41,18,63,81,35,9,7,20,36,205,SF
2008,22,60,1933,223,556,32,114,191,442,78,105,16,119,135,355,59,11,111,171,556,PG
2008,30,82,2579,471,1008,136,363,335,645,191,223,30,178,208,264,88,18,92,170,1269,SG
2008,32,11,42,4,17,4,16,0,1,2,2,0,2,2,0,1,0,4,4,14,SF
2008,32,7,34,4,14,4,13,0,1,0,0,0,2,2,0,1,0,3,4,12,SF
2008,30,23,281,16,38,0,0,16,38,0,5,18,43,61,13,6,1,21,38,32,PF
2008,35,42,1060,139,271,0,0,139,271,39,56,94,275,369,53,35,43,28,131,317,C
2008,35,28,524,56,125,0,1,56,124,14,24,36,102,138,14,21,14,18,57,126,PF
2008,30,63,1940,291,705,83,271,208,434,115,153,62,261,323,171,40,29,98,192,780,PF
2008,21,74,1330,186,440,1,6,185,434,129,174,102,240,342,90,48,72,77,170,502,PF
2008,24,79,2158,374,871,43,130,331,741,214,288,98,260,358,98,46,43,128,195,1005,PF
2008,29,39,1293,176,463,40,141,136,322,72,100,24,117,141,326,66,10,130,97,464,PG
2008,23,6,48,8,22,1,4,7,18,5,6,4,4,8,0,0,1,0,2,22,SF
2008,25,78,1458,188,397,0,1,188,396,140,186,95,211,306,128,28,108,72,199,516,C
2008,28,82,3026,556,1219,166,415,390,804,324,391,83,388,471,409,74,25,246,244,1602,SF
2008,30,73,1316,159,375,61,165,98,210,44,58,36,192,228,63,56,17,58,127,423,PF
2008,25,65,2080,328,708,53,137,275,571,125,147,34,183,217,282,56,10,148,138,834,PG
2008,25,48,1320,136,295,0,2,136,293,49,82,134,265,399,53,37,26,59,134,321,C
2008,32,74,1139,121,283,3,10,118,273,61,80,13,61,74,159,23,1,54,97,306,PG
2008,23,76,1829,354,814,55,185,299,629,123,157,145,321,466,78,30,35,107,174,886,PF
2008,23,13,69,9,20,5,12,4,8,5,11,1,7,8,2,1,1,3,4,28,SF
2008,30,44,386,37,80,0,0,37,80,24,29,30,67,97,13,9,21,29,83,98,C
2008,23,72,1279,219,482,118,270,101,212,76,91,19,135,154,72,36,5,52,107,632,SG
2008,26,51,1954,439,937,22,77,417,860,354,467,45,169,214,354,87,37,224,137,1254,SG
2008,22,29,154,17,61,4,26,13,35,8,12,1,18,19,7,2,3,13,7,46,SG
2008,22,21,90,10,38,1,15,9,23,6,8,1,9,10,5,2,1,11,4,27,SG
2008,22,8,64,7,23,3,11,4,12,2,4,0,9,9,2,0,2,2,3,19,SG
2008,31,46,892,136,375,61,188,75,187,35,66,56,112,168,45,33,8,46,80,368,PF
2008,33,50,1627,101,271,0,4,101,267,53,125,175,266,441,92,69,80,49,86,255,C
2008,33,22,578,37,81,0,0,37,81,19,44,59,104,163,13,19,37,18,35,93,PF
2008,25,62,2376,408,908,71,221,337,687,313,428,58,315,373,216,131,58,180,189,1200,PF
2008,33,77,2346,376,870,112,315,264,555,115,150,84,427,511,137,91,129,86,213,979,C
2008,27,74,1729,215,478,28,84,187,394,77,109,85,206,291,218,60,18,100,133,535,SF
2008,25,75,1754,328,653,13,48,315,605,183,260,123,233,356,53,36,28,85,156,852,PF
2008,22,18,146,21,48,4,12,17,36,7,13,4,16,20,15,5,0,14,16,53,SG
2008,23,9,71,5,15,0,0,5,15,2,5,5,7,12,0,2,2,7,8,12,C
2008,23,32,368,43,101,9,26,34,75,23,29,13,19,32,35,15,0,18,19,118,PG
2008,28,78,2269,339,747,49,132,290,615,111,145,43,182,225,531,69,11,175,158,838,PG
2008,34,9,126,15,31,0,0,15,31,5,12,2,30,32,18,4,6,11,17,35,PF
2008,21,75,2132,277,656,123,317,154,339,122,166,54,242,296,90,42,28,83,159,799,SF
2008,31,73,1562,252,569,12,50,240,519,146,227,84,247,331,97,75,32,103,157,662,SG
2008,31,51,1124,175,412,8,38,167,374,111,174,63,197,260,80,51,24,76,113,469,SG
2008,31,22,438,77,157,4,12,73,145,35,53,21,50,71,17,24,8,27,44,193,SG
2008,27,76,2870,629,1305,6,25,623,1280,300,353,180,495,675,177,62,99,165,208,1564,PF
2008,24,61,1533,196,475,48,135,148,340,67,91,31,162,193,229,59,29,117,103,507,PG
2008,24,35,727,97,250,19,56,78,194,26,39,13,83,96,113,30,10,66,44,239,PG
2008,24,26,806,99,225,29,79,70,146,41,52,18,79,97,116,29,19,51,59,268,PG
2008,23,64,269,21,49,0,4,21,45,17,26,26,22,48,13,12,4,9,61,59,SG
2008,25,62,1739,334,638,0,3,334,635,160,248,126,307,433,74,46,36,103,174,828,PF
2008,28,76,1843,271,673,50,155,221,518,106,144,72,173,245,150,62,19,89,128,698,SF
2008,28,15,188,17,36,3,8,14,28,4,4,5,14,19,14,9,0,9,13,41,PG
2008,28,8,122,10,23,2,5,8,18,2,2,4,8,12,6,5,0,5,9,24,PG
2008,28,4,44,2,4,1,2,1,2,0,0,1,5,6,3,3,0,1,2,5,PG
2008,28,3,22,5,9,0,1,5,8,2,2,0,1,1,5,1,0,3,2,12,PG
2008,36,30,297,27,55,0,0,27,55,14,18,15,46,61,9,12,15,13,44,68,C
2008,23,82,3059,566,1117,83,210,483,907,330,411,34,209,243,862,90,23,279,200,1545,PG
2008,32,67,1886,211,550,97,275,114,275,69,80,12,118,130,307,83,5,91,93,588,PG
2008,23,23,123,13,29,0,0,13,29,8,26,20,29,49,0,5,5,4,17,34,C
2008,23,22,117,12,26,0,0,12,26,7,22,19,29,48,0,5,5,3,14,31,C
2008,23,1,6,1,3,0,0,1,3,1,4,1,0,1,0,0,0,1,3,3,C
2008,21,80,1862,319,752,55,153,264,599,227,290,41,126,167,253,81,13,125,130,920,PG
2008,22,53,854,111,293,54,142,57,151,37,47,14,87,101,140,25,3,75,52,313,PG
2008,21,1,2,0,1,0,0,0,1,0,0,0,0,0,0,0,1,0,0,0,SF
2008,21,10,34,5,19,0,0,5,19,0,0,4,8,12,3,1,0,0,3,10,PF
2008,21,80,2765,424,918,1,10,423,908,336,409,119,338,457,137,81,33,127,225,1185,SF
2008,25,66,2410,441,919,89,231,352,688,166,194,37,193,230,419,78,10,182,188,1137,PG
2008,21,73,1278,164,305,0,0,164,305,81,133,115,207,322,28,28,106,70,193,409,C
2008,21,65,967,159,372,43,137,116,235,76,106,54,122,176,59,26,26,58,132,437,SF
2008,24,64,776,92,212,0,2,92,210,71,105,68,137,205,19,22,21,35,110,255,PF
2008,24,36,414,37,100,0,1,37,99,35,51,34,73,107,11,13,11,14,60,109,PF
2008,24,28,362,55,112,0,1,55,111,36,54,34,64,98,8,9,10,21,50,146,PF
2008,29,7,17,3,5,0,0,3,5,0,0,0,1,1,2,0,0,0,2,6,C
2008,28,57,2172,436,962,84,221,352,741,212,295,101,227,328,199,133,38,148,159,1168,SF
2008,23,56,1232,136,329,32,110,104,219,46,67,40,107,147,80,28,21,50,127,350,SG
2008,23,41,1056,115,287,27,101,88,186,41,58,35,90,125,67,26,17,39,105,298,SG
2008,23,15,176,21,42,5,9,16,33,5,9,5,17,22,13,2,4,11,22,52,SG
2008,20,38,376,62,112,0,0,62,112,27,40,38,61,99,9,6,22,13,36,151,PF
2008,22,44,1104,143,293,4,11,139,282,57,69,48,172,220,60,29,41,29,79,347,SF
2008,20,57,640,90,169,10,24,80,145,33,52,33,84,117,40,29,12,34,43,223,SF
2008,32,18,161,6,21,0,0,6,21,3,6,8,30,38,4,3,3,4,31,15,C
2008,32,13,148,5,17,0,0,5,17,3,6,7,30,37,3,3,3,2,26,13,C
2008,32,5,13,1,4,0,0,1,4,0,0,1,0,1,1,0,0,2,5,2,C
2008,22,75,1158,210,478,40,100,170,378,101,124,23,92,115,63,35,7,94,130,561,SG
2008,19,74,1554,264,490,6,19,258,471,76,103,120,192,312,58,73,8,64,126,610,PF
2009,26,25,199,30,76,7,20,23,56,5,10,8,16,24,12,5,4,7,9,72,SG
2009,26,7,20,4,11,0,4,4,7,1,2,0,2,2,1,2,1,0,0,9,SG
2009,26,18,179,26,65,7,16,19,49,4,8,8,14,22,11,3,3,7,9,63,SG
2009,24,12,52,4,13,0,0,4,13,3,6,1,6,7,1,1,1,4,4,11,SG
2009,23,74,1234,131,300,43,107,88,193,58,71,30,104,134,44,28,13,43,144,363,SG
2009,24,20,97,15,43,0,6,15,37,4,8,3,7,10,3,1,2,4,17,34,SG
2009,24,3,19,2,6,2,4,0,2,2,2,0,1,1,2,1,0,1,3,8,PG
2009,20,31,182,25,69,0,2,25,67,20,28,9,21,30,3,7,6,12,34,70,PF
2009,23,81,3004,601,1243,7,28,594,1215,261,334,234,371,605,157,77,77,121,207,1470,PF
2009,22,59,716,102,245,16,46,86,199,58,83,44,71,115,42,15,29,52,107,278,SF
2009,30,49,579,73,170,0,1,73,169,10,21,35,68,103,35,7,12,20,89,156,PF
2009,33,79,2876,499,1040,199,486,300,554,237,249,66,212,278,218,69,13,134,157,1434,SG
2009,27,46,887,137,284,6,27,131,257,79,109,22,82,104,66,54,23,77,98,359,SG
2009,23,25,255,33,81,5,17,28,64,21,26,9,27,36,7,4,4,16,31,92,SG
2009,32,77,2447,316,820,112,331,204,489,156,208,33,194,227,406,108,10,140,135,900,PG
2009,32,48,1591,193,522,80,230,113,292,86,109,25,119,144,258,57,7,88,72,552,PG
2009,32,29,856,123,298,32,101,91,197,70,99,8,75,83,148,51,3,52,63,348,PG
2009,26,76,1044,134,250,0,1,134,249,53,120,128,142,270,28,32,65,56,154,321,PF
2009,30,71,1460,160,292,2,10,158,282,130,181,163,279,442,31,41,175,69,174,452,C
2009,20,66,1312,160,407,69,189,91,218,98,116,104,207,311,52,44,20,63,157,487,PF
2009,24,66,2277,535,1207,63,170,472,1037,371,468,106,344,450,222,75,24,199,195,1504,SF
2009,26,65,1048,57,118,0,0,57,118,30,46,89,108,197,27,20,93,41,139,144,C
2009,27,2,63,6,23,2,7,4,16,12,16,1,8,9,20,0,1,1,4,26,PG
2009,23,82,1999,274,596,61,191,213,405,120,169,111,241,352,145,137,24,87,166,729,SF
2009,24,70,1092,138,246,0,2,138,244,62,98,81,114,195,29,26,45,80,181,338,C
2009,20,76,1464,191,436,0,2,191,434,40,60,108,238,346,43,52,52,47,206,422,PF
2009,34,33,412,34,113,15,57,19,56,15,16,5,19,24,59,10,2,23,27,98,PG
2009,34,14,115,9,27,5,17,4,10,4,4,0,6,6,28,2,1,10,5,27,PG
2009,34,19,297,25,86,10,40,15,46,11,12,5,13,18,31,8,1,13,22,71,PG
2009,21,72,1908,267,621,108,246,159,375,208,233,17,116,133,250,42,2,119,140,850,PG
2009,25,74,2375,392,845,94,210,298,635,185,229,112,258,370,117,57,50,95,183,1063,SF
2009,24,53,780,110,197,2,7,108,190,42,65,86,117,203,34,47,23,35,98,264,PF
2009,27,22,206,21,57,3,19,18,38,11,18,1,17,18,28,11,2,14,26,56,PG
2009,27,16,166,15,39,2,14,13,25,10,15,0,15,15,22,10,2,11,21,42,PG
2009,27,6,40,6,18,1,5,5,13,1,3,1,2,3,6,1,0,3,5,14,PG
2009,26,70,1705,366,759,90,240,276,519,171,194,34,147,181,162,82,7,93,115,993,SG
2009,24,79,1600,246,557,55,154,191,403,70,93,36,141,177,269,37,5,105,121,617,SG
2009,23,78,2453,431,958,119,291,312,667,221,266,70,346,416,94,34,97,135,242,1202,PF
2009,28,77,2082,285,674,117,341,168,333,101,136,79,342,421,212,52,26,130,209,788,PF
2009,37,56,857,70,172,49,131,21,41,19,20,17,77,94,78,24,3,48,45,208,SG
2009,23,81,1574,252,508,0,6,252,502,182,210,129,238,367,43,27,55,86,140,686,C
2009,33,27,217,25,46,0,1,25,45,17,27,22,30,52,7,6,10,12,39,67,PF
2009,32,77,1202,158,323,2,9,156,314,54,82,92,186,278,31,26,25,46,112,372,PF
2009,30,60,2031,145,354,91,237,54,117,55,67,52,233,285,137,48,54,49,114,436,SG
2009,20,79,1454,161,361,62,168,99,193,42,52,84,136,220,74,50,40,50,139,426,SF
2009,20,53,655,69,189,7,27,62,162,83,103,8,49,57,78,16,2,56,81,228,PG
2009,20,81,2009,452,957,33,81,419,876,186,241,110,329,439,83,41,37,121,184,1123,PF
2009,22,42,882,140,317,52,131,88,186,40,52,10,61,71,88,36,1,59,73,372,SG
2009,29,70,1783,217,524,87,240,130,284,66,80,32,102,134,151,50,7,76,138,587,SG
2009,32,67,2315,299,684,114,271,185,413,87,102,41,202,243,142,50,8,86,166,799,SG
2009,32,22,712,76,177,44,94,32,83,16,21,8,56,64,29,13,2,18,57,212,SG
2009,32,45,1603,223,507,70,177,153,330,71,81,33,146,179,113,37,6,68,109,587,SG
2009,30,79,2740,437,1005,167,428,270,577,135,171,38,240,278,392,98,11,128,145,1176,PG
2009,22,62,1863,308,533,0,1,308,532,119,216,223,470,693,121,63,96,110,236,735,C
2009,32,79,2789,410,980,162,397,248,583,418,458,32,207,239,506,93,18,177,161,1400,PG
2009,32,2,70,7,21,2,7,5,14,9,10,1,9,10,15,3,1,4,3,25,PG
2009,32,77,2719,403,959,160,390,243,569,409,448,31,198,229,491,90,17,173,158,1375,PG
2009,28,69,2188,277,647,140,328,137,319,63,75,28,145,173,348,69,4,108,126,757,PG
2009,22,71,1703,297,630,5,21,292,609,114,162,126,252,378,118,53,74,117,211,713,C
2009,33,20,207,30,78,11,27,19,51,8,13,10,31,41,4,1,7,14,17,79,C
2009,28,65,1272,119,324,74,218,45,106,52,57,31,171,202,64,43,4,41,105,364,SG
2009,28,36,787,63,175,42,126,21,49,21,24,15,96,111,31,23,2,19,61,189,SG
2009,28,29,485,56,149,32,92,24,57,31,33,16,75,91,33,20,2,22,44,175,SG
2009,24,36,1124,183,317,0,0,183,317,56,98,117,252,369,72,23,37,86,130,422,C
2009,28,81,1928,266,536,118,268,148,268,17,23,97,289,386,82,47,26,37,190,667,PF
2009,24,62,995,113,214,0,0,113,214,32,85,104,154,258,31,22,48,31,106,258,C
2009,32,8,56,5,10,0,0,5,10,6,8,5,6,11,0,1,2,1,10,16,C
2009,32,7,55,5,10,0,0,5,10,6,8,4,6,10,0,1,2,1,10,16,C
2009,27,37,1197,251,512,0,0,251,512,97,139,111,274,385,79,39,7,79,132,599,PF
2009,24,77,2928,615,1263,12,49,603,1214,504,617,215,556,771,191,67,77,174,189,1746,C
2009,37,80,1506,79,187,42,98,37,89,14,26,16,129,145,40,36,13,25,123,214,SF
2009,33,21,219,22,38,0,0,22,38,3,5,10,14,24,9,14,5,5,37,47,SF
2009,29,29,920,163,365,0,0,163,365,73,108,77,177,254,37,17,45,68,78,399,PF
2009,22,15,307,37,90,5,12,32,78,14,19,18,31,49,25,15,3,13,37,93,SF
2009,23,81,2605,421,828,22,85,399,743,247,352,101,199,300,179,138,30,110,128,1111,SF
2009,24,80,1998,316,783,113,309,203,474,149,172,33,124,157,238,46,8,125,152,894,PG
2009,27,4,41,1,7,0,0,1,7,2,2,7,5,12,1,1,0,5,9,4,PF
2009,24,47,675,94,247,31,94,63,153,26,34,8,28,36,87,15,1,47,74,245,SG
2009,24,21,256,47,113,14,36,33,77,8,9,6,10,16,30,6,2,16,21,116,PG
2009,24,19,261,18,49,7,24,11,25,3,5,7,22,29,36,10,0,17,28,46,PG
2009,24,17,233,17,44,6,20,11,24,1,3,7,21,28,33,10,0,14,22,41,PG
2009,24,2,28,1,5,1,4,0,1,2,2,0,1,1,3,0,0,3,6,5,PG
2009,30,63,869,111,313,28,97,83,216,78,100,31,88,119,54,32,5,54,81,328,SG
2009,26,58,999,90,169,0,0,90,169,63,122,91,199,290,32,24,24,50,138,243,C
2009,23,48,477,78,165,14,37,64,128,32,39,11,33,44,38,22,7,38,42,202,SG
2009,23,30,341,56,123,8,28,48,95,24,30,8,16,24,28,18,5,29,33,144,SG
2009,23,18,136,22,42,6,9,16,33,8,9,3,17,20,10,4,2,9,9,58,SG
2009,30,82,2960,800,1712,118,336,682,1376,483,564,90,339,429,399,120,37,210,189,2201,SG
2009,32,63,878,61,159,13,51,48,108,20,25,32,98,130,57,29,8,38,108,155,SF
2009,28,67,2585,491,1085,65,210,426,875,345,402,118,296,414,290,106,20,210,165,1392,SG
2009,29,82,2614,348,803,140,359,208,444,86,110,49,222,271,75,51,61,59,159,922,SF
2009,21,50,1446,281,502,0,0,281,502,152,215,137,261,398,71,18,90,85,157,714,C
2009,26,57,803,156,342,3,19,153,323,95,119,19,56,75,157,34,2,76,85,410,PG
2009,27,68,2333,320,644,82,202,238,442,151,154,16,178,194,607,74,7,143,114,873,PG
2009,34,62,1925,254,496,1,4,253,492,132,182,161,529,690,127,51,132,93,129,641,C
2009,31,64,909,65,169,30,92,35,77,30,35,39,103,142,76,37,13,48,135,190,PF
2009,24,67,1199,176,423,79,226,97,197,50,66,36,90,126,26,45,29,43,94,481,SG
2009,28,55,616,65,171,13,53,52,118,21,25,7,62,69,27,21,6,33,67,164,SG
2009,28,34,475,56,138,12,45,44,93,15,19,5,50,55,24,18,5,26,53,139,SG
2009,28,21,141,9,33,1,8,8,25,6,6,2,12,14,3,3,1,7,14,25,SG
2009,33,78,1787,167,386,21,88,146,298,57,78,40,165,205,364,96,13,155,142,412,PG
2009,32,80,2946,588,1345,151,392,437,953,335,410,74,336,410,376,82,38,166,234,1662,SG
2009,22,82,2626,278,662,114,311,164,351,148,193,37,191,228,403,160,8,165,240,818,PG
2009,26,45,1445,160,283,0,0,160,283,77,133,163,230,393,22,15,56,70,144,397,C
2009,21,82,2735,455,1054,103,314,352,740,171,215,91,354,445,170,71,75,139,250,1184,SF
2009,30,2,15,2,7,0,0,2,7,1,2,0,0,0,3,0,0,0,1,5,PG
2009,30,26,201,16,35,0,0,16,35,8,11,20,17,37,7,2,1,9,35,40,C
2009,30,31,422,22,70,0,0,22,70,13,28,28,42,70,11,9,13,12,73,57,C
2009,24,9,75,8,23,0,3,8,20,4,9,2,6,8,10,2,0,5,7,20,SG
2009,24,39,815,97,224,13,28,84,196,24,37,29,70,99,101,29,10,53,73,231,PG
2009,28,71,1831,243,428,0,2,243,426,98,136,181,308,489,66,51,50,73,239,584,C
2009,21,82,2508,323,730,88,217,235,513,161,197,25,251,276,354,90,8,143,146,895,PG
2009,28,30,171,28,76,13,30,15,46,5,6,7,25,32,5,3,3,13,26,74,PF
2009,28,21,146,23,60,11,25,12,35,5,6,6,21,27,4,3,0,11,23,62,PF
2009,28,9,25,5,16,2,5,3,11,0,0,1,4,5,1,0,3,2,3,12,PF
2009,21,75,1833,242,645,153,395,89,250,49,56,19,170,189,71,39,10,42,125,686,SF
2009,28,11,392,73,169,35,77,38,92,35,46,2,15,17,48,9,0,26,13,216,SG
2009,28,54,2087,346,853,107,317,239,536,265,298,21,155,176,240,48,13,122,79,1064,PG
2009,22,2,23,3,10,1,4,2,6,2,2,1,3,4,1,1,0,0,2,9,SF
2009,21,7,44,7,15,0,1,7,14,5,11,4,2,6,5,1,0,3,5,19,SG
2009,21,56,1130,124,270,2,14,122,256,48,81,53,107,160,145,39,6,79,96,298,PG
2009,33,14,100,14,39,5,15,9,24,7,12,11,23,34,9,1,1,6,5,40,PF
2009,33,11,77,12,30,5,11,7,19,7,11,7,17,24,6,1,1,4,4,36,PF
2009,33,3,23,2,9,0,4,2,5,0,1,4,6,10,3,0,0,2,1,4,PF
2009,26,3,12,2,2,0,0,2,2,1,3,0,4,4,0,0,0,2,5,5,C
2009,27,82,2036,216,434,0,2,216,432,91,124,214,487,701,18,33,146,117,248,523,C
2009,33,80,1836,182,280,0,0,182,280,90,141,216,349,565,77,24,95,74,191,454,C
2009,33,74,1021,99,236,22,60,77,176,80,100,5,72,77,177,26,1,62,55,300,PG
2009,33,13,288,18,45,5,11,13,34,25,33,0,22,22,47,7,0,13,14,66,PG
2009,33,61,733,81,191,17,49,64,142,55,67,5,50,55,130,19,1,49,41,234,PG
2009,28,54,1700,311,689,18,90,293,599,93,129,80,168,248,114,62,26,94,120,733,SF
2009,24,14,111,17,35,0,0,17,35,8,17,10,24,34,1,2,3,5,12,42,SF
2009,29,65,2248,355,959,99,328,256,631,159,210,46,192,238,501,108,35,193,193,968,PG
2009,23,76,1637,199,450,2,5,197,445,130,178,121,180,301,69,53,19,71,230,530,C
2009,24,27,320,40,98,0,1,40,97,27,34,28,39,67,12,10,3,13,44,107,PF
2009,29,36,785,83,245,35,111,48,134,31,36,9,51,60,82,19,5,39,63,232,SG
2009,23,49,1665,265,591,8,20,257,571,152,191,80,215,295,94,60,25,72,85,690,SF
2009,26,81,2754,448,884,75,181,373,703,101,147,118,314,432,333,61,53,215,202,1072,PF
2009,26,22,538,80,141,5,14,75,127,18,26,24,60,84,46,11,9,37,39,183,PF
2009,26,59,2216,368,743,70,167,298,576,83,121,94,254,348,287,50,44,178,163,889,PF
2009,26,63,851,76,217,51,163,25,54,10,19,26,56,82,27,13,6,16,75,213,SF
2009,26,55,719,74,179,46,118,28,61,12,15,6,80,86,122,26,5,21,42,206,PG
2009,25,29,215,39,74,1,2,38,72,40,53,26,30,56,3,3,3,12,23,119,PF
2009,25,19,73,6,19,0,0,6,19,15,20,12,5,17,0,1,2,6,9,27,PF
2009,25,10,142,33,55,1,2,32,53,25,33,14,25,39,3,2,1,6,14,92,PF
2009,27,75,1036,74,171,0,0,74,171,22,66,114,159,273,32,29,56,39,128,170,C
2009,27,34,452,22,58,0,0,22,58,12,29,45,73,118,13,12,25,11,55,56,C
2009,27,41,584,52,113,0,0,52,113,10,37,69,86,155,19,17,31,28,73,114,C
2009,30,50,816,101,256,25,75,76,181,34,39,8,59,67,118,35,6,70,74,261,PG
2009,28,77,2074,261,598,99,235,162,363,127,154,24,131,155,270,71,8,105,135,748,PG
2009,25,3,6,1,2,0,0,1,2,0,0,0,1,1,1,0,0,0,0,2,PF
2009,24,27,300,42,110,14,46,28,64,17,19,6,26,32,25,5,5,13,27,115,PG
2009,24,20,227,30,88,10,37,20,51,14,15,3,22,25,13,2,5,6,23,84,PG
2009,24,7,73,12,22,4,9,8,13,3,4,3,4,7,12,3,0,7,4,31,PG
2009,22,44,585,81,176,3,12,78,164,51,62,14,36,50,52,12,7,31,34,216,SG
2009,22,55,728,88,224,20,54,68,170,50,65,33,70,103,111,29,3,73,87,246,PG
2009,23,68,1155,136,285,29,74,107,211,71,105,82,123,205,56,57,8,43,105,372,SF
2009,23,20,427,45,96,3,8,42,88,15,24,25,34,59,19,18,2,10,40,108,SF
2009,23,48,728,91,189,26,66,65,123,56,81,57,89,146,37,39,6,33,65,264,SF
2009,26,79,2906,287,681,127,325,160,356,179,209,45,201,246,566,72,7,221,126,880,PG
2009,32,75,2524,558,1107,0,2,558,1105,334,483,201,599,800,264,38,126,165,173,1450,C
2009,28,18,495,93,232,32,90,61,142,53,65,14,54,68,44,12,9,38,36,271,SG
2009,20,74,2885,661,1390,97,230,564,1160,452,524,77,405,482,205,96,53,225,134,1871,SF
2009,23,25,892,194,430,8,26,186,404,78,94,14,94,108,93,39,8,67,67,474,SG
2009,32,59,977,83,169,1,4,82,165,33,39,100,129,229,32,36,36,48,144,200,C
2009,30,31,373,37,95,0,0,37,95,23,36,30,34,64,18,2,9,23,58,97,C
2009,30,80,1840,208,482,98,248,110,234,60,73,88,155,243,54,50,10,43,163,574,SF
2009,28,79,1137,79,178,0,1,79,177,104,175,135,226,361,26,41,8,69,161,262,PF
2009,22,65,1192,161,412,49,146,112,266,45,77,22,95,117,155,57,10,87,105,416,PG
2009,27,3,54,4,14,3,12,1,2,2,2,0,6,6,2,0,0,4,6,13,SG
2009,24,82,3086,442,1083,59,207,383,876,219,272,54,256,310,553,126,30,228,191,1162,PG
2009,23,78,1993,268,630,159,398,109,232,120,143,47,160,207,159,69,12,86,111,815,SG
2009,22,21,156,21,36,0,0,21,36,7,21,14,23,37,4,7,15,9,35,49,C
2009,35,81,2336,301,689,131,319,170,370,51,62,26,244,270,114,37,17,61,82,784,SF
2009,34,82,2441,292,688,120,302,172,386,110,130,25,163,188,261,95,6,72,187,814,PG
2009,25,74,2258,413,913,35,104,378,809,245,281,59,200,259,392,89,16,180,180,1106,PG
2009,32,74,1828,177,353,2,7,175,346,96,146,215,293,508,130,53,49,88,229,452,C
2009,25,70,2494,399,981,111,308,288,673,230,272,34,180,214,303,72,26,150,201,1139,SG
2009,33,10,62,7,11,0,0,7,11,3,6,9,17,26,1,0,8,3,5,17,C
2009,33,9,59,7,11,0,0,7,11,3,6,9,17,26,1,0,8,3,4,17,C
2009,25,63,746,113,267,11,33,102,234,26,36,41,99,140,24,17,16,29,106,263,PF
2009,30,67,941,117,244,0,2,117,242,37,68,95,160,255,39,32,43,41,162,271,C
2009,20,28,412,56,125,32,72,24,53,26,27,13,42,55,15,14,4,15,48,170,SG
2009,27,65,1975,295,665,88,221,207,444,146,178,56,162,218,150,80,67,112,196,824,SF
2009,23,16,98,9,36,4,23,5,13,2,4,0,7,7,2,4,1,3,4,24,SG
2009,32,57,1772,393,740,2,8,391,732,111,132,78,407,485,144,63,68,90,128,899,PF
2009,24,82,2521,350,661,0,1,350,660,275,375,201,404,605,143,63,90,164,265,975,C
2009,28,81,2999,592,1045,1,2,591,1043,343,439,262,518,780,284,52,81,157,172,1528,C
2009,22,79,2945,572,1262,85,242,487,1020,264,344,109,328,437,135,98,59,203,221,1493,SF
2009,31,43,708,54,142,22,76,32,66,17,22,25,53,78,15,23,11,17,57,147,SF
2009,22,75,1795,206,527,108,283,98,244,66,86,31,124,155,132,44,16,61,163,586,PG
2009,23,6,8,2,3,0,0,2,3,0,0,2,1,3,0,1,0,1,1,4,SF
2009,30,6,43,6,9,2,3,4,6,0,0,0,4,4,11,3,1,5,10,14,PG
2009,31,44,1181,223,491,69,209,154,282,168,190,24,174,198,157,64,16,88,90,683,SG
2009,26,82,2614,420,974,106,285,314,689,146,181,106,286,392,135,63,22,128,183,1092,SF
2009,27,51,1264,237,506,0,4,237,502,131,156,113,249,362,48,30,18,76,144,605,PF
2009,27,31,918,161,352,0,3,161,349,84,97,82,184,266,43,26,14,57,103,406,PF
2009,27,1,26,5,9,0,0,5,9,2,2,3,10,13,2,0,0,3,2,12,PF
2009,27,19,320,71,145,0,1,71,144,45,57,28,55,83,3,4,4,16,39,187,PF
2009,25,82,2999,598,1315,173,422,425,893,330,382,52,231,283,279,71,22,200,184,1699,SG
2009,20,78,2677,411,901,131,337,280,564,299,350,45,156,201,215,78,35,164,172,1252,SG
2009,24,63,794,106,187,1,1,105,186,26,45,96,190,286,14,18,53,25,111,239,PF
2009,26,78,1541,231,480,3,16,228,464,132,160,95,197,292,48,35,12,74,191,597,SF
2009,26,52,684,106,256,20,66,86,190,50,62,21,75,96,33,10,4,45,82,282,SG
2009,25,67,2424,571,1277,182,450,389,827,404,460,49,292,341,183,69,97,165,207,1728,SF
2009,24,56,715,81,167,0,1,81,166,34,59,84,136,220,46,14,18,40,135,196,C
2009,23,38,376,79,180,14,46,65,134,27,32,14,40,54,15,10,5,33,51,199,SG
2009,22,78,2873,476,1068,96,247,380,821,242,307,120,399,519,155,81,33,173,202,1290,PF
2009,27,81,1828,286,658,51,161,235,497,62,85,29,97,126,158,53,13,64,154,685,SG
2009,20,55,725,77,236,26,100,51,136,29,34,19,67,86,30,16,14,37,68,209,SF
2009,23,19,120,15,31,0,0,15,31,18,30,16,31,47,8,1,12,9,20,48,C
2009,21,15,155,24,49,0,1,24,48,2,7,11,17,28,13,6,7,12,19,50,SG
2009,30,67,2279,466,1043,70,190,396,853,223,263,44,163,207,297,40,4,133,176,1225,SG
2009,32,63,693,111,241,0,2,111,239,55,72,47,76,123,28,29,9,29,102,277,SG
2009,28,73,2546,532,1212,171,470,361,742,234,295,99,356,455,102,88,22,161,227,1469,PF
2009,28,5,166,23,70,11,28,12,42,5,10,10,18,28,10,7,0,7,14,62,PF
2009,28,68,2380,509,1142,160,442,349,700,229,285,89,338,427,92,81,22,154,213,1407,PF
2009,25,69,2494,455,1039,64,220,391,819,496,605,30,201,231,476,114,13,212,164,1470,PG
2009,30,39,348,30,94,0,6,30,88,18,23,13,33,46,48,12,4,22,39,78,PG
2009,30,28,312,25,84,0,4,25,80,15,19,12,30,42,43,12,4,19,35,65,PG
2009,30,11,36,5,10,0,2,5,8,3,4,1,3,4,5,0,0,3,4,13,PG
2009,28,75,2560,333,643,0,0,333,643,128,170,169,449,618,85,43,25,82,204,794,PF
2009,29,53,1094,86,191,2,8,84,183,20,25,50,96,146,51,21,16,30,92,194,SF
2009,20,77,2259,373,800,40,115,333,685,90,136,148,401,549,149,44,93,160,249,876,C
2009,25,71,858,42,113,0,4,42,109,7,19,74,176,250,42,34,19,25,134,91,C
2009,27,74,1832,257,577,94,244,163,333,36,52,27,240,267,54,52,7,49,162,644,SF
2009,29,6,175,24,50,0,0,24,50,10,21,13,31,44,8,4,15,9,14,58,C
2009,26,22,322,39,101,14,38,25,63,14,16,3,24,27,35,6,1,16,15,106,PG
2009,26,10,176,16,43,6,16,10,27,5,8,3,22,25,23,11,1,9,22,43,SG
2009,29,59,630,82,207,41,120,41,87,19,25,28,79,107,22,7,4,17,43,224,SF
2009,22,70,1009,198,420,0,0,198,420,98,147,115,128,243,49,20,76,55,215,494,C
2009,20,62,705,100,194,0,0,100,194,45,67,52,113,165,9,14,30,45,81,245,C
2009,26,77,2510,428,709,1,5,427,704,266,368,183,415,598,108,95,101,147,278,1123,C
2009,22,77,1270,150,372,24,73,126,299,114,146,30,128,158,136,45,21,74,150,438,PG
2009,36,82,2445,390,745,24,76,366,669,181,224,64,341,405,186,90,54,126,182,985,SF
2009,23,1,2,1,1,0,0,1,1,0,0,2,1,3,0,0,0,0,0,2,PF
2009,28,51,1339,183,419,69,169,114,250,68,86,16,107,123,197,66,19,87,126,503,SG
2009,24,45,444,50,94,0,0,50,94,43,72,46,51,97,7,7,32,24,78,143,C
2009,24,18,184,19,35,0,0,19,35,26,39,19,17,36,4,3,17,10,34,64,C
2009,24,27,260,31,59,0,0,31,59,17,33,27,34,61,3,4,15,14,44,79,C
2009,22,67,2242,312,594,0,1,312,593,149,205,145,479,624,163,53,95,103,190,773,C
2009,30,81,1479,249,560,151,340,98,220,42,53,11,146,157,92,61,7,55,113,691,PG
2009,23,79,2821,560,979,0,2,560,977,504,849,336,757,1093,112,77,231,240,270,1624,C
2009,28,52,1663,353,783,58,168,295,615,172,220,59,204,263,83,55,30,89,135,936,SF
2009,35,3,22,1,2,0,0,1,2,0,0,1,3,4,2,1,1,0,4,2,PF
2009,35,39,450,74,145,0,0,74,145,23,34,29,43,72,24,6,5,26,67,171,SF
2009,30,30,792,127,308,40,102,87,206,67,82,6,88,94,59,36,9,36,51,361,SF
2009,30,25,687,97,249,35,91,62,158,50,63,10,55,65,60,36,5,35,45,279,SG
2009,23,29,265,38,90,0,0,38,90,38,48,24,46,70,10,8,6,8,31,114,SF
2009,38,28,266,27,82,16,48,11,34,3,5,2,10,12,37,20,1,19,28,73,PG
2009,22,16,92,11,20,0,0,11,20,0,5,9,15,24,1,2,5,2,11,22,PF
2009,25,82,3269,542,1147,80,261,462,886,377,521,92,379,471,434,131,36,222,152,1541,SF
2009,33,65,1765,342,724,15,39,327,685,139,174,157,333,490,64,28,84,90,183,838,C
2009,28,23,181,27,57,0,1,27,56,7,8,9,22,31,9,10,24,13,33,61,C
2009,33,3,123,18,40,2,8,16,32,18,25,3,5,8,20,3,1,10,3,56,SG
2009,33,54,1970,330,794,26,91,304,703,253,322,27,138,165,263,85,5,136,83,939,PG
2009,27,71,861,69,208,39,114,30,94,34,43,19,57,76,43,36,7,23,76,211,SG
2009,25,82,2716,386,853,78,221,308,632,224,263,44,232,276,338,88,17,184,179,1074,SG
2009,35,71,1484,193,485,60,197,133,288,86,101,42,158,200,143,62,4,66,100,532,PG
2009,23,51,430,37,86,0,2,37,84,24,35,32,55,87,8,10,4,14,77,98,PF
2009,30,59,2339,413,997,103,305,310,692,294,356,70,233,303,381,88,31,229,153,1223,SF
2009,33,2,10,3,8,0,0,3,8,0,0,1,2,3,0,1,1,1,2,6,C
2009,24,81,3054,789,1613,132,384,657,1229,594,762,106,507,613,587,137,93,241,139,2304,SF
2009,33,61,1649,197,514,69,184,128,330,68,82,25,108,133,201,44,6,94,108,531,PG
2009,33,8,74,8,25,3,4,5,21,1,2,1,6,7,8,2,0,3,7,20,PG
2009,33,53,1575,189,489,66,180,123,309,67,80,24,102,126,193,42,6,91,101,511,PG
2009,32,81,3096,674,1441,112,319,562,1122,341,452,196,525,721,153,95,25,125,218,1801,PF
2009,30,53,605,48,145,11,28,37,117,29,41,23,42,65,74,29,11,49,62,136,SG
2009,22,6,19,1,4,0,0,1,4,0,0,1,1,2,0,0,0,2,3,2,PF
2009,24,50,1836,485,975,0,4,485,971,186,252,172,376,548,79,39,83,92,141,1156,C
2009,25,6,84,11,22,1,2,10,20,6,9,1,11,12,9,4,1,6,9,29,SG
2009,28,82,2939,537,1222,116,292,421,930,417,518,57,317,374,199,66,14,165,252,1607,SF
2009,27,56,1310,120,273,1,12,119,261,55,90,128,103,231,80,47,33,65,153,296,SF
2009,21,61,1421,191,500,48,140,143,360,95,123,67,259,326,60,29,36,70,157,525,PF
2009,21,62,911,97,163,0,0,97,163,23,35,102,130,232,20,20,60,33,171,217,PF
2009,34,80,1481,154,381,52,133,102,248,61,81,29,118,147,200,46,5,82,111,421,PG
2009,27,79,3124,620,1420,149,414,471,1006,299,362,65,281,346,455,84,19,195,176,1688,SG
2009,28,10,55,4,11,1,2,3,9,0,0,3,5,8,2,1,0,2,7,9,PF
2009,28,8,42,4,11,1,2,3,9,0,0,3,5,8,2,1,0,2,6,9,PF
2009,24,4,14,0,5,0,0,0,5,4,4,0,1,1,0,0,0,1,4,4,SG
2009,28,79,1426,154,336,11,17,143,319,110,151,58,110,168,78,49,19,68,199,429,SG
2009,32,18,108,11,34,11,28,0,6,0,0,0,6,6,7,3,0,6,4,33,PG
2009,25,6,52,4,7,0,0,4,7,4,6,6,6,12,0,0,1,4,6,12,PF
2009,29,52,1495,129,317,54,147,75,170,66,81,23,103,126,188,53,11,66,112,378,SF
2009,28,40,630,55,149,33,96,22,53,26,31,12,50,62,20,12,14,12,58,169,SF
2009,24,63,675,67,111,1,2,66,109,53,74,52,90,142,15,7,34,27,125,188,C
2009,20,53,771,93,147,0,0,93,147,42,109,72,165,237,11,11,59,41,96,228,C
2009,26,31,921,161,305,0,0,161,305,51,75,75,172,247,46,17,45,84,93,373,C
2009,27,80,1831,261,604,98,229,163,375,34,42,26,137,163,105,22,3,70,144,654,SG
2009,35,81,2886,257,618,131,323,126,295,86,105,85,415,500,702,160,39,185,168,731,PG
2009,24,50,277,31,69,7,18,24,51,33,38,10,28,38,10,12,0,22,34,102,SG
2009,27,67,1831,256,570,20,73,236,497,244,311,84,235,319,175,83,77,121,127,776,PF
2009,24,82,1824,289,646,87,267,202,379,148,204,92,235,327,64,31,14,82,155,813,SF
2009,33,74,938,66,189,0,6,66,183,48,64,13,75,88,190,68,4,66,98,180,PG
2009,27,78,1874,245,560,103,267,142,293,112,127,35,223,258,137,47,30,90,170,705,SF
2009,19,48,565,94,185,0,0,94,185,36,51,50,88,138,20,12,31,26,70,224,C
2009,25,46,1141,191,407,0,0,191,407,63,79,85,168,253,29,21,49,45,114,445,C
2009,23,40,442,51,131,15,38,36,93,40,50,33,48,81,20,14,19,16,78,157,SF
2009,25,69,1467,240,418,1,3,239,415,157,193,124,219,343,39,26,31,68,166,638,PF
2009,24,55,560,52,139,9,29,43,110,49,60,6,52,58,86,11,3,29,43,162,PG
2009,23,77,1939,243,540,82,203,161,337,78,94,18,160,178,91,76,14,69,157,646,SG
2009,25,81,2824,522,951,0,3,522,948,249,330,256,695,951,174,80,22,150,260,1293,C
2009,29,79,2859,478,1089,220,554,258,535,225,269,92,361,453,205,81,51,158,194,1401,PF
2009,23,12,231,31,60,0,0,31,60,9,10,3,25,28,20,7,2,9,12,71,PG
2009,23,4,41,3,8,0,0,3,8,3,4,0,2,2,4,2,0,3,4,9,PG
2009,23,8,190,28,52,0,0,28,52,6,6,3,23,26,16,5,2,6,8,62,PG
2009,20,82,2501,448,844,0,2,448,842,172,217,225,440,665,86,44,151,147,257,1068,C
2009,20,60,614,71,137,0,1,71,136,47,68,52,66,118,8,11,41,28,97,189,C
2009,20,81,2048,316,688,2,19,314,669,265,336,274,460,734,84,35,50,118,205,899,C
2009,22,77,1679,189,434,25,98,164,336,181,226,26,163,189,275,69,17,117,146,584,PG
2009,22,49,1071,112,272,17,69,95,203,129,161,13,98,111,178,48,8,79,89,370,PG
2009,22,28,608,77,162,8,29,69,133,52,65,13,65,78,97,21,9,38,57,214,PG
2009,31,44,521,71,162,27,62,44,100,14,19,6,40,46,60,8,0,23,54,183,PG
2009,31,30,392,54,119,21,45,33,74,12,16,6,29,35,46,6,0,21,41,141,PG
2009,31,14,129,17,43,6,17,11,26,2,3,0,11,11,14,2,0,2,13,42,PG
2009,33,19,116,3,14,0,0,3,14,0,4,10,8,18,4,1,1,3,18,6,C
2009,29,51,1588,292,634,24,95,268,539,342,415,49,233,282,92,44,8,120,192,950,PF
2009,30,55,709,65,131,0,0,65,131,29,60,82,140,222,22,11,25,32,121,159,C
2009,31,23,414,38,111,6,25,32,86,6,13,2,26,28,75,10,3,37,34,88,PG
2009,30,69,2470,382,788,10,53,372,735,117,147,180,409,589,139,88,66,105,132,891,SF
2009,30,42,1516,215,446,8,40,207,406,67,85,107,258,365,77,57,45,56,92,505,SF
2009,30,27,954,167,342,2,13,165,329,50,62,73,151,224,62,31,21,49,40,386,SF
2009,33,60,838,80,165,2,10,78,155,30,44,62,125,187,14,7,33,35,121,192,C
2009,35,25,189,33,73,25,55,8,18,3,6,6,34,40,15,4,5,6,24,94,PF
2009,24,33,266,28,77,10,33,18,44,20,25,7,26,33,13,8,4,9,33,86,SF
2009,31,66,2111,318,648,14,38,304,610,119,197,81,314,395,132,96,74,104,201,769,PF
2009,25,51,1947,341,811,115,277,226,534,457,527,29,154,183,138,61,8,146,116,1254,SG
2009,31,39,1064,124,285,0,3,124,282,46,85,41,116,157,46,15,30,56,96,294,SG
2009,28,82,2496,349,822,166,394,183,428,105,118,16,235,251,173,40,12,100,160,969,SG
2009,25,78,1408,184,320,0,1,184,319,84,158,169,155,324,24,25,63,45,157,452,C
2009,24,24,301,39,98,1,1,38,97,14,20,20,49,69,10,5,4,26,32,93,PF
2009,21,82,3120,562,1283,145,378,417,905,247,281,56,252,308,262,91,13,226,204,1516,SG
2009,22,82,2114,227,491,0,4,227,487,140,192,189,298,487,87,87,45,100,204,594,PF
2009,24,58,1101,192,488,63,189,129,299,107,141,21,89,110,68,47,14,64,103,554,SG
2009,24,34,636,105,292,38,119,67,173,60,81,11,52,63,32,27,6,45,63,308,SG
2009,24,24,465,87,196,25,70,62,126,47,60,10,37,47,36,20,8,19,40,246,SG
2009,34,62,1866,268,525,0,0,268,525,60,86,185,422,607,83,41,50,51,191,596,PF
2009,21,75,1143,191,387,0,0,191,387,107,162,120,174,294,23,33,75,61,155,489,C
2009,29,35,1181,188,485,44,117,144,368,125,156,20,134,154,175,42,15,69,38,545,SG
2009,23,79,2072,140,324,2,4,138,320,74,102,113,315,428,198,62,74,92,153,356,SF
2009,21,33,279,35,83,0,10,35,73,10,13,26,48,74,16,12,16,12,41,80,PF
2009,25,22,283,39,103,0,2,39,101,33,48,55,58,113,6,9,5,19,43,111,PF
2009,25,3,20,5,7,0,0,5,7,5,7,5,5,10,0,1,1,2,6,15,PF
2009,25,19,263,34,96,0,2,34,94,28,41,50,53,103,6,8,4,17,37,96,PF
2009,29,18,105,15,40,0,0,15,40,6,7,15,19,34,10,1,6,10,23,36,C
2009,21,72,1623,258,562,63,179,195,383,78,89,45,122,167,107,46,15,64,187,657,SG
2009,27,34,298,48,99,1,6,47,93,23,31,19,38,57,17,11,20,21,32,120,SF
2009,23,61,1034,137,266,0,0,137,266,59,105,83,181,264,34,22,51,48,134,333,C
2009,32,82,2976,492,1041,15,53,477,988,338,409,123,245,368,534,109,14,199,196,1337,PG
2009,32,70,2100,292,614,23,56,269,558,224,272,150,395,545,234,52,36,130,223,831,C
2009,32,43,1354,184,388,20,43,164,345,125,156,83,261,344,148,30,24,83,135,513,C
2009,32,27,746,108,226,3,13,105,213,99,116,67,134,201,86,22,12,47,88,318,C
2009,28,73,2356,264,548,85,225,179,323,109,149,73,410,483,326,30,31,145,139,722,SF
2009,23,76,2290,400,749,0,4,400,745,228,326,251,403,654,138,78,73,129,288,1028,PF
2009,28,77,2589,566,1032,1,1,565,1031,381,440,204,557,761,137,30,150,234,257,1514,C
2009,33,11,365,63,146,12,35,51,111,13,18,9,20,29,12,15,2,18,21,151,SG
2009,31,39,341,41,101,0,0,41,101,22,40,35,44,79,8,5,16,23,63,104,C
2009,28,80,2068,222,474,65,183,157,291,68,80,58,307,365,95,86,60,43,133,577,SF
2009,28,54,1379,150,317,38,110,112,207,55,65,48,201,249,70,65,44,31,85,393,SF
2009,28,26,689,72,157,27,73,45,84,13,15,10,106,116,25,21,16,12,48,184,SF
2009,33,46,746,63,121,0,0,63,121,34,42,45,107,152,28,13,14,27,112,160,PF
2009,33,24,456,51,85,0,0,51,85,14,19,31,75,106,25,4,5,21,96,116,C
2009,23,23,89,7,17,0,0,7,17,4,4,4,16,20,2,2,1,7,25,18,C
2009,24,52,711,80,223,32,96,48,127,17,23,18,62,80,41,9,4,32,77,209,SF
2009,24,44,667,76,211,31,92,45,119,16,21,16,56,72,38,9,4,29,73,199,SF
2009,24,8,44,4,12,1,4,3,8,1,2,2,6,8,3,0,0,3,4,10,SF
2009,23,67,1515,255,534,86,184,169,350,80,92,78,121,199,80,36,12,52,130,676,SG
2009,28,73,2482,364,767,161,358,203,409,152,184,146,715,861,172,58,34,114,226,1041,PF
2009,29,80,1975,355,795,87,242,268,553,177,233,22,146,168,158,88,17,128,173,974,SG
2009,42,9,96,5,13,0,0,5,13,6,9,12,21,33,0,0,11,6,11,16,C
2009,32,27,319,33,74,5,25,28,49,8,22,17,50,67,19,10,4,18,50,79,PF
2009,34,74,2484,428,851,108,246,320,605,196,210,19,204,223,717,55,10,248,108,1160,PG
2009,23,13,171,24,54,0,3,24,51,5,14,6,18,24,13,9,2,15,24,53,PG
2009,26,42,1309,267,531,82,181,185,350,86,97,20,125,145,226,51,3,83,123,702,PG
2009,32,70,1214,224,437,0,1,224,436,25,32,93,147,240,109,30,38,63,171,473,C
2009,24,4,14,3,9,0,2,3,7,1,2,0,2,2,1,0,1,0,1,7,SF
2009,24,2,5,1,4,0,1,1,3,0,0,0,0,0,1,0,0,0,1,2,SF
2009,24,2,9,2,5,0,1,2,4,1,2,0,2,2,0,0,1,0,0,5,SF
2009,23,80,1938,207,372,0,1,207,371,123,182,244,362,606,106,49,110,82,238,537,C
2009,29,53,1278,186,449,79,209,107,240,100,124,34,188,222,60,26,16,73,176,551,PF
2009,29,23,713,113,252,45,102,68,150,45,59,20,119,139,42,13,17,40,85,316,SF
2009,25,71,1161,176,396,119,286,57,110,21,23,19,106,125,40,20,5,23,71,492,PF
2009,30,81,3050,774,1616,61,170,713,1446,485,545,88,593,681,197,61,63,157,176,2094,PF
2009,22,39,255,45,84,0,2,45,82,11,20,13,53,66,11,6,19,22,61,101,C
2009,22,26,108,16,31,0,0,16,31,8,12,7,27,34,8,3,8,17,29,40,C
2009,22,13,147,29,53,0,2,29,51,3,8,6,26,32,3,3,11,5,32,61,C
2009,30,68,2027,365,770,0,1,365,769,175,222,126,307,433,122,29,136,144,211,905,C
2009,30,41,1216,220,465,0,1,220,464,115,142,71,217,288,67,18,82,92,130,555,C
2009,30,27,811,145,305,0,0,145,305,60,80,55,90,145,55,11,54,52,81,350,C
2009,36,75,2252,512,841,0,1,512,840,309,519,187,446,633,126,49,108,168,253,1333,C
2009,33,54,677,61,104,0,1,61,103,20,35,65,77,142,59,7,11,38,95,142,C
2009,21,61,1314,198,351,0,0,198,351,144,226,169,255,424,31,25,69,87,238,540,C
2009,29,78,2316,346,703,33,103,313,600,160,257,176,461,637,204,77,98,138,235,885,PF
2009,26,82,2691,433,772,0,0,433,772,219,369,275,552,827,53,48,136,144,247,1085,C
2009,29,72,2409,431,888,90,202,341,686,273,334,124,433,557,120,54,53,132,219,1225,C
2009,36,50,850,61,150,0,1,61,149,80,96,13,62,75,117,19,4,34,79,202,PG
2009,24,81,2246,385,850,89,236,296,614,175,242,70,261,331,83,47,57,94,168,1034,SF
2009,24,77,1473,159,320,0,3,159,317,163,230,173,263,436,57,35,26,91,208,481,C
2009,33,80,2637,321,754,94,241,227,513,121,145,45,272,317,269,100,15,114,145,857,SG
2009,26,72,2456,639,1263,19,65,620,1198,284,363,27,196,223,496,67,4,186,110,1581,PG
2009,23,78,3002,631,1255,64,176,567,1079,455,524,69,363,432,861,216,10,231,212,1781,PG
2009,25,66,1053,116,275,48,117,68,158,25,54,31,96,127,72,22,16,48,122,305,SF
2009,23,32,277,39,101,14,43,25,58,24,29,35,41,76,2,6,3,10,34,116,C
2009,24,76,2253,276,478,0,2,276,476,96,160,204,415,619,96,22,150,165,253,648,C
2009,31,43,515,73,183,33,85,40,98,12,19,13,71,84,16,15,2,15,51,191,SG
2009,23,49,559,73,176,0,2,73,174,16,29,42,116,158,16,19,15,28,107,162,C
2009,23,22,342,46,113,0,1,46,112,10,15,27,68,95,6,16,5,15,51,102,C
2009,23,27,217,27,63,0,1,27,62,6,14,15,48,63,10,3,10,13,56,60,C
2009,31,81,3035,540,1181,119,304,421,877,459,553,56,401,457,294,80,27,228,215,1658,SF
2009,26,54,1329,176,426,80,223,96,203,78,110,44,132,176,65,31,24,56,126,510,SG
2009,32,75,2140,216,524,116,314,100,210,120,146,38,324,362,82,58,21,79,216,668,SG
2009,25,70,1227,177,338,0,0,177,338,184,267,145,200,345,46,24,38,76,192,538,PF
2009,26,60,703,106,239,0,0,106,239,38,50,71,105,176,27,9,17,51,98,250,PF
2009,25,52,738,77,203,19,61,58,142,34,45,12,57,69,108,39,5,61,74,207,PG
2009,28,82,3057,459,1020,56,141,403,879,189,243,128,348,476,253,44,51,101,104,1163,SF
2009,22,47,366,31,101,14,48,17,53,17,21,9,34,43,39,15,3,19,34,93,SG
2009,29,82,1952,168,269,0,1,168,268,112,169,204,513,717,27,34,97,78,215,448,C
2009,25,66,962,118,289,56,137,62,152,47,58,8,67,75,132,24,2,33,79,339,PG
2009,28,78,1445,196,466,105,262,91,204,43,58,45,177,222,81,46,15,98,111,540,SF
2009,28,46,771,95,214,60,136,35,78,23,27,18,99,117,38,28,7,47,51,273,SF
2009,28,32,674,101,252,45,126,56,126,20,31,27,78,105,43,18,8,51,60,267,SF
2009,19,63,1129,199,431,0,4,199,427,101,141,128,235,363,49,42,74,80,141,499,PF
2009,25,10,37,8,13,1,1,7,12,1,4,10,8,18,0,0,1,6,4,18,PF
2009,27,11,388,82,189,7,24,75,165,55,67,40,97,137,15,13,3,23,28,226,C
2009,27,39,1369,333,684,25,73,308,611,124,177,117,250,367,88,30,13,91,105,815,PF
2009,35,46,579,34,64,0,0,34,64,21,35,46,82,128,9,17,47,14,77,89,C
2009,29,33,1203,249,547,70,191,179,356,131,161,24,83,107,88,35,2,53,45,699,SG
2009,24,64,1111,117,299,67,179,50,120,81,93,8,101,109,73,21,1,54,72,382,SG
2009,28,72,2410,465,974,129,325,336,649,153,199,77,242,319,146,76,28,95,146,1212,SG
2009,28,14,491,97,220,27,59,70,161,41,55,13,45,58,36,14,3,24,43,262,SG
2009,28,58,1919,368,754,102,266,266,488,112,144,64,197,261,110,62,25,71,103,950,SG
2009,24,12,93,14,49,6,17,8,32,3,6,1,13,14,3,0,0,3,6,37,SF
2009,28,72,1894,262,667,120,329,142,338,89,117,71,248,319,117,47,7,74,132,733,SG
2009,27,72,2033,250,621,55,157,195,464,133,153,33,185,218,365,92,16,128,200,688,PG
2009,25,29,276,44,120,26,81,18,39,5,5,6,16,22,20,10,1,8,18,119,PG
2009,25,23,253,39,103,24,71,15,32,5,5,4,11,15,19,10,1,7,18,107,PG
2009,25,6,23,5,17,2,10,3,7,0,0,2,5,7,1,0,0,1,0,12,PG
2009,24,74,2209,449,1028,125,385,324,643,249,296,98,192,290,301,95,6,139,206,1272,PG
2009,22,80,1225,129,329,37,114,92,215,61,77,43,87,130,286,54,2,119,133,356,PG
2009,22,80,2642,383,759,15,48,368,711,172,268,100,316,416,659,149,11,209,193,953,PG
2009,20,81,3000,574,1208,16,72,558,1136,197,250,96,221,317,512,66,18,202,125,1361,PG
2009,34,18,160,11,41,0,4,11,37,8,11,4,27,31,10,1,1,17,24,30,PF
2009,34,20,310,34,90,0,3,34,87,32,40,13,52,65,26,9,2,19,48,100,SF
2009,27,68,1164,99,259,33,88,66,171,34,42,29,97,126,47,32,14,36,114,265,SF
2009,24,78,2903,633,1318,83,220,550,1098,416,505,104,266,370,400,88,22,152,127,1765,SG
2009,32,11,35,2,7,0,0,2,7,2,2,6,5,11,0,3,1,2,7,6,PF
2009,23,75,1803,243,575,78,209,165,366,46,66,34,199,233,66,38,37,75,128,610,SG
2009,28,25,199,20,58,10,33,10,25,4,4,0,15,15,15,5,1,10,10,54,SG
2009,29,79,2959,516,1093,126,302,390,791,288,347,59,274,333,249,83,24,165,182,1446,SF
2009,29,53,1980,351,744,77,184,274,560,191,232,43,178,221,196,58,9,122,122,970,SF
2009,29,26,979,165,349,49,118,116,231,97,115,16,96,112,53,25,15,43,60,476,SF
2009,24,18,83,6,32,0,3,6,29,3,7,10,14,24,1,3,10,3,7,15,C
2009,24,6,24,2,13,0,1,2,12,0,0,2,7,9,1,2,5,2,4,4,C
2009,24,10,51,4,16,0,2,4,14,3,5,7,6,13,0,1,5,1,3,11,C
2009,24,2,8,0,3,0,0,0,3,0,2,1,1,2,0,0,0,0,0,0,C
2009,30,39,504,48,114,24,61,24,53,16,18,7,43,50,18,7,10,12,73,136,C
2009,28,82,2488,424,799,0,3,424,796,196,258,200,520,720,123,68,11,123,261,1044,PF
2009,24,43,735,79,182,15,50,64,132,21,25,26,97,123,65,35,19,37,50,194,SF
2009,24,23,718,73,175,9,37,64,138,40,48,28,91,119,46,40,26,27,54,195,SG
2009,22,6,29,6,9,0,0,6,9,8,10,5,9,14,0,1,3,4,2,20,C
2009,22,5,23,5,7,0,0,5,7,7,9,3,6,9,0,1,2,3,2,17,C
2009,22,1,6,1,2,0,0,1,2,1,1,2,3,5,0,0,1,1,0,3,C
2009,22,79,2173,345,775,6,34,339,741,281,354,64,205,269,452,83,7,152,158,977,PG
2009,22,8,20,4,11,0,2,4,9,0,2,0,3,3,0,0,2,0,3,8,PF
2009,28,71,1729,198,441,117,262,81,179,43,58,72,205,277,92,50,10,62,186,556,SF
2009,23,18,84,11,25,0,0,11,25,7,16,5,11,16,2,1,4,2,8,29,PF
2009,23,11,61,11,21,0,0,11,21,6,14,4,8,12,2,1,4,0,6,28,PF
2009,23,7,23,0,4,0,0,0,4,1,2,1,3,4,0,0,0,2,2,1,PF
2009,25,2,13,3,6,0,0,3,6,0,0,2,2,4,0,0,0,1,1,6,C
2009,25,1,11,3,6,0,0,3,6,0,0,2,2,4,0,0,0,0,1,6,C
2009,23,37,303,31,85,10,25,21,60,18,21,10,25,35,29,11,0,23,45,90,PG
2009,23,13,122,12,37,4,10,8,27,6,6,5,11,16,12,6,0,5,14,34,PG
2009,23,24,181,19,48,6,15,13,33,12,15,5,14,19,17,5,0,18,31,56,PG
2009,27,62,884,117,221,13,40,104,181,67,78,89,161,250,17,26,28,36,110,314,PF
2009,32,51,843,92,205,0,2,92,203,30,47,72,131,203,27,17,52,43,94,214,PF
2009,25,74,1460,289,514,0,1,289,513,168,248,98,186,284,79,31,19,105,184,746,PF
2009,23,81,2245,424,950,180,453,244,497,205,272,43,254,297,227,78,14,150,190,1233,SG
2009,33,57,1102,156,333,3,7,153,326,59,82,89,174,263,41,17,40,25,122,374,C
2009,33,36,691,99,218,2,4,97,214,38,54,53,110,163,25,10,26,15,72,238,C
2009,33,21,411,57,115,1,3,56,112,21,28,36,64,100,16,7,14,10,50,136,C
2009,23,69,2421,418,849,26,87,392,762,211,359,134,364,498,169,94,111,161,184,1073,PF
2009,30,53,712,105,245,28,86,77,159,25,34,12,52,64,133,27,4,54,71,263,PG
2009,30,39,544,79,181,15,57,64,124,20,24,9,34,43,123,20,4,49,60,193,PG
2009,30,14,168,26,64,13,29,13,35,5,10,3,18,21,10,7,0,5,11,70,PG
2009,30,77,1521,243,457,0,1,243,456,80,90,75,152,227,94,64,20,74,200,566,C
2009,21,79,1263,252,502,2,8,250,494,102,132,123,170,293,30,27,56,46,181,608,C
2009,34,10,162,16,60,3,19,13,41,7,7,5,12,17,12,4,1,9,6,42,SG
2009,27,32,886,72,231,35,129,37,102,32,60,11,65,76,98,21,2,32,43,211,SG
2009,31,61,2089,287,719,145,384,142,335,93,104,44,220,264,75,52,3,51,101,812,SF
2009,26,53,1948,404,749,3,7,401,742,323,387,116,314,430,104,49,57,150,163,1134,PF
2009,22,79,2517,401,913,23,78,378,835,233,290,69,206,275,387,78,11,173,217,1058,PG
2009,23,26,343,37,71,0,0,37,71,12,16,21,68,89,9,5,17,8,50,86,C
2009,29,19,185,24,56,1,1,23,55,13,26,16,30,46,3,4,8,16,40,62,PF
2009,29,6,64,9,15,0,0,9,15,5,11,5,8,13,1,0,2,7,15,23,PF
2009,29,13,121,15,41,1,1,14,40,8,15,11,22,33,2,4,6,9,25,39,PF
2009,31,74,1527,179,398,69,168,110,230,90,106,43,189,232,82,28,10,55,130,517,SF
2009,23,51,771,110,267,13,40,97,227,56,81,22,65,87,106,36,0,73,84,289,PG
2009,23,75,2095,267,697,73,211,194,486,131,160,32,95,127,343,73,12,146,184,738,PG
2009,31,74,2491,541,1168,167,456,374,712,198,225,39,138,177,251,97,20,119,141,1447,SG
2009,30,26,306,32,66,0,0,32,66,16,23,25,41,66,6,3,18,18,35,80,C
2009,31,8,62,3,8,0,0,3,8,0,0,4,11,15,1,6,1,1,9,6,PF
2009,36,79,1404,153,304,0,2,153,302,37,45,134,271,405,66,34,58,42,170,343,PF
2009,31,64,1247,189,438,78,189,111,249,89,121,42,159,201,68,31,11,70,144,545,PF
2009,31,10,220,34,90,6,20,28,70,21,34,14,32,46,10,3,1,14,26,95,PF
2009,31,36,773,119,258,53,126,66,132,54,67,20,93,113,46,22,10,46,91,345,PF
2009,31,18,254,36,90,19,43,17,47,14,20,8,34,42,12,6,0,10,27,105,PF
2009,22,79,2175,308,683,3,9,305,674,238,304,148,360,508,77,91,151,129,220,857,PF
2009,22,82,2303,356,717,0,8,356,709,198,286,234,372,606,93,46,59,146,314,910,PF
2009,25,71,2654,469,1051,20,79,449,972,236,313,122,246,368,103,59,62,130,227,1194,SF
2009,23,19,208,19,65,9,41,10,24,5,10,12,29,41,17,5,1,7,16,52,PF
2009,24,30,282,52,121,8,23,44,98,26,33,19,12,31,12,5,1,14,14,138,SG
2009,26,79,1696,186,366,0,3,186,363,98,124,88,272,360,166,34,168,70,243,470,C
2009,29,77,2815,423,1025,134,376,289,649,314,389,45,365,410,375,64,19,204,218,1294,SF
2009,31,67,1035,110,287,41,125,69,162,28,46,28,159,187,54,36,12,38,86,289,SF
2009,26,73,2270,321,696,35,113,286,583,123,150,46,174,220,342,81,12,158,192,800,PG
2009,24,72,890,123,324,11,62,112,262,44,60,27,48,75,153,30,2,60,77,301,PG
2009,26,81,2306,270,504,0,2,270,502,154,250,166,415,581,81,75,66,80,239,694,PF
2009,33,30,292,24,75,1,1,23,74,16,18,4,18,22,55,6,0,15,26,65,PG
2009,24,78,2095,487,1089,89,258,398,831,201,240,154,366,520,137,50,56,138,254,1264,PF
2009,31,38,240,12,45,0,0,12,45,11,14,21,38,59,8,3,4,17,60,35,C
2009,24,80,1293,155,401,81,223,74,178,70,76,19,116,135,113,77,7,35,154,461,SG
2009,27,79,3048,854,1739,88,278,766,1461,590,771,89,309,398,589,173,106,272,178,2386,SG
2009,23,63,1225,229,512,64,164,165,348,88,117,19,94,113,71,40,8,59,71,610,SG
2009,21,29,216,36,58,0,1,36,57,16,23,8,21,29,13,6,2,18,51,88,SF
2009,34,56,1314,69,155,0,0,69,155,27,64,136,226,362,44,48,75,34,82,165,PF
2009,26,71,2669,389,811,39,131,350,680,365,454,112,441,553,189,121,67,148,210,1182,SF
2009,34,66,2123,302,720,113,319,189,401,78,101,56,434,490,91,62,86,59,197,795,C
2009,28,65,1166,134,307,17,57,117,250,41,57,55,125,180,177,32,10,69,105,326,SF
2009,26,82,2029,340,693,5,23,335,670,266,374,129,277,406,66,48,39,98,170,951,PF
2009,24,77,1883,257,562,48,120,209,442,168,193,39,153,192,206,96,4,92,137,730,PG
2009,29,68,1776,174,453,20,85,154,368,80,106,36,147,183,391,50,11,156,137,448,PG
2009,22,56,1166,113,246,32,93,81,153,41,58,31,99,130,101,47,25,69,81,299,SG
2009,22,12,55,8,25,0,3,8,22,3,8,0,4,4,3,1,0,6,8,19,SG
2009,28,76,2982,610,1292,6,25,604,1267,367,415,160,486,646,173,49,68,163,207,1593,PF
2009,25,64,2152,285,624,91,228,194,396,90,108,31,172,203,226,94,13,92,125,751,SG
2009,24,53,269,14,34,1,1,13,33,14,30,24,32,56,19,18,4,13,35,43,SG
2009,20,82,2668,436,1095,35,129,401,966,349,428,178,221,399,435,110,16,274,191,1256,PG
2009,22,7,130,26,50,0,0,26,50,10,13,10,22,32,6,3,5,3,10,62,PF
2009,26,4,11,3,5,1,2,2,3,0,0,0,0,0,1,1,1,3,2,7,SF
2009,26,62,1049,184,370,0,4,184,366,79,140,96,181,277,47,26,16,75,137,447,C
2009,26,37,719,130,268,0,3,130,265,52,87,65,130,195,33,18,11,55,89,312,C
2009,26,25,330,54,102,0,1,54,101,27,53,31,51,82,14,8,5,20,48,135,C
2009,29,41,636,77,213,27,72,50,141,37,46,20,50,70,37,22,7,37,55,218,SG
2009,24,68,2505,463,984,70,226,393,758,326,384,24,171,195,725,73,20,228,134,1322,PG
2009,25,10,20,5,12,2,6,3,6,0,0,1,1,2,0,1,0,1,2,12,SF
2009,22,81,1919,336,844,63,220,273,624,304,385,36,129,165,242,85,14,151,128,1039,SG
2009,23,9,54,4,17,2,6,2,11,2,6,0,4,4,13,1,1,4,6,12,PG
2009,22,2,3,2,2,0,0,2,2,0,0,0,0,0,0,0,0,0,1,4,PF
2009,22,61,2093,285,622,55,155,230,467,220,273,110,272,382,81,57,39,70,127,845,SF
2009,26,81,2834,526,1126,183,420,343,706,208,228,47,232,279,329,69,9,179,215,1443,PG
2009,22,33,366,30,72,0,0,30,72,20,32,34,45,79,13,7,29,20,72,80,PF
2009,22,15,170,16,56,1,17,15,39,9,11,19,27,46,2,2,9,5,19,42,SF
2009,25,45,512,70,157,0,2,70,155,46,63,49,104,153,12,22,18,34,64,186,PF
2009,25,30,305,40,89,0,2,40,87,32,42,25,53,78,8,12,10,26,36,112,PF
2009,25,15,207,30,68,0,0,30,68,14,21,24,51,75,4,10,8,8,28,74,PF
2009,29,69,2452,416,1037,153,383,263,654,196,262,65,294,359,229,105,24,140,155,1181,SF
2009,24,65,1552,179,431,45,149,134,282,71,95,31,105,136,77,46,27,54,172,474,SF
2009,21,39,688,130,246,0,4,130,242,63,85,62,95,157,21,22,37,23,74,323,PF
2009,23,6,73,8,20,0,0,8,20,2,6,2,18,20,2,2,0,6,8,18,SF
2009,21,54,772,109,234,2,21,107,213,17,30,46,106,152,43,35,19,43,49,237,SF
2009,33,17,125,10,27,0,0,10,27,3,8,7,18,25,3,4,5,9,17,23,C
2009,23,82,1837,336,756,56,164,280,592,164,193,31,119,150,95,39,20,92,140,892,SG
2009,20,75,2580,475,960,56,164,419,796,139,189,139,238,377,86,100,23,118,165,1145,PF
2009,23,10,28,3,11,0,6,3,5,0,0,0,0,0,2,1,1,3,10,6,SG
2010,24,82,2221,272,585,108,249,164,336,72,98,59,193,252,138,46,30,74,225,724,SG
2010,21,6,30,5,10,0,0,5,10,0,1,1,3,4,0,1,1,2,5,10,C
2010,24,78,2922,579,1169,5,16,574,1153,230,304,192,435,627,160,67,48,104,231,1393,PF
2010,23,8,29,1,6,0,1,1,5,2,3,2,3,5,2,1,1,0,9,4,SF
2010,31,51,456,46,116,1,6,45,110,12,13,36,46,82,16,11,5,22,68,105,PF
2010,34,80,2819,464,973,145,399,319,574,231,253,45,208,253,210,64,25,129,182,1304,SG
2010,28,54,889,129,253,0,5,129,248,72,119,52,93,145,72,59,19,66,109,330,SG
2010,33,52,1421,155,446,58,168,97,278,59,81,13,116,129,176,50,10,95,103,427,PG
2010,33,27,766,95,277,28,87,67,190,44,54,9,66,75,104,27,5,61,50,262,PG
2010,33,25,655,60,169,30,81,30,88,15,27,4,50,54,72,23,5,34,53,165,PG
2010,27,79,1168,152,276,0,1,152,275,67,123,128,218,346,31,24,73,57,169,371,PF
2010,31,76,1695,142,251,0,3,142,248,164,236,147,336,483,33,42,143,59,171,448,PF
2010,29,63,891,147,340,27,78,120,262,46,67,54,154,208,44,15,12,37,119,367,C
2010,24,1,15,1,3,0,0,1,3,0,0,1,0,1,0,0,0,1,1,2,SF
2010,21,63,911,169,388,78,211,91,177,71,82,70,132,202,37,25,14,56,81,487,PF
2010,25,69,2634,688,1502,59,187,629,1315,508,612,152,302,454,222,88,30,209,225,1943,SF
2010,27,80,1322,76,159,0,0,76,159,66,92,123,126,249,12,20,109,45,158,218,C
2010,28,32,1169,253,616,63,181,190,435,153,207,17,116,133,230,41,9,117,95,722,PG
2010,24,72,2629,394,999,136,407,258,592,148,228,78,325,403,276,126,40,161,162,1072,SF
2010,25,18,239,19,50,0,0,19,50,13,28,17,44,61,16,8,8,13,44,51,PF
2010,25,6,56,4,12,0,0,4,12,2,2,5,9,14,2,2,4,4,5,10,C
2010,25,9,40,5,17,0,1,5,16,0,2,5,1,6,3,5,0,5,10,10,C
2010,30,72,1585,178,375,7,25,171,350,76,90,26,104,130,225,36,6,54,102,439,PG
2010,21,32,457,63,146,0,1,63,145,17,30,37,73,110,15,14,14,22,60,143,PF
2010,35,40,644,57,157,22,73,35,84,25,27,5,24,29,91,17,0,32,53,161,PG
2010,22,80,1472,168,435,70,178,98,257,102,131,11,86,97,193,45,5,74,127,508,PG
2010,22,39,405,43,65,0,0,43,65,18,20,25,73,98,1,7,16,12,76,104,C
2010,26,9,231,48,88,10,27,38,61,19,28,12,29,41,10,5,9,7,16,125,SF
2010,25,13,91,6,18,0,7,6,11,2,6,4,19,23,7,8,2,6,16,14,SF
2010,28,22,244,39,73,7,24,32,49,24,29,3,20,23,26,12,2,20,30,109,PG
2010,27,44,786,155,365,44,136,111,229,64,73,11,58,69,64,23,12,46,71,418,PG
2010,25,78,1546,232,527,56,157,176,370,76,90,17,129,146,258,35,6,102,119,596,PG
2010,24,80,2799,537,1143,121,325,416,818,181,234,105,388,493,93,25,111,120,215,1376,PF
2010,29,81,2097,271,557,66,207,205,350,108,146,106,339,445,134,59,30,112,185,716,SF
2010,28,7,232,30,68,0,0,30,68,22,29,31,46,77,8,4,4,11,24,82,C
2010,24,50,648,119,233,0,0,119,233,52,63,54,73,127,19,12,27,31,69,290,PF
2010,33,15,134,14,40,1,4,13,36,7,10,4,19,23,3,4,2,3,19,36,C
2010,31,67,2168,178,447,101,279,77,168,77,106,74,238,312,164,53,76,64,139,534,SG
2010,21,37,918,139,268,54,132,85,136,43,51,32,109,141,44,24,25,27,83,375,SF
2010,21,74,1304,200,483,29,92,171,391,201,242,18,102,120,172,26,5,94,152,630,SG
2010,21,78,2328,468,1040,28,102,440,938,192,240,123,375,498,100,80,49,131,221,1156,PF
2010,21,56,700,155,299,45,110,110,189,42,52,12,66,78,74,29,12,54,84,397,PG
2010,23,66,1121,154,379,60,158,94,221,101,121,14,81,95,89,42,5,60,80,469,SG
2010,30,71,1611,169,443,73,200,96,243,48,67,31,101,132,104,39,12,54,136,459,SG
2010,33,6,180,28,61,12,27,16,34,3,3,5,18,23,13,4,2,5,15,71,SG
2010,33,5,157,24,55,9,24,15,31,3,3,5,16,21,10,4,2,5,13,60,SG
2010,33,1,23,4,6,3,3,1,3,0,0,0,2,2,3,0,0,0,2,11,SG
2010,29,25,292,40,100,14,39,26,61,24,26,15,37,52,16,2,17,28,33,118,SF
2010,31,80,2195,268,644,126,324,142,320,68,79,20,164,184,310,67,3,90,157,730,PG
2010,23,33,763,81,137,0,0,81,137,4,25,63,196,259,57,20,44,32,117,166,C
2010,33,73,2490,402,962,157,407,245,555,466,512,25,203,228,409,82,9,177,153,1427,PG
2010,20,82,1494,275,495,0,2,275,493,88,161,200,326,526,65,50,39,112,224,638,PF
2010,29,80,2159,217,522,116,294,101,228,36,48,21,166,187,380,58,6,128,123,586,PG
2010,29,51,1397,143,355,78,207,65,148,24,32,15,103,118,203,37,2,65,84,388,PG
2010,29,29,762,74,167,38,87,36,80,12,16,6,63,69,177,21,4,63,39,198,PG
2010,23,81,2256,478,999,13,44,465,955,174,234,158,351,509,170,85,71,182,218,1143,PF
2010,29,79,1559,120,298,70,196,50,102,37,50,25,151,176,95,45,12,53,156,347,SF
2010,25,69,2229,473,910,0,2,473,908,149,237,208,493,701,127,39,175,131,222,1095,C
2010,29,65,1161,166,372,90,231,76,141,35,48,52,162,214,68,30,24,39,109,457,PF
2010,25,63,1045,117,223,0,0,117,223,19,58,124,191,315,29,30,48,37,111,253,PF
2010,28,78,2673,617,1098,0,0,617,1098,285,384,181,693,874,247,84,36,212,270,1519,PF
2010,25,70,2526,600,1158,8,22,592,1136,470,590,205,554,759,166,43,68,169,170,1678,C
2010,34,1,8,1,1,0,0,1,1,2,2,1,1,2,0,1,0,0,2,4,SF
2010,33,67,1117,172,403,19,60,153,343,77,89,17,58,75,171,24,3,69,48,440,PG
2010,30,76,2297,412,858,0,1,412,857,172,233,179,282,461,109,82,80,131,232,996,PF
2010,23,82,2482,409,949,82,237,327,712,166,256,70,209,279,193,117,29,164,224,1066,SG
2010,24,58,1742,209,429,8,31,201,398,85,133,45,142,187,154,91,15,53,80,511,SG
2010,24,53,1662,206,416,8,31,198,385,81,128,44,136,180,151,85,15,51,80,501,SG
2010,24,5,80,3,13,0,0,3,13,4,5,1,6,7,3,6,0,2,0,10,SG
2010,30,21,95,9,26,0,0,9,26,1,6,12,13,25,1,1,3,2,19,19,C
2010,30,7,36,2,13,0,0,2,13,1,2,6,6,12,0,1,1,0,9,5,C
2010,30,14,59,7,13,0,0,7,13,0,4,6,7,13,1,0,2,2,10,14,C
2010,22,52,654,55,103,0,0,55,103,37,62,105,108,213,22,15,5,23,115,147,PF
2010,25,82,2919,575,1331,209,525,366,806,245,298,54,161,215,434,69,14,232,199,1604,PG
2010,25,45,519,88,237,26,98,62,139,13,15,9,29,38,88,15,1,46,42,215,PG
2010,25,22,328,60,152,17,66,43,86,8,8,1,17,18,46,9,1,24,28,145,PG
2010,25,23,191,28,85,9,32,19,53,5,7,8,12,20,42,6,0,22,14,70,PG
2010,22,57,535,68,147,2,7,66,140,48,72,31,47,78,19,21,10,19,53,186,SF
2010,31,50,1060,136,361,58,164,78,197,69,86,29,95,124,65,33,6,62,72,399,SG
2010,31,39,967,128,325,54,147,74,178,69,86,27,82,109,58,30,5,57,62,379,SG
2010,31,11,93,8,36,4,17,4,19,0,0,2,13,15,7,3,1,5,10,20,SG
2010,27,48,660,62,124,0,1,62,123,33,98,53,124,177,22,15,12,43,93,157,C
2010,24,82,1700,253,592,62,189,191,403,99,121,30,153,183,108,57,31,67,129,667,SG
2010,31,73,2835,716,1569,99,301,617,1268,439,541,78,313,391,365,113,20,233,187,1970,SG
2010,21,74,1488,249,565,92,249,157,316,67,87,38,182,220,88,34,11,48,85,657,SF
2010,29,47,1853,293,694,25,95,268,599,185,211,68,248,316,107,68,15,113,126,796,SF
2010,29,27,930,157,357,17,50,140,307,79,104,36,109,145,49,48,9,47,67,410,SG
2010,30,82,2702,356,870,145,432,211,438,122,145,39,201,240,116,36,68,79,121,979,SF
2010,22,65,1977,392,688,0,1,392,687,193,261,177,364,541,68,35,94,115,193,977,C
2010,27,63,1667,237,534,12,55,225,479,142,178,24,118,142,283,55,7,115,143,628,PG
2010,28,68,1817,274,568,68,171,206,397,83,104,23,119,142,404,47,7,99,135,699,PG
2010,35,51,1596,166,356,2,6,164,350,60,91,166,450,616,151,69,99,64,105,394,PF
2010,35,23,718,72,145,0,1,72,144,18,31,83,172,255,35,26,47,27,56,162,C
2010,32,29,267,14,36,3,9,11,27,17,18,7,22,29,24,9,3,7,56,48,PF
2010,25,68,857,113,282,41,135,72,147,52,63,26,111,137,37,25,20,21,79,319,SG
2010,23,71,795,88,222,0,6,88,216,33,53,53,97,150,33,28,9,24,107,209,SF
2010,29,25,121,18,50,4,19,14,31,6,6,4,8,12,6,5,0,7,13,46,SG
2010,34,54,859,76,181,17,63,59,118,11,13,17,72,89,160,39,13,58,72,180,PG
2010,33,75,2310,434,1015,119,324,315,691,257,306,33,260,293,236,53,18,106,189,1244,SG
2010,21,77,1931,300,672,75,203,225,469,117,174,75,274,349,95,54,17,98,125,792,SF
2010,23,73,1807,182,454,75,236,107,218,82,110,25,110,135,246,91,12,123,175,521,PG
2010,27,51,1163,109,190,0,0,109,190,115,157,114,206,320,16,17,55,91,138,333,C
2010,22,65,2320,412,860,40,150,372,710,129,160,93,255,348,138,46,49,108,184,993,SG
2010,22,51,383,56,151,2,5,54,146,26,36,18,44,62,21,7,13,23,25,140,PF
2010,31,34,261,12,31,0,0,12,31,10,25,22,40,62,6,2,3,10,42,34,C
2010,31,24,115,8,23,0,1,8,22,0,2,5,9,14,4,3,2,5,21,16,C
2010,25,43,470,47,128,4,17,43,111,13,21,13,37,50,44,23,1,32,45,111,SG
2010,22,76,2109,376,789,46,115,330,674,148,174,41,151,192,432,78,4,202,92,946,PG
2010,29,75,1557,182,309,1,4,181,305,74,107,152,232,384,38,37,48,63,230,439,C
2010,22,80,2569,369,830,82,212,287,618,139,187,30,161,191,425,109,12,170,178,959,PG
2010,27,5,36,3,10,0,3,3,7,0,2,0,3,3,7,0,0,4,5,6,PG
2010,29,15,44,7,23,2,9,5,14,5,7,1,8,9,1,0,2,6,5,21,PF
2010,22,45,691,81,253,40,126,41,127,21,25,9,73,82,43,14,10,24,50,223,SG
2010,29,79,2460,496,1105,163,427,333,678,270,315,34,167,201,238,61,12,137,132,1425,SG
2010,22,63,707,106,214,0,2,106,212,31,48,54,106,160,14,24,22,15,97,243,PF
2010,27,7,62,8,21,0,0,8,21,10,17,4,9,13,0,0,1,13,13,26,C
2010,21,80,2896,528,1143,166,380,362,763,177,200,48,308,356,472,152,19,243,252,1399,PG
2010,28,82,2124,285,523,0,0,285,523,97,133,239,545,784,64,42,151,123,252,667,C
2010,34,55,1280,133,213,1,3,132,210,61,101,128,272,400,31,15,77,61,153,328,C
2010,29,51,937,124,249,6,28,118,221,34,56,27,68,95,66,27,6,42,91,288,SF
2010,30,75,2523,412,1015,82,296,330,719,239,291,52,214,266,598,126,43,211,210,1145,PG
2010,24,54,933,122,279,0,4,122,275,96,138,101,104,205,35,21,14,53,132,340,PF
2010,25,2,8,2,4,0,0,2,4,1,2,0,0,0,3,0,1,0,0,5,PF
2010,30,36,499,62,143,16,42,46,101,18,31,10,47,57,39,11,3,29,39,158,SF
2010,21,69,915,137,295,29,95,108,200,46,56,34,140,174,34,25,26,48,114,349,SF
2010,27,75,2279,299,732,134,365,165,367,93,119,51,343,394,202,80,21,119,138,825,SF
2010,24,70,2651,473,1014,32,83,441,931,252,330,131,381,512,143,66,61,134,129,1230,SF
2010,20,77,1664,255,512,4,16,251,496,148,194,66,157,223,53,43,18,62,176,662,SG
2010,27,82,2906,373,773,66,206,307,567,113,147,131,293,424,325,60,57,178,219,925,PF
2010,27,6,44,2,10,1,6,1,4,0,0,1,3,4,3,1,0,3,8,5,SG
2010,27,9,51,2,10,1,7,1,3,1,4,0,3,3,8,4,0,0,2,6,PG
2010,27,4,25,1,6,1,5,0,1,0,2,0,2,2,4,3,0,0,1,3,PG
2010,27,5,26,1,4,0,2,1,2,1,2,0,1,1,4,1,0,0,1,3,PG
2010,28,27,262,15,29,0,0,15,29,2,9,24,41,65,5,5,14,12,31,32,C
2010,29,53,971,129,324,59,157,70,167,47,61,8,46,54,135,34,0,59,82,364,PG
2010,26,15,106,9,20,0,0,9,20,5,12,16,27,43,2,3,2,6,21,23,PF
2010,26,7,54,5,11,0,0,5,11,1,2,11,14,25,2,2,1,4,12,11,PF
2010,26,8,52,4,9,0,0,4,9,4,10,5,13,18,0,1,1,2,9,12,PF
2010,23,56,1087,179,391,68,175,111,216,55,68,40,68,108,112,42,3,55,116,481,PG
2010,23,67,1730,255,573,14,54,241,519,133,157,45,153,198,93,55,19,97,101,657,SF
2010,23,80,1442,222,491,74,188,148,303,117,159,38,133,171,241,48,8,126,131,635,PG
2010,24,82,1991,225,490,120,262,105,228,104,138,99,182,281,115,81,16,68,162,674,SF
2010,27,67,2072,168,451,90,258,78,193,68,95,28,150,178,378,59,3,110,83,494,PG
2010,33,78,2438,561,1082,2,11,559,1071,271,374,221,567,788,246,45,117,140,152,1395,C
2010,29,67,1486,229,558,75,236,154,322,133,158,25,211,236,103,38,15,72,105,666,SF
2010,21,82,3239,794,1668,128,351,666,1317,756,840,105,518,623,231,112,84,271,171,2472,SF
2010,22,76,1384,190,448,64,162,126,286,61,70,33,126,159,74,20,5,74,72,505,SG
2010,24,64,2647,631,1406,77,228,554,1178,292,388,47,210,257,340,143,25,244,189,1631,SG
2010,33,12,66,5,15,0,0,5,15,2,5,6,8,14,2,1,0,1,7,12,C
2010,33,11,62,4,13,0,0,4,13,2,2,5,8,13,2,1,0,1,7,10,C
2010,33,1,4,1,2,0,0,1,2,0,3,1,0,1,0,0,0,0,0,2,C
2010,31,79,1317,175,393,57,169,118,224,46,61,59,95,154,48,34,17,20,125,453,SF
2010,29,28,311,34,69,0,0,34,69,27,60,30,75,105,8,14,4,22,44,95,PF
2010,20,72,2677,533,1165,36,141,497,1024,348,465,66,314,380,414,109,26,216,204,1450,SG
2010,23,82,1474,224,515,86,229,138,286,57,85,14,117,131,127,52,11,72,109,591,PG
2010,25,80,2643,388,846,60,156,328,690,132,173,53,235,288,446,123,22,168,172,968,PG
2010,24,62,1441,160,423,98,266,62,157,85,98,35,129,164,127,62,11,72,87,503,SG
2010,23,49,408,52,95,0,1,52,94,24,57,33,57,90,15,6,19,24,78,128,C
2010,36,46,709,81,184,32,82,49,102,8,15,6,65,71,43,10,6,21,33,202,SF
2010,36,25,395,37,97,13,41,24,56,6,9,5,33,38,19,6,4,13,12,93,SF
2010,36,21,314,44,87,19,41,25,46,2,6,1,32,33,24,4,2,8,21,109,SF
2010,35,82,2227,212,558,78,224,134,334,113,132,25,145,170,201,90,9,78,202,615,PG
2010,20,81,2339,397,952,77,215,320,737,223,270,24,167,191,356,82,2,233,98,1094,PG
2010,26,47,1189,186,418,8,50,178,368,104,135,41,108,149,180,44,11,90,102,484,PG
2010,33,16,255,22,46,0,1,22,45,5,9,34,47,81,21,3,4,14,45,49,C
2010,26,70,1667,256,619,63,182,193,437,129,145,16,114,130,228,33,10,94,123,704,PG
2010,26,81,2190,317,703,172,392,145,311,98,121,66,361,427,113,64,74,73,263,904,C
2010,31,32,314,39,89,0,0,39,89,10,25,38,54,92,12,9,13,15,63,88,C
2010,23,32,217,38,82,7,26,31,56,23,46,6,23,29,39,12,0,14,17,106,PG
2010,21,81,2747,392,927,186,488,206,439,251,307,65,333,398,135,75,58,110,191,1221,SF
2010,28,25,575,82,176,23,59,59,117,15,17,11,55,66,45,10,19,21,49,202,SG
2010,33,69,2060,402,772,1,5,401,767,185,221,78,428,506,185,68,57,101,170,990,PF
2010,25,69,2469,378,651,0,1,378,650,252,376,208,432,640,165,69,109,135,254,1008,C
2010,29,65,2403,452,844,0,5,452,839,286,362,243,491,734,218,37,113,143,152,1190,C
2010,23,80,3175,600,1288,66,202,534,1086,301,400,115,357,472,153,118,64,169,201,1567,SF
2010,22,11,182,28,59,7,9,21,50,18,29,15,18,33,7,7,1,10,13,81,SG
2010,32,45,761,89,206,48,123,41,83,16,23,21,93,114,32,41,10,15,89,242,SF
2010,23,56,1068,125,268,71,149,54,119,34,49,13,60,73,70,25,7,36,79,355,PG
2010,24,82,2204,311,629,0,0,311,629,113,175,226,385,611,70,50,104,114,282,735,PF
2010,24,32,239,28,60,0,10,28,50,13,23,16,35,51,13,9,2,17,29,69,SF
2010,24,21,99,9,21,0,2,9,19,6,12,4,16,20,6,4,1,7,10,24,SF
2010,24,11,140,19,39,0,8,19,31,7,11,12,19,31,7,5,1,10,19,45,SF
2010,25,2,5,1,1,0,0,1,1,0,0,0,1,1,0,1,0,0,0,2,SF
2010,32,75,2150,398,903,132,350,266,553,309,355,68,216,284,370,103,24,154,154,1237,SG
2010,27,76,2210,327,732,74,199,253,533,104,126,76,272,348,124,62,16,95,155,832,SF
2010,28,46,1030,157,336,1,6,156,330,93,115,123,193,316,26,26,50,56,129,408,C
2010,28,24,725,131,266,0,2,131,264,93,101,84,142,226,21,15,8,52,65,355,PF
2010,26,62,1730,291,699,75,234,216,465,198,230,26,93,119,166,49,6,118,147,855,SG
2010,21,62,2229,352,784,119,321,233,463,222,299,25,135,160,186,69,14,144,96,1045,SG
2010,25,81,1088,121,227,0,3,121,224,51,75,104,237,341,17,17,70,46,138,293,C
2010,27,63,759,105,202,2,13,103,189,54,73,39,84,123,22,23,7,43,104,266,SF
2010,27,70,804,119,240,16,50,103,190,42,65,24,111,135,23,20,10,36,94,296,SG
2010,26,62,2278,488,1139,158,438,330,701,363,428,67,275,342,171,94,51,157,183,1497,SF
2010,25,32,311,42,82,0,0,42,82,20,28,45,61,106,22,9,11,18,54,104,C
2010,25,8,50,8,21,0,0,8,21,2,7,5,11,16,2,0,0,1,10,18,C
2010,25,24,261,34,61,0,0,34,61,18,21,40,50,90,20,9,11,17,44,86,C
2010,22,20,115,15,39,6,22,9,17,4,6,8,9,17,5,6,3,5,9,40,SG
2010,23,82,3043,485,1070,104,312,381,758,165,223,112,378,490,134,104,72,135,221,1239,PF
2010,28,73,1553,248,543,47,136,201,407,95,114,20,109,129,152,32,11,67,135,638,SG
2010,21,76,1630,244,553,69,183,175,370,90,140,53,181,234,71,41,53,93,150,647,SF
2010,23,8,32,4,10,0,2,4,8,2,4,0,2,2,1,0,2,1,4,10,SF
2010,24,36,240,24,62,0,3,24,59,14,19,26,49,75,10,1,14,20,57,62,C
2010,22,47,317,40,76,2,11,38,65,17,30,13,36,49,16,4,9,11,29,99,SG
2010,29,10,44,10,21,3,5,7,16,2,5,4,6,10,0,0,2,3,5,25,SF
2010,31,46,1552,293,717,41,138,252,579,204,241,30,92,122,202,30,3,115,115,831,SG
2010,24,29,511,81,225,0,4,81,221,84,113,60,78,138,28,17,8,21,70,246,PF
2010,20,76,1738,233,578,93,248,140,330,194,240,47,197,244,137,80,20,106,200,753,SG
2010,29,72,2195,448,1030,140,409,308,621,240,317,88,317,405,110,62,26,132,209,1276,PF
2010,26,64,2221,356,884,60,217,296,667,308,386,24,179,203,423,79,18,181,178,1080,PG
2010,26,13,96,11,30,0,1,11,29,7,11,10,14,24,3,5,1,9,14,29,PF
2010,26,8,82,10,27,0,1,10,26,5,9,9,11,20,3,4,1,9,10,25,PF
2010,26,5,14,1,3,0,0,1,3,2,2,1,3,4,0,1,0,0,4,4,PF
2010,31,5,22,1,2,0,0,1,2,0,0,0,2,2,6,2,1,3,4,2,PG
2010,31,1,5,0,1,0,0,0,1,0,0,0,0,0,1,1,0,0,0,0,PG
2010,31,4,17,1,1,0,0,1,1,0,0,0,2,2,5,1,1,3,4,2,PG
2010,29,78,2177,312,632,0,0,312,632,147,193,167,462,629,52,30,23,75,174,771,PF
2010,30,52,1106,90,219,0,5,90,214,52,69,56,96,152,50,17,9,47,91,232,SF
2010,21,72,1904,312,666,26,87,286,579,73,106,145,291,436,158,32,83,131,200,723,C
2010,26,82,1773,161,329,0,0,161,329,36,66,151,314,465,139,73,43,74,219,358,C
2010,28,45,1033,138,328,60,179,78,149,14,18,9,99,108,40,29,9,28,91,350,SF
2010,30,77,2355,276,491,0,1,276,490,152,245,278,437,715,43,26,158,99,209,704,C
2010,30,49,1614,188,335,0,0,188,335,102,158,200,307,507,18,18,101,67,145,478,C
2010,30,28,741,88,156,0,1,88,155,50,87,78,130,208,25,8,57,32,64,226,C
2010,27,47,813,136,311,37,105,99,206,48,58,6,74,80,72,18,9,54,53,357,SG
2010,22,43,355,37,104,4,19,33,85,35,47,15,40,55,13,10,9,14,25,113,SG
2010,23,81,2035,387,782,3,6,384,776,169,224,177,287,464,158,30,131,145,285,946,C
2010,21,81,1691,289,522,0,1,289,521,111,163,110,290,400,40,36,39,92,132,689,PF
2010,27,82,2755,421,717,0,2,421,715,293,416,166,461,627,203,115,82,125,281,1135,C
2010,23,78,2276,353,738,75,188,278,550,183,237,42,163,205,226,69,26,101,222,964,PG
2010,37,81,2430,336,703,35,80,301,623,205,251,74,371,445,193,60,36,108,165,912,SF
2010,22,47,624,99,201,0,2,99,199,46,68,76,99,175,20,14,21,30,92,244,PF
2010,22,24,252,41,92,0,2,41,90,15,21,32,29,61,7,10,9,12,37,97,PF
2010,22,23,372,58,109,0,0,58,109,31,47,44,70,114,13,4,12,18,55,147,PF
2010,29,74,2481,308,753,104,280,204,473,85,113,24,236,260,330,85,24,113,204,805,SG
2010,19,73,1767,230,520,62,159,168,361,65,86,56,135,191,280,79,18,156,153,587,PG
2010,25,73,1223,169,303,0,1,169,302,109,158,79,128,207,51,19,38,95,199,447,C
2010,23,81,2845,467,847,1,1,466,846,213,270,236,563,799,189,59,91,122,225,1148,C
2010,31,50,846,129,322,64,167,65,155,36,40,7,62,69,48,28,7,27,61,358,PG
2010,31,18,371,44,133,15,60,29,73,12,12,6,34,40,37,12,0,20,20,115,SG
2010,24,82,2843,510,834,0,7,510,827,483,816,284,798,1082,144,75,228,274,287,1503,C
2010,29,35,918,157,388,23,86,134,302,109,139,30,95,125,48,26,11,46,91,446,SF
2010,29,31,827,137,342,20,75,117,267,94,119,26,86,112,44,23,9,43,78,388,SF
2010,29,4,91,20,46,3,11,17,35,15,20,4,9,13,4,3,2,3,13,58,SF
2010,36,73,1632,191,375,0,1,191,374,55,70,108,227,335,61,27,10,72,191,437,C
2010,25,25,131,21,53,5,16,16,37,11,13,7,11,18,13,8,3,14,12,58,PG
2010,25,16,70,7,18,3,5,4,13,5,6,3,5,8,8,3,2,9,7,22,PG
2010,25,9,61,14,35,2,11,12,24,6,7,4,6,10,5,5,1,5,5,36,PG
2010,31,45,1115,137,386,43,139,94,247,94,113,23,119,142,137,52,15,75,70,411,SG
2010,31,31,820,102,279,28,97,74,182,65,79,16,94,110,109,40,11,56,53,297,SG
2010,31,14,295,35,107,15,42,20,65,29,34,7,25,32,28,12,4,19,17,114,SG
2010,24,69,1221,180,408,0,1,180,407,127,190,120,258,378,32,36,48,66,145,487,PF
2010,24,25,315,53,115,0,0,53,115,25,44,38,57,95,7,7,11,13,43,131,PF
2010,24,44,906,127,293,0,1,127,292,102,146,82,201,283,25,29,37,53,102,356,PF
2010,25,60,783,109,217,0,4,109,213,52,69,56,111,167,37,13,35,30,132,270,C
2010,39,13,122,5,30,1,13,4,17,2,2,1,13,14,9,1,0,4,12,13,PG
2010,23,7,33,4,12,0,0,4,12,3,4,6,6,12,0,0,1,3,5,11,SF
2010,28,21,158,17,43,0,0,17,43,19,36,18,24,42,0,1,10,9,10,53,C
2010,20,73,1323,201,370,1,2,200,368,58,92,138,259,397,10,25,97,68,194,461,PF
2010,26,82,3193,496,1120,94,303,402,817,315,430,82,447,529,472,141,55,218,145,1401,SF
2010,34,64,1339,194,438,11,23,183,415,75,101,114,231,345,48,14,50,63,183,474,C
2010,29,49,355,48,103,0,0,48,103,9,19,32,55,87,8,5,29,15,54,105,C
2010,22,81,1898,323,729,81,241,242,488,113,158,157,360,517,84,53,23,71,251,840,PF
2010,34,3,67,15,26,1,1,14,25,6,12,1,3,4,11,1,0,7,5,37,PG
2010,34,25,798,121,290,8,24,113,266,98,119,15,60,75,102,18,2,57,43,348,SG
2010,28,44,326,35,83,14,35,21,48,9,12,6,28,34,27,19,2,11,39,93,SG
2010,28,26,236,26,55,12,24,14,31,6,7,5,21,26,17,10,2,5,25,70,SG
2010,28,18,90,9,28,2,11,7,17,3,5,1,7,8,10,9,0,6,14,23,SG
2010,26,82,2243,323,671,82,199,241,472,203,241,30,192,222,413,60,6,163,151,931,PG
2010,23,12,74,6,20,1,6,5,14,7,12,2,6,8,14,3,2,11,7,20,PG
2010,23,5,10,0,2,0,1,0,1,1,4,0,1,1,2,0,0,1,0,1,PG
2010,23,3,25,2,7,0,2,2,5,3,4,1,3,4,6,3,2,2,2,7,PG
2010,23,4,39,4,11,1,3,3,8,3,4,1,2,3,6,0,0,8,5,12,PG
2010,24,28,123,9,30,1,4,8,26,4,6,9,13,22,4,2,4,13,21,23,PF
2010,24,27,114,8,25,1,3,7,22,4,6,8,12,20,4,2,4,13,19,21,PF
2010,24,1,9,1,5,0,1,1,4,0,0,1,1,2,0,0,0,0,2,2,PF
2010,31,9,300,56,133,11,40,45,93,26,37,6,29,35,42,14,6,26,16,149,PF
2010,31,72,2829,544,1285,118,353,426,932,312,397,72,294,366,258,118,37,233,181,1518,SG
2010,25,76,2966,768,1528,129,387,639,1141,593,773,71,483,554,651,125,77,261,119,2258,SF
2010,34,4,46,6,20,2,6,4,14,4,8,1,2,3,5,3,0,5,3,18,PG
2010,33,66,2406,478,1036,85,247,393,789,194,300,136,419,555,84,71,21,91,179,1235,PF
2010,33,41,1595,315,700,58,168,257,532,152,217,99,263,362,52,43,9,61,112,840,PF
2010,33,25,811,163,336,27,79,136,257,42,83,37,156,193,32,28,12,30,67,395,PF
2010,23,39,412,49,111,0,1,49,110,26,38,49,55,104,24,10,9,27,58,124,C
2010,24,14,73,12,29,0,0,12,29,13,19,8,11,19,1,4,0,6,10,37,SG
2010,25,76,2463,560,1125,0,4,560,1121,181,266,180,523,703,137,63,98,136,205,1301,C
2010,29,81,2520,362,775,59,187,303,588,211,287,58,298,356,158,45,40,105,178,994,SF
2010,28,52,1462,102,230,20,62,82,168,60,93,99,124,223,83,53,58,62,157,284,PF
2010,28,18,332,36,84,1,9,35,75,15,27,31,34,65,18,9,13,14,46,88,SF
2010,20,82,2671,451,1216,145,388,306,828,223,273,49,233,282,470,105,18,200,191,1270,PG
2010,22,80,2232,290,603,36,115,254,488,125,176,194,284,478,58,79,29,82,230,741,PF
2010,22,52,1655,227,563,15,41,212,522,154,193,115,257,372,47,37,52,77,170,623,PF
2010,22,82,1453,208,334,0,4,208,330,95,149,154,241,395,48,44,66,63,255,511,PF
2010,35,31,406,49,111,13,39,36,72,19,20,8,40,48,63,11,1,26,32,130,PG
2010,22,65,757,95,210,15,46,80,164,51,70,34,94,128,48,21,43,62,126,256,PF
2010,28,76,2886,635,1386,129,350,506,1036,220,269,74,279,353,369,82,5,145,145,1619,SG
2010,29,76,1892,287,623,4,32,283,591,198,257,48,181,229,150,40,39,129,237,776,SF
2010,29,36,503,43,119,37,90,6,29,23,28,4,41,45,17,11,4,11,45,146,SF
2010,25,52,675,78,176,0,3,78,173,51,71,51,93,144,32,14,37,40,125,207,C
2010,21,70,1137,144,238,0,2,144,236,48,128,122,230,352,21,16,62,75,152,336,C
2010,27,76,2608,589,1202,0,6,589,1196,230,307,184,520,704,120,37,94,223,213,1408,C
2010,28,57,976,126,301,63,171,63,130,9,15,14,52,66,39,21,6,34,80,324,SF
2010,26,4,108,11,32,2,11,9,21,4,6,4,12,16,15,3,1,6,14,28,SF
2010,36,80,2881,284,671,176,414,108,257,80,99,48,397,445,724,145,35,195,142,824,PG
2010,28,58,1681,244,482,26,89,218,393,174,234,76,188,264,158,83,71,79,102,688,SF
2010,28,52,952,138,280,59,110,79,170,39,49,10,101,111,89,26,12,42,76,374,SG
2010,20,36,172,22,47,0,0,22,47,9,15,16,29,45,6,2,4,15,26,53,C
2010,26,76,1741,281,560,1,5,280,555,76,106,134,249,383,52,32,45,58,177,639,C
2010,25,1,22,3,6,1,2,2,4,0,0,1,3,4,2,0,0,1,0,7,SG
2010,26,80,2469,499,931,1,3,498,928,344,427,188,280,468,66,55,63,136,234,1343,PF
2010,26,52,1415,302,552,0,0,302,552,235,280,122,164,286,40,28,46,86,146,839,PF
2010,26,28,1054,197,379,1,3,196,376,109,147,66,116,182,26,27,17,50,88,504,PF
2010,24,18,111,16,43,9,28,7,15,3,5,5,14,19,0,1,2,6,14,44,SF
2010,24,17,108,16,41,9,26,7,15,3,5,5,14,19,0,1,2,6,14,44,SF
2010,25,26,234,35,75,5,16,30,59,38,49,3,14,17,26,11,1,17,16,113,PG
2010,25,5,66,9,14,1,3,8,11,12,15,0,2,2,7,6,0,2,5,31,PG
2010,25,9,33,5,16,0,1,5,15,6,7,0,1,1,3,1,1,3,3,16,PG
2010,25,12,135,21,45,4,12,17,33,20,27,3,11,14,16,4,0,12,8,66,PG
2010,22,65,1318,201,390,34,83,167,307,106,140,42,82,124,203,48,2,82,89,542,PG
2010,24,71,2375,338,775,76,225,262,550,133,153,60,192,252,121,93,20,76,130,885,SG
2010,26,81,3019,686,1258,0,8,686,1250,268,330,228,721,949,295,85,40,189,257,1640,C
2010,30,72,2369,350,805,168,423,182,382,145,180,62,256,318,107,78,28,108,180,1013,PF
2010,24,36,796,104,201,0,6,104,195,42,48,16,62,78,130,17,11,58,61,250,PG
2010,24,10,130,5,16,0,2,5,14,0,0,4,16,20,14,5,2,8,9,10,PG
2010,24,26,666,99,185,0,4,99,181,42,48,12,46,58,116,12,9,50,52,240,PG
2010,21,82,3027,563,1129,0,2,563,1127,416,509,270,439,709,187,55,139,204,251,1542,C
2010,21,51,986,171,291,0,0,171,291,88,125,104,144,248,7,10,53,41,117,430,C
2010,21,60,1714,291,646,35,106,256,540,225,276,227,431,658,136,43,23,117,136,842,PF
2010,23,68,1651,184,464,37,136,147,328,215,260,91,156,247,305,60,9,116,173,620,PG
2010,30,70,2081,457,886,13,50,444,836,460,551,92,281,373,172,51,4,168,231,1387,PF
2010,31,36,359,28,56,0,0,28,56,21,59,41,80,121,1,9,11,17,59,77,C
2010,23,26,165,35,55,0,0,35,55,31,47,13,39,52,2,3,8,15,32,101,C
2010,31,75,2385,395,778,3,19,392,759,105,139,158,319,477,107,69,61,99,141,898,SF
2010,34,14,75,4,8,0,0,4,8,2,5,14,9,23,2,0,3,2,17,10,C
2010,25,18,390,50,136,17,49,33,87,24,30,25,43,68,16,11,1,19,48,141,SF
2010,25,10,276,32,88,10,31,22,57,16,21,17,30,47,9,8,0,13,36,90,SF
2010,25,8,114,18,48,7,18,11,30,8,9,8,13,21,7,3,1,6,12,51,SF
2010,32,58,1986,283,620,8,29,275,591,93,167,142,404,546,109,72,61,91,186,667,PF
2010,26,46,1633,289,693,70,210,219,483,298,340,29,135,164,111,46,6,92,96,946,SG
2010,26,22,774,135,339,39,110,96,229,127,155,20,74,94,57,23,4,35,51,436,SG
2010,26,24,859,154,354,31,100,123,254,171,185,9,61,70,54,23,2,57,45,510,SG
2010,32,5,66,5,12,0,0,5,12,3,4,4,9,13,2,1,1,4,5,13,SF
2010,29,79,1515,193,496,88,264,105,232,27,34,11,151,162,137,30,14,59,99,501,SG
2010,23,82,2025,273,565,63,165,210,400,160,193,50,141,191,124,64,15,93,152,769,SG
2010,26,76,1550,212,415,0,1,212,414,89,155,161,240,401,39,36,38,68,175,513,C
2010,25,37,331,51,111,0,4,51,107,21,32,20,50,70,17,12,7,19,46,123,C
2010,22,81,1269,154,368,22,71,132,297,52,72,21,108,129,266,40,10,85,115,382,PG
2010,22,26,363,52,133,5,24,47,109,25,33,10,28,38,81,13,2,28,33,134,PG
2010,22,55,906,102,235,17,47,85,188,27,39,11,80,91,185,27,8,57,82,248,PG
2010,22,82,3113,542,1183,136,355,406,828,212,262,61,250,311,242,98,17,176,174,1432,SG
2010,23,73,1866,177,369,6,17,171,352,93,133,171,229,400,81,60,39,70,181,453,PF
2010,35,77,1617,205,428,0,2,205,426,36,57,149,306,455,83,43,32,79,147,446,PF
2010,22,60,968,156,307,0,1,156,306,74,116,88,155,243,14,16,101,51,122,386,C
2010,30,30,673,91,235,16,64,75,171,47,63,22,72,94,99,15,14,44,40,245,SG
2010,30,6,46,7,19,1,2,6,17,4,6,0,5,5,6,0,2,1,2,19,SG
2010,30,24,627,84,216,15,62,69,154,43,57,22,67,89,93,15,12,43,38,226,SG
2010,24,51,307,19,52,0,0,19,52,0,7,23,56,79,11,5,4,17,35,38,SF
2010,24,41,240,15,40,0,0,15,40,0,5,17,44,61,8,4,3,10,32,30,SF
2010,24,10,67,4,12,0,0,4,12,0,2,6,12,18,3,1,1,7,3,8,SF
2010,22,42,524,76,146,8,23,68,123,19,38,40,87,127,44,17,16,19,74,179,C
2010,22,60,719,104,268,42,132,62,136,31,39,9,90,99,39,18,5,25,52,281,SG
2010,22,41,486,64,177,23,82,41,95,18,21,5,67,72,22,13,4,20,33,169,SG
2010,22,19,233,40,91,19,50,21,41,13,18,4,23,27,17,5,1,5,19,112,SG
2010,26,20,120,13,33,0,0,13,33,13,24,16,19,35,3,4,9,10,20,39,PF
2010,26,4,13,1,4,0,0,1,4,3,6,1,3,4,1,1,1,0,3,5,PF
2010,26,16,107,12,29,0,0,12,29,10,18,15,16,31,2,3,8,10,17,34,PF
2010,22,63,1497,241,562,74,217,167,345,66,95,42,126,168,105,58,17,81,190,622,SF
2010,24,32,685,100,204,0,1,100,203,15,28,47,104,151,47,22,34,35,82,215,C
2010,24,8,71,8,17,0,0,8,17,0,0,5,13,18,4,4,1,2,7,16,C
2010,24,24,614,92,187,0,1,92,186,15,28,42,91,133,43,18,33,33,75,199,C
2010,33,82,2500,404,908,16,80,388,828,322,392,81,185,266,445,93,9,173,169,1146,PG
2010,33,82,1950,250,581,37,132,213,449,182,220,83,316,399,154,44,29,107,189,719,C
2010,29,54,1805,217,433,82,171,135,262,70,85,55,281,336,212,39,12,115,131,586,SG
2010,21,10,38,10,24,2,4,8,20,4,7,1,1,2,5,0,0,4,6,26,PG
2010,24,82,2277,385,716,1,9,384,707,183,264,186,373,559,131,64,99,116,285,954,PF
2010,32,58,984,189,342,0,0,189,342,81,125,114,190,304,28,15,43,53,105,459,C
2010,29,61,1052,114,247,32,100,82,147,36,45,26,165,191,49,34,30,23,69,296,SF
2010,34,23,406,54,90,0,0,54,90,7,11,26,43,69,36,5,13,21,60,115,C
2010,24,28,124,23,41,0,0,23,41,16,27,10,28,38,2,5,3,12,34,62,PF
2010,25,31,241,32,85,5,21,27,64,5,8,10,22,32,18,3,2,10,17,74,SF
2010,24,69,2018,329,703,140,307,189,396,101,114,61,198,259,104,65,16,84,158,899,SG
2010,20,13,54,7,19,0,0,7,19,0,0,3,7,10,1,2,0,4,13,14,PF
2010,29,72,2344,384,813,128,333,256,480,154,193,129,608,737,150,72,34,100,175,1050,PF
2010,30,75,1673,268,683,69,221,199,462,141,194,28,155,183,135,46,16,91,126,746,SG
2010,30,46,993,160,411,41,131,119,280,93,131,15,83,98,84,28,12,65,77,454,SG
2010,30,29,680,108,272,28,90,80,182,48,63,13,72,85,51,18,4,26,49,292,SG
2010,33,46,685,62,146,19,64,43,82,14,24,34,81,115,29,26,14,25,94,157,PF
2010,33,13,204,20,53,3,17,17,36,6,12,12,26,38,15,9,2,12,33,49,PF
2010,33,33,481,42,93,16,47,26,46,8,12,22,55,77,14,17,12,13,61,108,PF
2010,35,81,2660,499,985,124,291,375,694,211,225,34,234,268,892,42,12,295,108,1333,PG
2010,27,65,1860,317,706,86,226,231,480,98,116,26,168,194,353,48,2,139,147,818,PG
2010,33,42,413,81,149,0,0,81,149,1,5,37,52,89,25,10,17,16,54,163,C
2010,24,64,1925,262,520,0,0,262,520,163,219,220,484,704,132,32,100,117,198,687,C
2010,30,75,1477,234,587,96,249,138,338,71,99,32,190,222,75,32,26,67,160,635,SF
2010,26,54,362,42,108,22,71,20,37,7,9,1,32,33,6,7,2,2,21,113,SF
2010,31,81,3039,720,1496,51,121,669,1375,536,586,80,540,620,218,70,79,149,208,2027,PF
2010,23,11,51,8,15,0,1,8,14,3,6,2,9,11,1,2,4,5,12,19,C
2010,31,70,1991,394,745,0,2,394,743,162,225,124,362,486,92,25,95,125,212,950,C
2010,37,53,1240,262,463,0,1,262,462,112,226,93,262,355,80,15,62,105,169,636,C
2010,34,57,650,35,56,0,0,35,56,13,17,34,71,105,51,11,9,36,121,83,C
2010,22,21,502,92,152,0,0,92,152,49,64,64,114,178,19,8,48,39,84,233,C
2010,30,82,2585,342,739,58,182,284,557,140,202,184,618,802,267,75,59,150,227,882,PF
2010,27,82,2370,348,656,0,0,348,656,154,274,251,491,742,55,54,127,111,218,850,C
2010,30,73,2149,355,775,82,213,273,562,196,239,132,383,515,119,38,81,127,223,988,C
2010,37,25,263,18,45,0,1,18,44,8,8,3,22,25,20,9,0,6,16,44,PG
2010,25,34,730,110,281,40,105,70,176,49,59,33,88,121,34,18,17,32,43,309,SF
2010,25,11,231,38,101,12,31,26,70,21,24,13,25,38,8,7,8,12,13,109,SF
2010,25,23,499,72,180,28,74,44,106,28,35,20,63,83,26,11,9,20,30,200,SF
2010,25,78,1089,120,246,0,4,120,242,93,143,117,176,293,42,37,31,58,186,333,C
2010,30,63,829,132,381,38,138,94,243,42,45,9,69,78,89,29,2,50,68,344,PG
2010,34,81,2289,206,475,108,261,98,214,75,95,30,201,231,157,63,18,71,151,595,SG
2010,27,56,1728,349,716,10,34,339,682,186,246,7,128,135,317,29,8,149,96,894,PG
2010,24,45,1712,314,637,52,127,262,510,161,190,20,171,191,480,96,8,112,118,841,PG
2010,26,71,877,109,300,35,118,74,182,10,26,12,105,117,58,23,6,53,84,263,SF
2010,24,44,447,77,188,14,52,63,136,29,32,32,92,124,11,9,14,32,55,197,C
2010,25,78,2154,314,522,0,3,314,519,163,280,155,440,595,80,26,132,165,219,791,C
2010,32,46,973,116,301,62,171,54,130,33,54,17,109,126,41,25,5,27,81,327,SG
2010,24,36,436,54,101,0,1,54,100,14,21,32,97,129,14,10,13,23,80,122,C
2010,32,71,2411,409,867,109,263,300,604,369,433,39,271,310,218,84,31,166,196,1296,SF
2010,27,75,1687,233,539,116,306,117,233,69,109,39,176,215,49,53,31,69,138,651,SF
2010,33,77,1731,126,345,81,242,45,103,66,80,32,297,329,117,42,19,51,204,399,SF
2010,26,20,236,21,49,0,0,21,49,37,63,19,42,61,0,6,2,11,36,79,SF
2010,27,63,581,71,194,7,16,64,178,20,31,44,72,116,35,9,6,33,71,169,PF
2010,23,56,865,145,354,60,174,85,180,60,75,12,76,88,106,35,3,59,53,410,PG
2010,26,60,806,98,242,18,63,80,179,41,59,28,46,74,123,40,13,56,109,255,PG
2010,29,49,1664,282,580,27,73,255,507,70,98,71,177,248,161,34,22,60,77,661,SF
2010,30,30,681,45,86,0,0,45,86,33,51,72,166,238,8,8,43,39,95,123,C
2010,26,25,223,20,56,10,32,10,24,6,6,1,15,16,29,9,1,10,15,56,PG
2010,29,41,891,103,273,30,108,73,165,20,27,51,127,178,45,29,7,44,97,256,PF
2010,29,8,133,14,42,7,22,7,20,4,6,8,21,29,7,3,1,5,18,39,PF
2010,29,33,758,89,231,23,86,66,145,16,21,43,106,149,38,26,6,39,79,217,PF
2010,20,33,749,137,309,1,5,136,304,109,136,73,142,215,42,28,51,49,92,384,C
2010,26,6,53,6,18,0,0,6,18,2,2,7,7,14,1,1,1,3,9,14,PF
2010,26,3,47,5,15,0,0,5,15,0,0,7,6,13,0,1,1,2,9,10,PF
2010,26,3,6,1,3,0,0,1,3,2,2,0,1,1,1,0,0,1,0,4,PF
2010,28,81,3051,652,1336,15,52,637,1284,362,465,330,620,950,149,80,34,174,226,1681,PF
2010,36,49,807,70,152,0,0,70,152,38,50,59,98,157,25,12,61,41,87,178,C
2010,36,21,183,16,36,0,0,16,36,2,4,15,25,40,9,3,18,16,27,34,C
2010,36,28,624,54,116,0,0,54,116,36,46,44,73,117,16,9,43,25,60,144,C
2010,30,18,492,75,213,18,60,57,153,47,66,11,43,54,39,19,2,15,24,215,SG
2010,25,82,1808,243,553,111,274,132,279,191,222,17,138,155,158,28,4,63,118,788,SG
2010,25,18,224,15,29,0,0,15,29,7,11,19,40,59,7,8,4,14,50,37,PF
2010,29,79,2485,473,998,157,400,316,598,136,184,81,323,404,143,66,33,92,169,1239,SG
2010,29,76,2082,242,561,142,358,100,203,52,71,64,310,374,93,70,18,62,169,678,SF
2010,28,82,1759,328,686,69,181,259,505,127,140,24,119,143,324,54,7,106,182,852,PG
2010,25,56,1115,215,493,87,223,128,270,50,67,28,82,110,163,49,5,73,116,567,PG
2010,25,30,733,152,336,51,136,101,200,42,54,23,49,72,112,27,5,53,66,397,PG
2010,25,26,382,63,157,36,87,27,70,8,13,5,33,38,51,22,0,20,50,170,PG
2010,23,66,1048,167,351,32,91,135,260,68,93,24,65,89,212,50,5,114,84,434,PG
2010,23,39,517,88,190,15,42,73,148,43,62,15,35,50,121,29,3,59,46,234,PG
2010,23,27,531,79,161,17,49,62,112,25,31,9,30,39,91,21,2,55,38,200,PG
2010,23,81,2963,459,904,17,80,442,824,175,282,100,260,360,794,189,11,246,198,1110,PG
2010,21,78,2871,672,1373,16,60,656,1313,259,338,65,228,293,469,57,27,217,96,1619,PG
2010,28,27,301,23,56,3,13,20,43,5,8,11,16,27,7,7,4,3,34,54,SF
2010,28,25,261,17,55,1,8,16,47,3,6,6,16,22,5,6,2,8,35,38,SG
2010,25,65,2419,491,1038,73,221,418,817,343,440,73,212,285,305,61,16,129,136,1398,SG
2010,24,82,2491,297,702,124,302,173,400,56,89,41,305,346,112,56,65,93,159,774,SG
2010,29,7,58,4,11,1,3,3,8,0,0,1,5,6,4,2,3,3,8,9,SG
2010,30,81,2824,437,991,118,309,319,682,253,305,35,235,270,223,99,26,123,166,1245,SG
2010,30,51,1695,230,548,73,192,157,356,116,147,18,156,174,125,65,22,70,101,649,SG
2010,30,30,1129,207,443,45,117,162,326,137,158,17,79,96,98,34,4,53,65,596,SG
2010,31,52,472,29,85,16,49,13,36,4,6,9,39,48,27,9,4,17,59,78,PF
2010,29,82,2671,560,1090,1,5,559,1085,208,267,175,530,705,169,63,26,163,246,1329,PF
2010,25,82,2348,194,441,41,131,153,310,60,89,76,311,387,145,97,46,90,154,489,SG
2010,23,82,1732,253,555,1,15,252,540,167,233,58,156,214,258,55,5,137,137,674,PG
2010,29,23,395,42,117,20,63,22,54,18,20,11,52,63,15,15,3,19,52,122,PF
2010,28,25,211,24,64,5,22,19,42,6,6,17,38,55,9,11,7,12,31,59,SF
2010,28,32,766,73,190,2,15,71,175,47,56,91,130,221,22,17,36,37,82,195,PF
2010,33,16,123,10,25,0,0,10,25,6,8,9,18,27,0,3,4,7,20,26,PF
2010,26,75,1232,226,397,1,5,225,392,132,208,97,190,287,84,33,25,88,194,585,PF
2010,24,75,2082,428,1033,158,467,270,566,142,201,28,206,234,183,99,20,139,174,1156,SG
2010,23,56,658,75,174,10,29,65,145,29,42,54,81,135,33,21,28,35,110,189,PF
2010,34,64,592,77,193,1,7,76,186,39,48,66,91,157,21,6,19,22,95,194,PF
2010,24,81,2871,504,999,0,7,504,992,261,422,223,482,705,342,130,172,198,240,1269,PF
2010,31,75,1410,241,488,1,6,240,482,60,74,59,173,232,70,62,14,81,206,543,C
2010,22,62,1016,212,444,0,5,212,439,108,145,85,167,252,36,29,34,51,152,532,C
2010,35,42,855,129,316,45,130,84,186,55,69,19,81,100,70,21,9,66,56,358,SG
2010,28,64,883,46,163,19,87,27,76,25,35,11,80,91,56,16,6,30,74,136,SG
2010,28,40,616,29,103,11,62,18,41,18,25,7,58,65,44,11,5,24,51,87,SG
2010,28,24,267,17,60,8,25,9,35,7,10,4,22,26,12,5,1,6,23,49,SG
2010,32,62,1947,278,688,132,352,146,336,96,107,39,188,227,92,48,5,56,83,784,SF
2010,27,82,2838,704,1264,1,6,703,1258,487,632,230,502,732,82,52,83,213,281,1896,PF
2010,23,73,2499,449,1109,18,79,431,1030,299,359,67,214,281,348,101,12,163,205,1215,PG
2010,22,44,405,46,130,15,42,31,88,27,38,14,31,45,16,8,7,16,52,134,SF
2010,23,31,303,45,119,5,22,40,97,33,46,21,25,46,16,10,3,19,15,128,SG
2010,21,71,719,90,227,7,32,83,195,41,49,5,62,67,122,34,11,50,82,228,PG
2010,24,43,659,83,201,13,56,70,145,29,37,5,40,45,126,24,5,50,71,208,PG
2010,24,39,582,67,166,11,47,56,119,24,31,5,36,41,114,22,5,44,65,169,PG
2010,24,4,77,16,35,2,9,14,26,5,6,0,4,4,12,2,0,6,6,39,PG
2010,23,27,334,44,101,13,37,31,64,35,50,6,25,31,21,13,6,27,42,136,SG
2010,23,9,118,13,29,3,12,10,17,16,24,2,12,14,7,4,4,14,16,45,SG
2010,23,5,23,3,8,0,2,3,6,5,5,1,2,3,2,1,0,2,1,11,SG
2010,23,13,193,28,64,10,23,18,41,14,21,3,11,14,12,8,2,11,25,80,SG
2010,32,77,2540,456,1041,136,373,320,668,232,268,19,121,140,292,94,17,109,142,1280,SG
2010,22,68,883,77,131,0,0,77,131,54,93,85,158,243,11,15,89,43,162,208,C
2010,31,23,321,31,68,0,0,31,68,13,22,18,46,64,1,4,16,18,39,75,C
2010,32,26,313,17,35,0,0,17,35,7,12,35,51,86,15,10,10,17,42,41,PF
2010,37,70,1049,99,208,0,0,99,208,12,15,84,207,291,47,26,46,48,159,210,C
2010,32,18,285,49,106,16,43,33,63,21,24,13,28,41,14,10,2,14,31,135,SF
2010,23,29,678,99,205,0,1,99,204,58,90,42,141,183,33,40,48,52,64,256,PF
2010,23,25,542,95,215,0,2,95,213,62,85,39,113,152,23,23,37,40,65,252,C
2010,23,75,2357,370,784,1,10,369,774,198,277,224,413,637,124,41,73,139,279,939,C
2010,26,75,2079,320,676,11,31,309,645,153,211,116,178,294,90,45,35,102,206,804,SF
2010,26,51,1405,220,460,5,14,215,446,103,139,85,107,192,61,25,22,66,144,548,SF
2010,26,24,674,100,216,6,17,94,199,50,72,31,71,102,29,20,13,36,62,256,SF
2010,22,73,1872,398,883,117,313,281,570,144,177,72,139,211,114,58,11,76,127,1057,SG
2010,31,38,589,52,140,7,39,45,101,22,27,11,55,66,108,33,5,63,67,133,PG
2010,24,46,1427,193,449,50,152,143,297,103,134,84,236,320,87,32,33,46,128,539,PF
2010,24,44,1423,193,448,50,151,143,297,103,134,84,235,319,87,32,33,46,127,539,PF
2010,25,15,96,17,39,1,7,16,32,16,21,6,4,10,4,0,0,5,6,51,SF
2010,25,11,71,13,30,1,7,12,23,16,21,5,2,7,3,0,0,4,5,43,SF
2010,25,4,25,4,9,0,0,4,9,0,0,1,2,3,1,0,0,1,1,8,SF
2010,27,42,872,85,146,0,1,85,145,37,78,54,137,191,90,23,54,49,98,207,C
2010,30,74,2272,276,674,108,289,168,385,175,226,42,301,343,304,55,32,125,220,835,SF
2010,32,69,944,91,241,26,91,65,150,42,57,51,140,191,58,34,6,42,83,250,SG
2010,27,79,2477,415,841,75,199,340,642,118,141,38,181,219,372,89,10,136,166,1023,PG
2010,25,13,97,14,30,3,12,11,18,9,11,0,3,3,12,1,0,6,6,40,PG
2010,27,76,2166,267,467,1,5,266,462,116,175,189,389,578,87,71,67,67,223,651,PF
2010,25,78,1848,363,827,99,282,264,545,106,130,85,280,365,53,48,55,74,223,931,PF
2010,25,67,575,66,164,25,81,41,83,28,33,25,54,79,41,20,4,17,67,185,SG
2010,28,77,2792,719,1511,73,243,646,1268,534,702,107,266,373,501,142,82,252,181,2045,SG
2010,22,8,29,3,6,0,0,3,6,2,2,0,5,5,3,0,0,2,4,8,SF
2010,22,27,739,117,226,50,116,67,110,37,47,15,68,83,37,23,3,26,79,321,SG
2010,35,69,1975,158,292,0,2,158,290,65,160,245,352,597,105,86,84,64,131,381,C
2010,27,76,3119,456,943,52,140,404,803,422,544,150,612,762,161,117,83,178,194,1386,SF
2010,35,79,1780,266,650,82,290,184,360,96,125,42,283,325,80,80,70,63,222,710,C
2010,29,29,272,30,84,7,17,23,67,2,4,12,26,38,40,10,1,12,19,69,SF
2010,27,76,1557,265,550,1,7,264,543,202,274,127,187,314,52,24,18,80,126,733,PF
2010,27,48,1024,182,378,1,6,181,372,125,172,87,125,212,35,17,10,57,83,490,PF
2010,27,28,533,83,172,0,1,83,171,77,102,40,62,102,17,7,8,23,43,243,PF
2010,25,65,1788,247,528,45,145,202,383,128,166,28,141,169,180,103,8,69,124,667,PG
2010,30,79,2322,223,524,53,184,170,340,120,169,54,186,240,399,104,16,175,181,619,PG
2010,23,12,144,12,33,7,19,5,14,5,6,1,17,18,11,6,6,4,13,36,SG
2010,23,82,2005,259,639,124,332,135,307,126,155,47,221,268,62,45,40,60,153,768,SF
2010,23,69,1368,236,458,2,15,234,443,44,64,42,150,192,101,39,25,65,126,518,SG
2010,29,81,2949,619,1226,7,27,612,1199,296,342,164,441,605,239,76,60,173,233,1541,PF
2010,26,60,1500,194,436,25,77,169,359,115,142,29,140,169,196,55,28,90,86,528,SG
2010,25,39,142,12,21,0,1,12,20,6,10,8,19,27,9,8,0,7,25,30,SG
2010,21,82,2813,485,1160,23,104,462,1056,329,422,143,258,401,652,108,34,268,204,1322,PG
2010,23,12,102,25,41,0,0,25,41,9,10,10,13,23,4,5,3,3,12,59,PF
2010,27,34,441,63,120,0,0,63,120,26,52,44,73,117,13,13,12,38,64,152,PF
2010,30,80,1585,165,381,18,61,147,320,103,129,72,177,249,135,66,25,76,144,451,SF
2010,30,4,59,6,12,2,3,4,9,2,4,1,3,4,4,0,0,4,5,16,PG
2010,25,76,2802,494,1053,96,259,398,794,335,418,50,253,303,798,96,16,252,208,1419,PG
2010,34,82,1703,189,426,84,221,105,205,31,41,7,119,126,298,53,3,87,65,493,PG
2010,26,54,742,81,206,30,93,51,113,32,45,16,67,83,34,12,5,18,73,224,PG
2010,23,64,1912,318,677,70,206,248,471,192,233,25,162,187,268,80,15,106,110,898,PG
2010,24,62,872,104,271,24,81,80,190,37,55,13,80,93,161,32,1,74,43,269,PG
2010,23,81,2468,302,664,40,132,262,532,176,215,106,310,416,93,66,46,72,160,820,SF
2010,27,69,2359,378,855,159,371,219,484,177,198,28,178,206,368,70,21,173,170,1092,PG
2010,23,24,782,140,283,33,92,107,191,52,62,18,92,110,66,23,6,29,49,365,SF
2010,23,20,227,21,49,0,1,21,48,10,19,21,25,46,1,8,19,20,41,52,PF
2010,26,54,597,63,121,0,1,63,120,75,98,47,99,146,21,13,21,30,85,201,PF
2010,22,78,1764,261,651,31,100,230,551,103,144,46,302,348,223,43,10,124,126,656,SF
2010,30,77,2605,306,740,105,296,201,444,128,186,99,232,331,234,106,21,121,165,845,SF
2010,25,67,1392,162,399,58,173,104,226,53,77,38,152,190,71,30,11,58,134,435,SF
2010,24,72,1496,194,419,61,157,133,262,61,69,50,185,235,91,52,32,53,94,510,SF
2010,22,68,871,116,232,2,6,114,226,25,41,58,86,144,41,29,18,44,45,259,SF
2010,24,74,1421,233,558,69,170,164,388,104,130,20,82,102,48,28,8,56,147,639,SG
2010,24,80,1321,224,497,11,56,213,441,136,175,77,124,201,52,34,20,94,106,595,SF
2010,21,67,2145,382,813,48,138,334,675,114,165,130,220,350,97,81,15,126,133,926,PF
2011,24,23,196,23,54,0,0,23,54,11,19,23,35,58,10,4,5,9,28,57,PF
2011,25,69,2324,312,627,105,248,207,379,138,163,45,206,251,168,34,31,71,153,867,SG
2011,26,4,29,6,11,3,4,3,7,0,0,0,2,2,1,1,0,4,4,15,SG
2011,22,34,340,59,133,12,34,47,99,13,18,17,61,78,10,11,19,18,73,143,C
2011,22,10,75,12,32,3,7,9,25,2,3,5,12,17,2,3,5,1,13,29,C
2011,22,24,265,47,101,9,27,38,74,11,15,12,49,61,8,8,14,17,60,114,C
2011,22,12,59,3,15,0,0,3,15,0,2,7,7,14,2,2,2,3,5,6,C
2011,22,18,142,8,15,0,0,8,15,2,4,13,22,35,4,5,7,8,30,18,C
2011,25,81,3211,707,1415,4,23,703,1392,351,444,278,431,709,170,82,94,153,220,1769,PF
2011,32,18,178,11,31,0,0,11,31,1,2,12,20,32,4,1,4,3,30,23,PF
2011,35,80,2890,480,978,168,378,312,600,193,219,51,223,274,219,77,16,117,147,1321,SG
2011,29,72,1494,251,492,4,23,247,469,137,182,70,123,193,104,129,44,86,161,643,SG
2011,20,81,1452,160,406,45,143,115,263,92,119,75,192,267,60,59,25,103,121,457,SF
2011,28,46,691,83,183,0,0,83,183,34,87,81,104,185,17,14,33,24,87,200,PF
2011,32,45,732,82,137,0,1,82,136,86,135,75,144,219,20,23,58,25,79,250,C
2011,30,40,373,56,121,8,23,48,98,14,22,20,64,84,13,5,9,22,40,134,PF
2011,30,11,150,23,47,3,10,20,37,7,7,8,26,34,7,3,3,8,11,56,PF
2011,30,29,223,33,74,5,13,28,61,7,15,12,38,50,6,2,6,14,29,78,PF
2011,21,26,286,31,81,18,46,13,35,14,18,2,21,23,18,3,6,13,24,94,SF
2011,22,64,1424,226,525,134,341,92,184,95,117,129,226,355,52,30,38,49,137,681,PF
2011,26,77,2751,684,1503,95,251,589,1252,507,605,118,445,563,221,68,46,206,224,1970,SF
2011,26,50,1774,437,967,42,126,395,841,343,417,77,305,382,140,43,31,142,134,1259,SF
2011,26,27,977,247,536,53,125,194,411,164,188,41,140,181,81,25,15,64,90,711,SF
2011,28,75,1463,53,99,0,0,53,99,47,73,104,162,266,24,10,93,36,194,153,C
2011,29,70,1796,269,734,97,327,172,407,120,153,22,167,189,274,74,21,177,188,755,PG
2011,29,21,726,130,330,47,145,83,185,56,67,6,64,70,117,30,12,71,76,363,PG
2011,29,49,1070,139,404,50,182,89,222,64,86,16,103,119,157,44,9,106,112,392,PG
2011,25,75,2600,303,762,82,271,221,491,138,197,61,347,408,162,120,31,118,180,826,SF
2011,26,53,488,37,76,2,4,35,72,16,33,42,89,131,14,18,21,28,84,92,C
2011,26,41,412,31,64,1,3,30,61,14,23,39,75,114,10,15,16,25,75,77,C
2011,26,12,76,6,12,1,1,5,11,2,10,3,14,17,4,3,5,3,9,15,C
2011,31,64,1185,120,273,31,69,89,204,39,47,20,83,103,125,21,1,60,71,310,PG
2011,31,49,995,109,238,28,64,81,174,28,35,13,67,80,100,14,1,43,60,274,PG
2011,31,15,190,11,35,3,5,8,30,11,12,7,16,23,25,7,0,17,11,36,PG
2011,22,80,1609,310,624,0,6,310,618,109,134,115,227,342,53,52,63,88,228,729,PF
2011,24,82,989,78,141,0,0,78,141,73,145,112,194,306,32,20,56,64,153,229,C
2011,23,82,2757,399,958,111,333,288,625,269,297,38,187,225,498,54,3,155,152,1178,PG
2011,21,24,137,15,55,3,16,12,39,3,9,6,24,30,6,2,2,8,15,36,SF
2011,26,8,62,6,13,1,2,5,11,3,4,2,5,7,2,4,2,1,15,16,SF
2011,26,5,44,5,9,0,0,5,9,3,4,1,3,4,2,3,2,0,11,13,SF
2011,26,3,18,1,4,1,2,0,2,0,0,1,2,3,0,1,0,1,4,3,SF
2011,29,3,22,0,2,0,0,0,2,6,8,0,1,1,3,1,0,2,4,6,PG
2011,28,58,1395,294,653,72,213,222,440,109,137,14,85,99,119,50,6,84,112,769,SG
2011,26,81,1669,285,649,66,189,219,460,133,157,29,130,159,317,30,1,136,136,769,PG
2011,25,66,2353,525,1173,77,223,448,950,287,350,74,269,343,119,34,46,152,160,1414,C
2011,30,53,1020,131,279,34,107,97,172,60,77,73,155,228,71,39,22,58,127,356,SF
2011,29,21,305,32,99,0,0,32,99,15,24,32,44,76,11,8,6,16,46,79,C
2011,29,12,183,12,51,0,0,12,51,12,20,16,24,40,4,6,4,11,32,36,C
2011,29,7,85,17,37,0,0,17,37,2,2,12,10,22,4,2,2,2,10,36,C
2011,29,2,37,3,11,0,0,3,11,1,2,4,10,14,3,0,0,3,4,7,C
2011,25,76,1980,332,645,0,2,332,643,190,233,134,290,424,57,27,52,97,159,854,PF
2011,34,38,377,45,96,2,3,43,93,8,14,17,82,99,12,5,15,12,59,100,C
2011,32,82,2375,229,509,102,267,127,242,64,93,90,283,373,185,69,81,79,158,624,SF
2011,32,59,1818,186,408,88,225,98,183,49,76,58,223,281,153,53,71,63,127,509,SF
2011,32,23,557,43,101,14,42,29,59,15,17,32,60,92,32,16,10,16,31,115,SF
2011,22,80,2522,367,807,118,342,249,465,138,164,109,252,361,123,68,49,83,194,990,SF
2011,22,71,1496,218,517,49,146,169,371,166,206,26,139,165,266,38,5,127,149,651,PG
2011,22,11,149,17,49,3,14,14,35,13,17,2,13,15,28,2,1,17,16,50,PG
2011,22,60,1347,201,468,46,132,155,336,153,189,24,126,150,238,36,4,110,133,601,PG
2011,22,73,2361,561,1246,60,164,501,1082,219,291,118,291,409,158,54,52,195,222,1401,SF
2011,22,28,496,94,223,25,83,69,140,23,30,7,45,52,64,20,8,47,76,236,PG
2011,24,80,1957,302,691,134,324,168,367,98,125,17,134,151,92,38,6,77,146,836,SG
2011,31,19,171,12,43,6,21,6,22,2,4,6,12,18,13,6,1,6,13,32,SG
2011,34,68,2097,191,467,68,193,123,274,91,102,31,145,176,118,56,14,63,169,541,SG
2011,32,80,2285,248,576,153,348,95,228,39,62,17,178,195,265,50,9,101,175,688,PG
2011,32,56,1674,192,441,113,256,79,185,29,46,15,128,143,202,38,6,68,125,526,PG
2011,32,2,29,1,9,0,4,1,5,0,0,0,3,3,8,1,0,1,3,2,PG
2011,32,22,582,55,126,40,88,15,38,10,16,2,47,49,55,11,3,32,47,160,PG
2011,24,59,1397,142,266,0,0,142,266,10,31,145,281,426,60,52,52,57,198,294,C
2011,34,72,2310,339,794,146,363,193,431,384,419,25,165,190,387,71,14,177,146,1208,PG
2011,34,51,1646,235,536,105,238,130,298,265,287,12,113,125,271,52,12,129,94,840,PG
2011,34,21,664,104,258,41,125,63,133,119,132,13,52,65,116,19,2,48,52,368,PG
2011,21,81,1734,292,583,0,2,292,581,90,137,215,350,565,77,95,42,113,213,674,PF
2011,30,79,1581,110,306,73,193,37,113,26,30,19,137,156,170,40,3,73,99,319,PG
2011,24,64,2172,426,957,4,18,422,939,220,283,183,343,526,144,98,51,172,182,1076,PF
2011,21,81,1841,206,486,32,116,174,370,99,133,68,155,223,289,92,26,194,130,543,PG
2011,30,82,1461,124,307,90,237,34,70,21,32,19,129,148,101,38,9,41,113,359,SG
2011,26,65,2297,367,742,0,4,367,738,96,217,199,521,720,131,47,168,125,217,830,C
2011,30,66,1432,172,371,105,230,67,141,32,43,60,179,239,60,26,21,27,110,481,PF
2011,23,65,1063,139,253,0,1,139,252,68,101,98,153,251,35,29,42,38,115,346,PF
2011,29,59,1882,431,845,0,0,431,845,171,244,130,435,565,145,45,18,149,186,1033,C
2011,26,77,2795,524,1056,6,25,518,1031,384,471,141,500,641,144,59,49,138,172,1438,PF
2011,34,57,862,156,352,27,71,129,281,69,82,15,40,55,141,38,3,52,43,408,PG
2011,23,3,33,4,16,0,5,4,11,0,0,2,2,4,1,1,0,0,3,8,PF
2011,20,31,162,23,67,0,5,23,62,6,12,4,13,17,12,9,0,16,20,52,PG
2011,31,81,2809,502,981,0,1,502,980,213,273,237,439,676,120,92,106,101,244,1217,PF
2011,24,56,1362,168,437,26,99,142,338,121,171,45,107,152,77,89,14,77,134,483,SF
2011,24,13,148,25,51,4,13,21,38,15,21,12,11,23,12,11,2,10,25,69,SG
2011,25,81,1781,205,427,6,27,199,400,87,133,55,207,262,140,106,22,55,82,503,SG
2011,23,63,677,48,94,0,0,48,94,40,59,74,110,184,18,14,3,24,119,136,C
2011,26,59,1284,220,587,70,236,150,351,124,140,20,58,78,233,34,3,99,115,634,PG
2011,26,34,811,134,387,48,169,86,218,78,83,11,40,51,129,21,2,55,69,394,PG
2011,26,25,473,86,200,22,67,64,133,46,57,9,18,27,104,13,1,44,46,240,PG
2011,23,49,576,74,131,5,10,69,121,32,60,41,58,99,33,20,10,35,59,185,SF
2011,23,41,488,62,113,2,6,60,107,25,47,32,52,84,29,16,8,28,48,151,SF
2011,23,8,88,12,18,3,4,9,14,7,13,9,6,15,4,4,2,7,11,34,SF
2011,28,66,1714,194,375,0,0,194,375,136,231,147,303,450,43,26,39,69,174,524,C
2011,25,82,1568,273,643,74,212,199,431,92,101,35,122,157,96,67,16,75,124,712,SG
2011,32,82,2779,740,1639,115,356,625,1283,483,583,83,336,419,388,99,12,243,172,2078,SG
2011,22,78,1738,279,656,89,274,190,382,118,138,52,229,281,127,41,18,67,114,765,SF
2011,30,29,867,170,378,28,65,142,313,68,88,22,96,118,46,28,8,49,59,436,SF
2011,31,47,770,79,237,46,136,33,101,18,27,10,67,77,27,8,15,24,37,222,SG
2011,31,41,744,73,226,42,129,31,97,18,27,10,66,76,27,8,15,22,34,206,SG
2011,31,6,26,6,11,4,7,2,4,0,0,0,1,1,0,0,0,2,3,16,SG
2011,23,54,1500,237,413,0,0,237,413,138,209,170,338,508,73,19,106,74,140,612,C
2011,28,61,1125,182,406,16,50,166,356,102,122,15,59,74,195,52,4,83,113,482,PG
2011,29,68,2102,262,596,57,156,205,440,88,103,30,172,202,605,81,7,148,143,669,PG
2011,36,59,1540,117,294,0,1,117,293,43,70,182,424,606,121,40,92,62,140,277,C
2011,22,41,215,32,66,0,0,32,66,17,23,19,24,43,7,4,10,19,47,81,C
2011,33,56,618,43,100,42,87,1,13,17,18,10,49,59,40,24,7,17,82,145,SF
2011,26,27,336,46,110,17,38,29,72,18,27,13,35,48,11,12,5,16,33,127,SF
2011,26,25,331,45,107,17,37,28,70,18,27,12,35,47,11,11,5,16,33,125,SF
2011,26,2,5,1,3,0,1,1,2,0,0,1,0,1,0,1,0,0,0,2,SF
2011,24,12,50,4,12,0,0,4,12,2,2,2,6,8,4,1,1,0,5,10,PF
2011,24,7,39,4,9,0,0,4,9,2,2,2,6,8,2,1,1,0,5,10,PF
2011,24,5,11,0,3,0,0,0,3,0,0,0,0,0,2,0,0,0,0,0,PF
2011,30,54,582,89,199,17,46,72,153,40,52,12,56,68,23,17,6,23,43,235,SG
2011,35,33,463,45,106,12,40,33,66,8,8,7,44,51,69,27,6,39,49,110,PG
2011,35,14,153,10,30,4,12,6,18,2,2,0,12,12,26,9,1,14,19,26,PG
2011,35,19,310,35,76,8,28,27,48,6,6,7,32,39,43,18,5,25,30,84,PG
2011,34,73,2051,389,891,116,321,273,570,128,173,54,221,275,146,67,20,90,193,1022,SG
2011,34,22,664,125,266,27,78,98,188,56,75,11,79,90,64,20,3,36,70,333,SG
2011,34,51,1387,264,625,89,243,175,382,72,98,43,142,185,82,47,17,54,123,689,SG
2011,22,71,1702,225,546,92,247,133,299,68,101,74,233,307,74,54,13,68,115,610,SF
2011,24,70,1579,155,388,83,231,72,157,54,62,12,134,146,177,76,7,91,158,447,PG
2011,28,74,2059,266,407,0,0,266,407,216,295,206,486,692,32,36,80,88,240,748,C
2011,23,72,2401,429,953,112,320,317,633,130,161,75,333,408,120,48,94,104,199,1100,SF
2011,23,51,1759,328,712,86,245,242,467,96,119,62,241,303,86,34,70,67,152,838,SF
2011,23,21,642,101,241,26,75,75,166,34,42,13,92,105,34,14,24,37,47,262,SF
2011,27,54,894,121,214,1,16,120,198,29,59,69,86,155,42,33,23,44,68,272,SG
2011,23,42,464,68,158,0,5,68,153,27,47,37,64,101,9,8,18,28,45,163,SF
2011,23,9,72,12,31,0,0,12,31,5,10,4,13,17,4,1,3,2,6,29,SF
2011,23,33,392,56,127,0,5,56,122,22,37,33,51,84,5,7,15,26,39,134,SF
2011,32,28,181,6,21,0,0,6,21,7,10,14,10,24,2,4,1,7,29,19,C
2011,32,23,157,5,15,0,0,5,15,7,10,7,10,17,1,4,1,5,24,17,C
2011,32,5,24,1,6,0,0,1,6,0,0,7,0,7,1,0,0,2,5,2,C
2011,32,49,593,34,71,1,1,33,70,27,41,30,72,102,22,9,9,26,97,96,C
2011,23,20,66,7,25,2,10,5,15,1,1,0,5,5,8,2,0,4,2,17,PG
2011,23,79,2360,398,870,41,124,357,746,202,232,40,185,225,403,87,14,194,109,1039,PG
2011,30,71,1524,137,242,0,0,137,242,55,73,119,197,316,69,42,31,55,210,329,C
2011,23,81,2872,423,953,80,217,343,736,181,247,32,215,247,528,144,18,176,182,1107,PG
2011,30,40,447,72,170,34,79,38,91,15,24,19,77,96,15,12,11,25,75,193,PF
2011,23,43,598,79,181,65,154,14,27,16,20,8,64,72,20,14,1,17,51,239,SG
2011,24,4,18,2,3,0,0,2,3,0,0,0,3,3,0,0,1,1,1,4,C
2011,20,81,2309,432,1004,3,18,429,986,276,402,217,482,699,204,85,68,268,332,1143,C
2011,30,76,2297,368,874,119,349,249,525,222,260,22,108,130,241,57,14,145,97,1077,SG
2011,22,42,1027,192,500,33,128,159,372,73,84,31,74,105,117,39,3,83,63,490,SG
2011,22,16,160,27,77,9,27,18,50,4,6,9,19,28,15,3,0,15,13,67,SG
2011,22,26,867,165,423,24,101,141,322,69,78,22,55,77,102,36,3,68,50,423,SG
2011,23,78,1637,218,472,1,13,217,459,45,62,96,181,277,43,54,43,51,177,482,PF
2011,23,56,1108,126,291,0,4,126,287,32,45,73,116,189,30,39,32,33,139,284,PF
2011,23,22,529,92,181,1,9,91,172,13,17,23,65,88,13,15,11,18,38,198,PF
2011,22,74,2489,505,1053,151,342,354,711,212,227,52,234,286,432,109,20,226,233,1373,PG
2011,29,80,1938,268,567,0,2,268,565,108,148,212,445,657,67,36,116,132,225,644,C
2011,35,51,815,52,89,0,1,52,88,24,44,53,124,177,22,14,47,32,82,128,C
2011,35,4,35,2,5,0,2,2,3,2,2,0,5,5,2,0,0,1,0,6,PG
2011,30,49,938,114,232,4,21,110,211,39,57,24,89,113,64,39,22,38,63,271,SF
2011,31,58,1649,289,693,81,239,208,454,101,131,35,121,156,391,78,28,146,143,760,PG
2011,31,43,1269,214,515,45,152,169,363,79,104,29,91,120,299,62,22,107,114,552,PG
2011,31,15,380,75,178,36,87,39,91,22,27,6,30,36,92,16,6,39,29,208,PG
2011,21,65,1602,215,373,0,0,215,373,71,128,168,294,462,40,39,67,48,183,501,PF
2011,25,78,2298,359,801,2,15,357,786,195,265,101,324,425,92,78,30,85,231,915,C
2011,22,72,1446,193,471,69,172,124,299,82,108,64,210,274,78,39,39,59,165,537,SF
2011,28,49,1590,200,513,105,284,95,229,60,75,24,176,200,112,76,8,57,72,565,SF
2011,25,82,3208,531,1155,115,333,416,822,253,336,116,360,476,230,78,48,156,162,1430,SF
2011,21,82,2851,539,1154,5,52,534,1102,327,402,75,240,315,148,85,31,144,217,1410,SG
2011,28,82,2778,381,774,78,226,303,548,84,123,105,309,414,337,74,46,166,190,924,PF
2011,27,36,470,83,148,0,0,83,148,41,62,41,74,115,2,3,3,22,72,207,PF
2011,29,16,181,8,24,0,0,8,24,4,11,12,28,40,7,4,15,11,26,20,C
2011,30,80,1757,206,519,81,234,125,285,78,94,12,105,117,243,54,4,91,119,571,PG
2011,27,43,522,52,99,0,0,52,99,31,65,79,111,190,27,24,17,39,78,135,C
2011,24,81,1971,314,755,143,383,171,372,85,107,65,179,244,244,89,4,89,177,856,SG
2011,24,44,884,117,273,15,46,102,227,74,89,7,81,88,50,29,13,35,73,323,SF
2011,26,24,292,51,125,3,10,48,115,16,17,5,15,20,51,20,2,29,30,121,PG
2011,24,70,1234,192,441,56,155,136,286,83,133,36,106,142,204,50,10,117,125,523,PG
2011,24,48,856,133,316,28,101,105,215,59,97,24,62,86,149,36,6,96,90,353,PG
2011,24,22,378,59,125,28,54,31,71,24,36,12,44,56,55,14,4,21,35,170,PG
2011,25,82,2140,300,629,105,253,195,376,162,218,111,207,318,108,87,20,77,139,867,SF
2011,28,51,774,49,129,13,52,36,77,14,25,9,43,52,118,16,2,61,30,125,PG
2011,34,76,2156,419,838,0,4,419,834,184,257,169,509,678,203,50,146,122,119,1022,C
2011,30,61,1683,240,520,102,254,138,266,100,125,28,248,276,105,40,30,69,107,682,SG
2011,30,3,13,1,4,0,1,1,3,0,0,0,3,3,1,0,0,0,2,2,SF
2011,22,78,3038,711,1538,145,414,566,1124,594,675,57,476,533,214,88,76,218,159,2161,SF
2011,21,20,118,21,51,2,5,19,46,18,23,15,12,27,2,4,5,6,7,62,SG
2011,23,62,1181,160,397,48,121,112,276,42,53,26,82,108,72,28,3,53,85,410,SG
2011,25,80,3227,726,1611,137,379,589,1232,340,431,44,237,281,450,168,23,252,203,1929,SG
2011,34,62,610,54,113,0,0,54,113,26,31,35,80,115,33,21,14,32,84,134,C
2011,32,30,366,28,51,0,0,28,51,13,21,27,47,74,14,4,11,14,50,69,C
2011,24,41,595,62,111,0,0,62,111,39,60,37,81,118,20,15,24,34,104,163,C
2011,24,37,531,58,97,0,0,58,97,34,54,31,76,107,19,13,21,32,92,150,C
2011,24,4,64,4,14,0,0,4,14,5,6,6,5,11,1,2,3,2,12,13,C
2011,23,49,463,76,115,0,1,76,114,26,37,36,61,97,24,17,17,19,50,178,SF
2011,32,73,1549,177,424,55,167,122,257,52,58,52,104,156,45,34,14,33,129,461,SF
2011,32,47,837,79,201,28,89,51,112,24,28,23,61,84,30,16,5,15,74,210,SF
2011,32,26,712,98,223,27,78,71,145,28,30,29,43,72,15,18,9,18,55,251,SF
2011,30,30,798,42,103,0,1,42,102,48,88,119,226,345,38,29,6,39,89,132,PF
2011,21,57,2107,382,933,43,148,339,785,205,266,46,229,275,319,85,30,184,143,1012,SG
2011,26,7,19,0,5,0,2,0,3,3,4,1,1,2,2,0,1,1,1,3,SF
2011,21,44,947,130,306,25,91,105,215,18,28,27,96,123,35,34,28,47,78,303,SF
2011,24,73,1796,255,651,109,304,146,347,82,100,24,149,173,368,62,6,139,128,701,PG
2011,19,78,1535,215,416,0,0,215,416,103,173,171,241,412,39,29,68,77,246,533,PF
2011,19,56,1091,141,276,0,0,141,276,71,116,126,171,297,21,18,41,56,183,353,PF
2011,19,22,444,74,140,0,0,74,140,32,57,45,70,115,18,11,27,21,63,180,PF
2011,26,54,2074,339,801,88,268,251,533,157,181,40,154,194,488,97,11,176,113,923,PG
2011,26,21,663,88,204,28,61,60,143,37,60,8,67,75,137,28,0,45,37,241,SG
2011,25,78,1821,213,575,116,361,97,214,126,146,37,135,172,193,87,14,88,134,668,SG
2011,24,53,456,44,100,0,1,44,99,18,46,34,74,108,18,4,16,25,90,106,C
2011,22,82,2541,299,602,86,219,213,383,113,147,105,416,521,155,80,17,107,114,797,SG
2011,36,82,2297,206,529,63,159,143,370,83,103,14,138,152,224,99,8,70,192,558,PG
2011,21,53,983,108,296,31,100,77,196,32,42,12,65,77,182,34,3,113,58,279,PG
2011,25,63,791,124,273,19,58,105,215,59,87,28,88,116,49,23,6,46,77,326,SF
2011,27,41,773,91,236,6,32,85,204,35,48,17,64,81,141,35,8,63,69,223,PG
2011,34,56,940,80,167,0,3,80,164,27,48,160,190,350,46,24,31,26,127,187,C
2011,27,63,1551,206,531,71,217,135,314,133,149,13,90,103,170,47,21,95,122,616,SG
2011,27,77,2541,358,829,171,439,187,390,89,107,65,448,513,96,46,79,73,272,976,PF
2011,32,28,297,37,88,0,1,37,87,5,14,53,33,86,11,10,18,21,63,79,C
2011,32,14,166,17,41,0,0,17,41,5,13,18,31,49,3,3,11,8,28,39,PF
2011,24,24,301,42,105,9,38,33,67,18,36,13,25,38,42,16,1,27,25,111,PG
2011,24,8,65,7,22,2,6,5,16,5,10,1,5,6,6,3,0,6,4,21,PG
2011,24,6,90,15,35,3,15,12,20,2,6,2,6,8,11,4,1,8,10,35,PG
2011,24,10,146,20,48,4,17,16,31,11,20,10,14,24,25,9,0,13,11,55,PG
2011,22,48,1671,211,509,83,239,128,270,259,290,48,181,229,82,38,18,58,117,764,PF
2011,22,14,433,54,131,20,54,34,77,78,101,11,65,76,22,13,9,25,27,206,SF
2011,29,58,1386,207,475,81,224,126,251,65,76,24,109,133,71,51,49,45,126,560,SF
2011,34,71,2220,434,822,1,5,433,817,187,217,83,548,631,171,95,57,115,148,1056,PF
2011,26,81,2586,364,691,3,7,361,684,220,294,154,415,569,200,74,136,146,265,951,C
2011,30,82,3037,593,1120,1,3,592,1117,354,430,268,568,836,273,48,130,142,203,1541,C
2011,24,54,2152,409,869,57,144,352,725,194,241,82,254,336,153,91,58,135,131,1069,SF
2011,23,56,1118,121,264,17,51,104,213,72,92,62,120,182,38,40,18,55,94,331,SG
2011,23,5,18,1,3,0,0,1,3,0,0,2,1,3,0,0,2,3,3,2,SG
2011,23,11,127,12,27,0,2,12,25,8,12,11,11,22,5,7,0,8,10,32,SG
2011,23,40,973,108,234,17,49,91,185,64,80,49,108,157,33,33,16,44,81,297,SG
2011,20,61,1265,179,395,41,138,138,257,77,101,37,187,224,65,62,26,70,127,476,SG
2011,24,67,1865,264,660,118,293,146,367,134,163,24,153,177,201,48,21,80,154,780,SG
2011,25,80,1742,234,502,1,8,233,494,100,148,162,296,458,58,39,106,71,203,569,PF
2011,33,80,2426,441,1018,154,441,287,577,357,410,42,253,295,393,123,28,174,163,1393,SG
2011,28,76,2095,207,505,72,211,135,294,61,85,61,193,254,118,62,12,55,159,547,SF
2011,29,35,860,156,362,3,20,153,342,81,102,73,165,238,47,21,18,46,98,396,PF
2011,27,82,2131,339,770,107,266,232,504,136,160,41,154,195,171,48,16,141,178,921,SG
2011,22,56,2112,427,949,106,291,321,658,287,348,45,119,164,244,71,18,151,115,1247,SG
2011,26,80,2032,338,603,1,4,337,599,140,193,148,483,631,70,36,91,81,188,817,C
2011,26,25,396,44,81,0,0,44,81,12,18,38,80,118,17,7,21,17,52,100,C
2011,26,55,1636,294,522,1,4,293,518,128,175,110,403,513,53,29,70,64,136,717,C
2011,28,39,586,82,179,9,30,73,149,29,36,8,76,84,18,6,7,28,73,202,SF
2011,28,59,959,81,200,5,21,76,179,31,38,17,106,123,40,14,1,38,106,198,SG
2011,27,79,2763,535,1260,157,407,378,853,395,466,87,338,425,203,89,62,206,213,1622,SF
2011,26,41,531,56,99,0,0,56,99,17,34,59,112,171,16,11,12,32,96,129,C
2011,23,8,92,17,35,7,19,10,16,0,0,3,12,15,2,2,1,5,7,41,SG
2011,24,49,1815,270,618,56,184,214,434,148,181,57,217,274,89,40,21,76,142,744,PF
2011,24,26,612,98,202,8,27,90,175,50,63,16,70,86,19,13,16,23,68,254,SF
2011,29,77,1674,270,609,54,155,216,454,78,100,22,139,161,74,36,13,67,143,672,SG
2011,22,69,1127,156,386,45,154,111,232,43,65,49,98,147,48,36,20,60,88,400,SF
2011,28,3,5,1,2,0,0,1,2,1,2,0,0,0,1,1,0,0,0,3,SG
2011,21,82,3112,696,1376,7,24,689,1352,446,695,270,719,989,312,63,45,223,252,1845,PF
2011,25,31,168,30,58,0,1,30,57,15,23,24,44,68,5,2,13,11,29,75,C
2011,32,55,1498,288,671,55,144,233,527,146,172,24,102,126,171,39,4,88,95,777,SG
2011,25,70,1535,285,613,0,2,285,611,197,253,145,221,366,41,37,15,76,160,767,PF
2011,23,49,640,79,206,16,66,63,140,19,26,40,103,143,30,15,17,16,80,193,PF
2011,23,28,241,28,71,2,10,26,61,5,8,17,38,55,10,4,7,5,36,63,PF
2011,23,21,399,51,135,14,56,37,79,14,18,23,65,88,20,11,10,11,44,130,PF
2011,21,82,2189,298,684,113,324,185,360,289,343,42,213,255,176,92,24,106,207,998,SG
2011,30,73,1665,281,675,117,328,164,347,86,117,76,256,332,101,39,10,106,202,765,PF
2011,27,71,2254,343,813,58,180,285,633,335,402,17,152,169,503,70,7,207,163,1079,PG
2011,27,54,1724,260,612,33,110,227,502,258,307,11,118,129,411,57,5,158,130,811,PG
2011,27,17,530,83,201,25,70,58,131,77,95,6,34,40,92,13,2,49,33,268,PG
2011,21,54,933,108,289,34,92,74,197,71,93,36,104,140,85,31,7,63,65,321,SG
2011,27,4,16,3,6,0,0,3,6,2,4,2,3,5,1,0,1,1,2,8,PF
2011,30,13,345,44,86,0,0,44,86,16,20,29,77,106,6,7,3,14,39,104,PF
2011,22,81,1718,264,568,9,37,255,531,47,88,129,336,465,121,29,71,97,201,584,C
2011,27,74,2079,244,463,0,2,244,461,94,142,219,380,599,202,79,49,86,200,582,C
2011,20,72,1218,142,293,35,74,107,219,69,97,41,98,139,81,30,19,70,106,388,SF
2011,24,42,419,55,154,17,60,38,94,33,42,23,47,70,28,12,7,19,44,160,SF
2011,31,72,1331,128,223,0,1,128,222,64,177,129,247,376,19,16,74,51,146,320,C
2011,28,36,586,68,164,25,64,43,100,39,50,16,44,60,70,10,9,32,43,200,PG
2011,23,68,1661,259,570,7,36,252,534,128,163,49,158,207,101,50,32,64,118,653,SG
2011,19,38,527,65,160,2,17,63,143,33,52,9,28,37,18,11,3,13,48,165,SG
2011,24,81,2244,410,890,0,4,410,886,205,275,182,428,610,166,33,142,185,256,1025,C
2011,22,80,2256,429,936,0,5,429,931,247,367,217,478,695,91,48,54,173,215,1105,C
2011,28,75,2291,402,654,1,5,401,649,286,402,145,426,571,149,84,73,134,238,1091,C
2011,24,76,2148,287,633,77,204,210,429,233,270,24,175,199,193,66,21,99,153,884,PG
2011,38,80,2409,399,825,45,114,354,711,213,257,77,261,338,200,64,35,134,184,1056,SF
2011,23,72,1125,173,352,0,2,173,350,60,85,128,178,306,29,14,52,62,157,406,C
2011,30,48,1471,198,438,43,112,155,326,92,105,14,115,129,210,56,10,84,119,531,SG
2011,30,24,686,80,185,32,76,48,109,14,21,7,46,53,78,19,7,37,66,206,PG
2011,20,82,2901,446,999,81,222,365,777,172,209,68,264,332,531,120,29,218,203,1145,PG
2011,26,70,1182,131,219,0,0,131,219,111,163,70,116,186,26,22,42,67,199,373,C
2011,24,77,2704,513,921,2,4,511,917,150,188,182,536,718,266,59,80,119,193,1178,C
2011,32,56,978,128,321,68,175,60,146,38,40,9,83,92,62,32,3,29,68,362,SG
2011,25,78,2935,619,1044,0,7,619,1037,546,916,309,789,1098,107,107,186,279,258,1784,C
2011,30,18,409,58,162,7,29,51,133,29,47,18,56,74,24,13,5,20,34,152,SF
2011,37,57,592,55,125,0,0,55,125,29,35,36,86,122,23,10,4,25,61,139,PF
2011,26,11,73,6,24,4,15,2,9,2,4,1,4,5,17,4,1,7,10,18,PG
2011,25,74,2061,307,583,0,1,307,582,127,191,225,546,771,84,33,80,103,168,741,PF
2011,21,82,2216,335,617,0,1,335,616,138,184,214,408,622,22,31,198,71,267,808,PF
2011,27,67,2469,338,759,61,181,277,578,208,300,61,326,387,422,101,38,138,109,945,SF
2011,35,72,1145,162,319,0,1,162,318,36,46,108,179,287,26,23,58,52,185,360,C
2011,30,41,330,23,49,0,0,23,49,13,18,35,51,86,6,6,27,21,52,59,C
2011,23,60,1505,221,507,36,121,185,386,93,104,105,260,365,56,51,24,63,159,571,PF
2011,29,25,155,16,38,7,16,9,22,2,2,2,14,16,7,6,1,5,17,41,SG
2011,27,13,347,48,122,4,24,44,98,40,46,6,36,42,59,14,0,34,25,140,PG
2011,27,70,1375,212,515,29,84,183,431,142,168,14,117,131,183,40,6,76,77,595,SG
2011,25,59,486,77,158,3,11,74,147,30,49,49,45,94,14,12,3,23,61,187,PF
2011,32,67,2405,435,1059,121,359,314,700,249,305,53,251,304,241,80,28,209,161,1240,SG
2011,23,25,403,46,103,0,3,46,100,18,28,17,68,85,20,16,12,25,36,110,SF
2011,26,79,3063,758,1485,92,279,666,1206,503,663,80,510,590,554,124,50,284,163,2111,SF
2011,34,56,1842,374,876,91,263,283,613,171,234,86,289,375,93,50,30,77,137,1010,PF
2011,25,17,322,31,65,1,4,30,61,30,46,25,42,67,20,17,0,14,32,93,SG
2011,25,1,8,1,3,0,0,1,3,0,0,0,2,2,1,0,0,1,1,2,SG
2011,25,16,314,30,62,1,4,29,58,30,46,25,40,65,19,17,0,13,31,91,SG
2011,26,82,2940,654,1319,0,0,654,1319,220,289,235,559,794,149,46,153,105,238,1528,C
2011,30,81,2459,304,642,135,307,169,335,148,195,54,256,310,107,38,34,93,164,891,SF
2011,29,42,601,30,86,2,9,28,77,12,29,62,54,116,36,31,17,21,75,74,PF
2011,29,18,138,11,36,1,6,10,30,4,10,20,15,35,11,7,3,4,21,27,PF
2011,29,24,463,19,50,1,3,18,47,8,19,42,39,81,25,24,14,17,54,47,PF
2011,21,63,2169,361,926,98,303,263,623,199,246,42,192,234,305,95,21,146,131,1019,PG
2011,27,62,858,106,259,6,30,100,229,37,41,9,61,70,162,29,2,51,54,255,PG
2011,23,63,1112,145,347,3,13,142,334,62,91,79,169,248,25,27,32,51,115,355,PF
2011,23,72,1853,281,495,0,1,281,494,126,160,189,272,461,81,53,88,69,263,688,PF
2011,21,38,277,46,101,5,12,41,89,13,22,11,25,36,45,5,1,38,31,110,PG
2011,25,14,138,9,21,0,0,9,21,15,20,12,20,32,3,3,9,10,21,33,C
2011,25,10,106,7,18,0,0,7,18,13,18,11,16,27,2,3,6,8,18,27,C
2011,25,4,32,2,3,0,0,2,3,2,2,1,4,5,1,0,3,2,3,6,C
2011,23,38,822,108,237,8,34,100,203,47,71,37,105,142,89,33,37,64,95,271,SF
2011,23,13,123,17,41,2,9,15,32,6,13,6,18,24,14,8,9,18,25,42,SF
2011,23,25,699,91,196,6,25,85,171,41,58,31,87,118,75,25,28,46,70,229,SF
2011,29,72,2554,514,1161,89,300,425,861,195,243,59,232,291,338,47,7,146,131,1312,SG
2011,26,8,94,12,33,1,3,11,30,9,10,2,5,7,11,1,1,5,12,34,SG
2011,26,7,81,10,30,1,3,9,27,7,8,2,5,7,11,1,1,5,11,28,SG
2011,26,1,13,2,3,0,0,2,3,2,2,0,0,0,0,0,0,0,1,6,SG
2011,23,79,2069,271,682,103,289,168,393,64,92,51,189,240,148,58,54,95,163,709,SG
2011,30,45,589,100,214,14,39,86,175,69,90,4,61,65,33,20,7,31,70,283,SG
2011,22,18,135,14,45,0,4,14,41,14,17,6,19,25,19,5,3,10,7,42,SG
2011,30,81,1549,146,346,123,287,23,59,60,72,23,137,160,43,29,19,21,129,475,SF
2011,26,39,528,49,121,0,1,49,120,41,62,45,68,113,30,12,22,35,94,139,C
2011,22,80,2047,234,341,0,1,234,340,98,217,207,368,575,42,41,142,101,255,566,C
2011,28,32,838,177,376,0,0,177,376,43,57,51,174,225,46,16,48,58,75,397,C
2011,29,24,112,7,28,1,8,6,20,1,2,3,8,11,4,2,1,2,4,16,SF
2011,37,80,2653,215,596,133,391,82,205,67,77,35,316,351,655,134,29,179,119,630,PG
2011,29,64,1999,253,542,36,98,217,444,208,270,100,227,327,192,81,74,117,113,750,SF
2011,26,39,1032,178,406,39,131,139,275,41,65,37,140,177,40,19,7,65,99,436,SF
2011,29,82,1649,242,557,120,289,122,268,77,87,12,138,150,124,35,20,60,156,681,SG
2011,21,50,434,68,150,0,2,68,148,24,43,57,73,130,7,10,25,31,59,160,C
2011,21,39,336,47,108,0,2,47,106,12,24,42,55,97,7,8,20,25,50,106,C
2011,21,11,98,21,42,0,0,21,42,12,19,15,18,33,0,2,5,6,9,54,C
2011,27,71,1571,231,452,0,0,231,452,113,146,124,211,335,27,26,25,56,184,575,C
2011,27,47,1018,152,305,0,0,152,305,53,66,77,130,207,19,18,17,33,107,357,C
2011,27,24,553,79,147,0,0,79,147,60,80,47,81,128,8,8,8,23,77,218,C
2011,27,76,2008,345,687,0,4,345,683,213,288,165,182,347,63,40,32,109,196,903,PF
2011,27,53,1406,238,484,0,3,238,481,155,215,127,126,253,50,30,20,82,125,631,PF
2011,27,23,602,107,203,0,1,107,202,58,73,38,56,94,13,10,12,27,71,272,PF
2011,26,51,726,81,186,6,36,75,150,47,64,12,51,63,84,32,0,43,61,215,PG
2011,26,11,94,3,19,0,6,3,13,6,10,3,8,11,14,4,0,10,10,12,PG
2011,26,40,632,78,167,6,30,72,137,41,54,9,43,52,70,28,0,33,51,203,PG
2011,23,80,2103,346,688,69,171,277,517,172,225,67,142,209,377,80,4,137,133,933,PG
2011,25,81,1723,253,576,71,174,182,402,95,120,51,158,209,100,58,18,68,102,672,SG
2011,27,73,2634,496,978,1,3,495,975,210,267,217,497,714,233,74,31,170,211,1203,PF
2011,31,25,810,113,270,44,120,69,150,34,45,23,83,106,29,22,10,35,63,304,PF
2011,31,32,1014,139,312,43,124,96,188,43,51,48,136,184,63,30,20,52,96,364,SF
2011,22,29,285,28,72,1,5,27,67,19,25,12,22,34,42,33,9,18,31,76,PG
2011,25,73,1261,185,397,1,4,184,393,108,125,29,120,149,164,47,29,88,109,479,PG
2011,22,82,2889,644,1309,0,1,644,1308,385,489,197,291,488,129,47,120,176,240,1673,C
2011,22,67,991,179,357,0,0,179,357,74,100,82,134,216,8,18,45,48,143,432,C
2011,22,73,2611,482,1026,88,211,394,815,424,499,330,782,1112,184,45,28,155,148,1476,PF
2011,24,75,2563,345,809,129,343,216,466,192,251,89,220,309,500,102,23,158,207,1011,PG
2011,28,2,10,1,3,0,1,1,2,0,2,0,0,0,1,0,0,0,0,2,PG
2011,31,67,1401,253,559,28,78,225,481,271,325,44,197,241,84,21,5,127,175,805,SF
2011,32,18,158,13,22,0,0,13,22,9,18,17,44,61,3,4,2,5,26,35,C
2011,24,56,488,55,98,0,2,55,96,63,82,43,77,120,8,14,15,25,105,173,C
2011,32,80,2253,434,834,5,33,429,801,126,164,168,383,551,110,68,50,130,144,999,SF
2011,35,29,208,19,44,2,2,17,42,5,8,16,24,40,4,3,5,11,44,45,C
2011,26,52,542,71,182,39,99,32,83,28,40,20,54,74,18,18,6,16,52,209,SF
2011,33,48,1233,185,362,2,9,183,353,42,72,67,230,297,109,43,35,59,136,414,PF
2011,27,80,2603,553,1267,176,459,377,808,594,669,28,230,258,198,80,15,184,155,1876,SG
2011,30,26,319,26,77,16,44,10,33,7,10,5,38,43,20,6,2,6,25,75,SG
2011,24,82,2758,440,979,154,378,286,601,266,315,48,210,258,164,102,9,138,195,1300,SG
2011,27,57,930,93,189,0,0,93,189,51,99,66,107,173,17,24,21,44,92,237,PF
2011,23,82,1200,134,333,37,96,97,237,43,59,25,96,121,238,35,6,77,96,348,PG
2011,23,71,1869,304,747,96,264,208,483,99,131,35,135,170,145,73,26,99,127,803,SG
2011,24,79,2093,198,428,0,7,198,421,133,188,169,251,420,68,72,28,77,180,529,PF
2011,36,73,1387,169,344,0,1,169,343,52,77,122,273,395,84,36,39,72,163,390,PF
2011,23,79,2193,332,604,0,3,332,601,134,230,223,411,634,38,41,193,102,232,798,C
2011,31,72,1686,227,514,30,88,197,426,90,129,49,202,251,252,66,34,102,101,574,SG
2011,25,52,760,72,182,0,2,72,180,30,39,63,136,199,43,10,33,25,94,174,SF
2011,23,72,1597,211,386,23,60,188,326,88,119,109,273,382,150,47,57,93,165,533,PF
2011,23,74,2062,242,570,138,348,104,222,152,170,21,150,171,78,63,4,60,97,774,SG
2011,27,7,35,1,3,0,0,1,3,0,0,3,8,11,2,0,0,2,11,2,PF
2011,23,78,1969,366,899,109,339,257,560,159,196,54,201,255,135,74,38,93,221,1000,SF
2011,25,69,1686,271,578,0,0,271,578,64,115,133,227,360,104,54,140,151,229,606,C
2011,34,81,2650,388,844,4,37,384,807,249,292,97,205,302,566,114,12,197,171,1029,PG
2011,34,60,1015,132,296,40,107,92,189,78,94,44,178,222,145,28,21,54,98,382,C
2011,30,41,838,81,202,43,118,38,84,23,34,38,146,184,51,20,2,41,88,228,SG
2011,22,64,783,135,328,47,133,88,195,36,47,19,32,51,109,27,1,62,63,353,PG
2011,25,76,2605,525,988,9,23,516,965,256,338,164,415,579,187,103,69,145,272,1315,PF
2011,30,5,91,18,37,0,0,18,37,15,16,7,20,27,4,0,8,7,13,51,C
2011,33,75,1280,234,448,0,1,234,447,67,112,140,228,368,23,30,56,70,184,535,C
2011,33,51,851,159,317,0,1,159,316,52,88,94,158,252,17,14,46,51,121,370,C
2011,33,24,429,75,131,0,0,75,131,15,24,46,70,116,6,16,10,19,63,165,C
2011,20,80,2222,303,550,0,1,303,549,145,233,248,353,601,105,93,45,81,196,751,C
2011,30,59,1042,101,248,38,123,63,125,15,17,23,142,165,52,28,33,22,65,255,SF
2011,30,40,764,76,189,27,95,49,94,10,11,14,104,118,45,25,27,17,39,189,SF
2011,30,19,278,25,59,11,28,14,31,5,6,9,38,47,7,3,6,5,26,66,SF
2011,25,58,1856,279,620,110,260,169,360,96,107,37,135,172,68,19,7,54,135,764,SG
2011,24,45,524,63,133,0,0,63,133,37,52,46,75,121,15,15,25,35,84,163,C
2011,24,34,458,52,112,0,0,52,112,31,44,41,63,104,15,14,23,32,76,135,C
2011,24,11,66,11,21,0,0,11,21,6,8,5,12,17,0,1,2,3,8,28,C
2011,21,13,85,9,28,0,0,9,28,7,14,6,18,24,0,2,3,8,11,25,PF
2011,30,35,466,42,114,5,33,37,81,20,30,22,91,113,23,15,3,20,47,109,PF
2011,30,18,288,26,76,4,23,22,53,9,17,11,64,75,17,7,2,13,28,65,PF
2011,30,17,178,16,38,1,10,15,28,11,13,11,27,38,6,8,1,7,19,44,PF
2011,24,16,80,4,5,0,0,4,5,6,12,2,5,7,0,2,5,3,18,14,C
2011,34,31,372,26,72,11,34,15,38,6,11,14,30,44,20,11,6,13,52,69,PF
2011,36,75,2497,399,811,81,205,318,606,227,249,40,220,260,855,48,4,265,87,1106,PG
2011,26,80,1685,285,632,129,308,156,324,84,104,21,175,196,96,27,4,78,148,783,SG
2011,28,76,2319,374,838,119,297,255,541,130,162,37,189,226,456,75,3,194,209,997,PG
2011,25,48,1576,211,402,0,1,211,401,139,188,182,316,498,107,48,72,90,156,561,C
2011,31,54,931,118,277,42,118,76,159,49,61,19,150,169,45,14,15,47,100,327,SF
2011,27,30,215,35,67,26,46,9,21,8,8,4,24,28,3,1,5,4,14,104,SF
2011,27,7,18,4,8,3,4,1,4,0,0,0,5,5,0,0,0,0,3,11,SF
2011,27,23,197,31,59,23,42,8,17,8,8,4,19,23,3,1,5,4,11,93,SF
2011,32,73,2504,610,1179,66,168,544,1011,395,443,50,463,513,190,38,47,137,172,1681,PF
2011,32,24,431,50,109,0,1,50,108,29,43,25,63,88,12,2,30,27,65,129,C
2011,38,37,752,134,201,0,0,134,201,73,131,48,130,178,26,16,42,56,120,341,C
2011,35,5,45,3,5,0,0,3,5,1,2,3,4,7,0,0,0,3,10,7,C
2011,31,82,2639,473,893,68,178,405,715,166,246,175,535,710,249,47,61,139,200,1180,PF
2011,28,72,2287,300,524,0,1,300,523,145,258,230,454,684,42,40,127,119,230,745,C
2011,31,13,168,22,62,5,16,17,46,15,20,9,21,30,19,4,4,7,18,64,C
2011,26,82,2358,274,731,76,252,198,479,132,171,54,271,325,84,34,36,71,148,756,SF
2011,28,12,143,15,32,6,13,9,19,4,9,1,14,15,8,9,5,5,18,40,SF
2011,28,7,31,3,6,1,3,2,3,2,4,0,4,4,1,2,0,0,4,9,SF
2011,28,5,112,12,26,5,10,7,16,2,5,1,10,11,7,7,5,5,14,31,SF
2011,26,79,1244,107,232,0,0,107,232,135,179,119,214,333,58,34,22,69,184,349,C
2011,35,72,2091,220,552,86,227,134,325,74,95,33,185,218,218,67,10,80,109,600,SF
2011,28,78,2528,555,1069,25,70,530,999,233,303,30,208,238,513,90,3,200,135,1368,PG
2011,21,52,868,149,267,0,2,149,265,30,42,86,114,200,41,17,37,31,77,328,PF
2011,25,80,2880,430,928,71,183,359,745,337,384,38,289,327,782,188,5,177,196,1268,PG
2011,27,10,163,15,35,7,16,8,19,4,5,0,12,12,7,5,3,5,15,41,SF
2011,27,4,50,2,11,0,5,2,6,0,0,0,6,6,6,0,4,1,4,4,SG
2011,27,17,149,12,26,5,10,7,16,2,5,1,13,14,3,5,0,6,15,31,SG
2011,25,65,887,136,263,0,0,136,263,87,114,90,103,193,27,18,35,91,181,359,C
2011,26,29,742,67,130,0,0,67,130,40,72,62,170,232,26,9,26,56,91,174,C
2011,26,12,313,32,59,0,0,32,59,23,40,23,74,97,10,2,10,25,37,87,C
2011,26,17,429,35,71,0,0,35,71,17,32,39,96,135,16,7,16,31,54,87,C
2011,33,4,23,2,5,0,1,2,4,0,0,0,3,3,1,0,0,0,5,4,SG
2011,25,77,893,129,290,0,4,129,286,15,28,62,150,212,44,34,34,46,178,273,C
2011,33,80,2774,507,1021,111,297,396,724,386,449,34,396,430,260,80,51,171,231,1511,SF
2011,28,19,418,45,115,34,87,11,28,3,6,6,44,50,10,10,3,14,35,127,SF
2011,28,38,689,98,250,51,149,47,101,36,51,9,67,76,23,19,18,25,66,283,SG
2011,22,2,11,1,3,0,0,1,3,0,0,1,2,3,0,0,0,2,2,2,C
2011,22,66,734,73,180,18,50,55,130,24,34,23,65,88,28,17,10,16,63,188,SF
2011,34,49,839,81,241,67,212,14,29,11,15,10,137,147,34,24,6,24,103,240,SF
2011,27,14,187,29,59,0,0,29,59,12,26,16,22,38,2,7,3,5,20,70,PF
2011,27,16,141,30,60,0,2,30,58,28,46,8,17,25,5,3,1,7,24,88,C
2011,28,54,653,94,208,0,1,94,207,36,45,49,86,135,22,5,5,53,78,224,PF
2011,24,50,795,114,320,41,149,73,171,54,81,16,56,72,111,29,1,53,61,323,PG
2011,27,59,717,74,210,20,69,54,141,29,39,22,39,61,56,42,5,55,106,197,SG
2011,30,78,2562,473,1001,34,98,439,903,118,168,78,251,329,215,30,41,82,90,1098,SF
2011,31,36,519,25,44,0,0,25,44,14,27,37,108,145,13,5,15,29,79,64,C
2011,31,31,445,21,34,0,0,21,34,13,23,28,93,121,13,5,14,22,63,55,C
2011,31,5,74,4,10,0,0,4,10,1,4,9,15,24,0,0,1,7,16,9,C
2011,27,41,292,33,91,11,37,22,54,4,8,3,22,25,42,5,1,12,29,81,PG
2011,30,74,1169,137,318,70,173,67,145,30,34,64,148,212,79,44,44,57,157,374,PF
2011,21,17,127,14,45,1,4,13,41,6,12,11,29,40,7,4,8,10,15,35,PF
2011,21,23,463,109,219,0,0,109,219,52,74,32,88,120,26,18,16,43,47,270,C
2011,29,75,2724,598,1188,8,43,590,1145,300,396,326,588,914,163,63,25,151,175,1504,PF
2011,37,10,71,1,6,0,0,1,6,0,2,6,7,13,3,2,5,3,7,2,C
2011,24,5,24,3,7,1,4,2,3,1,2,0,1,1,3,1,0,7,0,8,SG
2011,31,10,134,18,45,4,17,14,28,4,4,0,8,8,12,2,1,4,4,44,SG
2011,26,59,1513,197,447,87,219,110,228,112,128,6,107,113,102,29,3,53,80,593,SG
2011,30,80,2715,472,1056,189,479,283,577,116,159,67,264,331,147,93,13,95,162,1249,SG
2011,30,25,796,183,389,62,148,121,241,55,72,33,78,111,36,27,3,30,46,483,SG
2011,30,55,1919,289,667,127,331,162,336,61,87,34,186,220,111,66,10,65,116,766,SG
2011,30,57,955,87,255,42,146,45,109,33,44,39,139,178,38,25,5,33,74,249,SF
2011,29,71,2159,319,681,81,184,238,497,121,137,37,162,199,384,89,10,158,146,840,PG
2011,26,59,1013,150,376,65,200,85,176,36,44,15,75,90,111,29,4,68,115,401,PG
2011,26,55,983,146,361,63,192,83,169,33,40,15,74,89,105,29,4,66,107,388,PG
2011,26,4,30,4,15,2,8,2,7,3,4,0,1,1,6,0,0,2,8,13,PG
2011,24,68,2527,318,670,10,43,308,627,75,132,87,210,297,760,153,11,234,120,721,PG
2011,22,81,3026,711,1597,128,385,583,1212,476,555,81,249,330,623,85,51,278,136,2026,PG
2011,29,36,353,26,59,0,3,26,56,5,14,10,20,30,10,3,6,7,40,57,SF
2011,26,47,1310,209,523,38,114,171,409,117,138,28,93,121,129,37,12,55,76,573,SG
2011,25,67,1754,217,515,93,223,124,292,80,106,33,184,217,62,41,35,69,107,607,SG
2011,31,73,2554,373,898,83,219,290,679,195,240,27,239,266,252,72,28,137,157,1024,SG
2011,22,37,701,110,241,0,3,110,238,68,110,75,83,158,17,15,18,53,88,288,PF
2011,22,60,872,116,268,0,0,116,268,28,50,59,119,178,16,22,72,38,117,260,C
2011,32,18,88,10,19,0,5,10,14,0,0,1,7,8,6,3,4,5,18,20,PF
2011,30,74,2412,569,1129,0,3,569,1126,214,290,147,459,606,185,48,44,147,227,1352,PF
2011,26,79,2049,157,333,28,102,129,231,59,79,65,281,346,111,97,38,55,171,401,SG
2011,21,58,635,66,147,0,0,66,147,22,31,80,72,152,10,17,28,42,126,154,PF
2011,24,81,2133,362,776,3,15,359,761,348,423,46,209,255,419,60,8,178,93,1075,PG
2011,26,22,159,21,59,1,10,20,49,8,15,7,15,22,25,5,3,18,15,51,PG
2011,24,21,101,17,31,0,0,17,31,11,22,16,12,28,3,1,4,10,20,45,C
2011,27,48,586,104,188,0,5,104,183,50,68,43,74,117,31,16,7,33,84,258,PF
2011,22,43,442,43,115,3,10,40,105,12,21,7,40,47,79,18,2,34,37,101,PG
2011,22,28,329,32,83,3,8,29,75,7,10,6,36,42,64,13,2,26,26,74,PG
2011,22,15,113,11,32,0,2,11,30,5,11,1,4,5,15,5,0,8,11,27,PG
2011,25,79,1968,341,784,124,318,217,466,163,221,45,277,322,175,92,16,100,173,969,SF
2011,24,77,1102,136,307,0,2,136,305,59,70,89,152,241,36,26,32,53,150,331,C
2011,35,16,69,3,16,0,0,3,16,2,2,3,18,21,4,0,4,5,13,8,PF
2011,35,4,25,1,4,0,0,1,4,0,0,1,2,3,1,0,0,2,3,2,PF
2011,35,12,44,2,12,0,0,2,12,2,2,2,16,18,3,0,4,3,10,6,PF
2011,25,77,2645,497,1041,51,154,446,887,229,316,134,523,657,255,99,120,197,217,1274,PF
2011,32,10,71,7,15,0,0,7,15,2,4,2,8,10,2,0,0,4,16,16,C
2011,23,64,734,144,291,1,4,143,287,55,73,64,146,210,30,8,19,40,120,344,C
2011,26,60,738,101,191,0,1,101,190,76,140,72,129,201,26,29,17,32,91,278,C
2011,36,7,50,3,12,1,4,2,8,5,7,1,6,7,3,0,2,2,3,12,SG
2011,20,12,115,13,39,0,5,13,34,11,14,1,17,18,21,4,0,16,14,37,SG
2011,29,72,1158,128,330,94,249,34,81,33,43,20,86,106,77,21,5,44,71,383,SG
2011,33,33,617,100,227,57,136,43,91,23,25,14,61,75,29,13,2,17,24,280,SF
2011,33,6,89,14,33,11,25,3,8,6,7,0,6,6,6,2,0,4,2,45,SF
2011,33,2,22,7,10,4,6,3,4,2,2,0,3,3,1,0,0,2,0,20,SF
2011,33,25,506,79,184,42,105,37,79,15,16,14,52,66,22,11,2,11,22,215,SF
2011,28,78,2870,744,1482,10,23,734,1459,473,597,198,438,636,202,71,150,250,274,1971,C
2011,24,70,2183,363,827,26,90,337,737,330,381,70,146,216,361,76,10,155,177,1082,PG
2011,23,22,199,28,69,9,21,19,48,9,20,2,10,12,2,3,1,13,21,74,SF
2011,22,3,21,2,6,0,1,2,5,3,3,2,1,3,2,1,0,3,1,7,SF
2011,24,34,483,94,196,14,45,80,151,21,28,26,36,62,32,14,5,46,39,223,SG
2011,24,8,77,16,32,2,5,14,27,5,6,1,8,9,2,2,2,6,4,39,SG
2011,24,26,406,78,164,12,40,66,124,16,22,25,28,53,30,12,3,40,35,184,SG
2011,22,70,963,133,304,18,48,115,256,77,97,11,91,102,138,45,25,64,82,361,PG
2011,25,37,711,97,241,28,78,69,163,44,60,17,37,54,111,25,3,64,64,266,PG
2011,24,3,21,1,5,0,1,1,4,0,2,1,1,2,2,1,1,1,2,2,SG
2011,24,9,83,7,21,3,10,4,11,0,4,0,6,6,6,1,1,2,8,17,SG
2011,24,12,126,12,42,7,26,5,16,7,11,0,15,15,24,9,4,20,14,38,PG
2011,33,82,2564,492,1091,127,351,365,740,182,214,24,129,153,334,93,13,167,140,1293,SG
2011,23,47,373,17,40,0,0,17,40,19,35,24,51,75,4,9,16,17,76,53,C
2011,23,45,369,17,39,0,0,17,39,19,35,24,51,75,4,9,15,17,73,53,C
2011,23,2,4,0,1,0,0,0,1,0,0,0,0,0,0,0,1,0,3,0,C
2011,32,13,82,10,21,0,0,10,21,12,15,6,17,23,2,1,4,5,11,32,C
2011,38,52,1178,95,186,1,1,94,185,20,32,75,226,301,60,32,42,42,164,211,PF
2011,24,41,861,156,331,0,3,156,328,107,136,65,159,224,29,30,66,65,113,419,C
2011,24,75,1748,271,534,0,3,271,531,121,200,144,310,454,88,28,44,99,212,663,PF
2011,27,49,1069,154,327,4,25,150,302,81,107,46,110,156,51,28,9,44,103,393,SF
2011,27,22,314,51,104,0,1,51,103,29,35,10,47,57,11,7,3,20,40,131,PF
2011,23,73,1775,350,807,88,240,262,567,145,184,61,197,258,135,64,9,93,110,933,SG
2011,23,46,745,137,334,35,93,102,241,50,66,25,106,131,43,19,4,37,50,359,SG
2011,23,27,1030,213,473,53,147,160,326,95,118,36,91,127,92,45,5,56,60,574,SG
2011,25,65,1362,141,313,47,115,94,198,105,131,92,203,295,82,28,28,49,145,434,SF
2011,28,64,1141,103,163,0,0,103,163,61,98,64,143,207,92,35,73,41,160,267,C
2011,31,25,630,85,193,41,97,44,96,26,36,20,80,100,58,18,14,31,77,237,PF
2011,31,56,1910,237,529,86,213,151,316,80,120,25,231,256,285,54,20,101,170,640,SF
2011,22,78,1797,225,529,14,44,211,485,101,125,42,264,306,159,49,14,80,138,565,SG
2011,23,58,1030,97,222,0,0,97,222,42,64,80,101,181,40,22,86,48,144,236,C
2011,33,20,130,5,21,0,8,5,13,4,8,5,14,19,13,8,1,5,14,14,SF
2011,28,79,2734,412,824,65,182,347,642,197,228,41,224,265,386,94,9,141,181,1086,PG
2011,22,42,438,61,144,3,8,58,136,33,56,30,31,61,69,13,8,25,29,158,PG
2011,28,31,994,114,216,0,2,114,214,54,81,98,203,301,45,27,38,40,87,282,C
2011,24,70,860,95,233,25,86,70,147,34,44,12,61,73,151,22,4,70,83,249,SG
2011,26,76,1666,313,708,125,323,188,385,89,116,50,245,295,48,42,42,66,175,840,PF
2011,26,67,1648,239,595,97,262,142,333,81,96,30,156,186,132,54,5,66,136,656,SG
2011,26,11,54,8,23,3,7,5,16,1,2,1,3,4,5,1,0,5,7,20,SG
2011,26,56,1594,231,572,94,255,137,317,80,94,29,153,182,127,53,5,61,129,636,SG
2011,29,76,2823,692,1384,63,206,629,1178,494,652,123,362,485,346,111,87,237,197,1941,SG
2011,25,58,553,67,159,18,67,49,92,32,38,7,42,49,35,18,5,20,39,184,SG
2011,23,61,784,104,236,59,153,45,83,31,44,16,106,122,34,21,6,37,81,298,SG
2011,20,69,2606,398,972,34,115,364,857,301,393,35,282,317,574,121,35,261,175,1131,PG
2011,36,54,1238,67,149,1,2,66,147,19,57,129,221,350,72,54,54,44,81,154,C
2011,28,48,1872,252,582,35,106,217,476,210,284,72,322,394,116,59,48,100,120,749,SF
2011,28,23,821,134,269,27,80,107,189,69,90,39,136,175,57,46,15,52,63,364,PF
2011,30,54,484,38,116,8,34,30,82,7,10,9,58,67,62,9,4,31,38,91,SF
2011,21,19,134,13,35,5,15,8,20,6,8,1,11,12,27,6,0,8,16,37,PG
2011,28,80,1416,228,446,1,11,227,435,212,294,88,208,296,69,32,9,79,100,669,PF
2011,26,82,1091,146,394,44,112,102,282,69,93,16,78,94,186,55,11,73,82,405,PG
2011,31,80,1567,126,307,36,107,90,200,55,82,52,130,182,278,61,17,116,146,343,PG
2011,24,5,69,9,25,3,7,6,18,7,8,2,8,10,7,2,2,7,3,28,SG
2011,24,46,1094,152,340,55,132,97,208,94,122,36,111,147,53,28,9,58,101,453,SF
2011,24,59,1413,228,513,17,61,211,452,72,94,39,114,153,104,34,2,86,87,545,SF
2011,30,70,2451,528,1040,2,9,526,1031,264,327,155,374,529,164,67,62,142,202,1322,PF
2011,27,24,453,55,120,12,33,43,87,13,15,6,31,37,64,20,10,30,29,135,PG
2011,26,6,116,9,21,1,4,8,17,3,5,2,9,11,10,7,0,2,13,22,SG
2011,22,82,2847,614,1390,34,103,580,1287,531,631,121,258,379,670,155,30,316,207,1793,PG
2011,24,23,219,30,65,0,0,30,65,5,10,12,40,52,4,6,8,7,31,65,PF
2011,24,24,466,81,154,0,2,81,152,41,54,31,75,106,15,6,12,7,46,203,C
2011,28,57,995,187,322,0,1,187,321,50,89,95,176,271,43,29,17,43,145,424,PF
2011,31,52,676,69,137,2,10,67,127,40,56,23,67,90,41,27,9,21,72,180,SF
2011,26,65,2465,428,975,105,317,323,658,348,412,40,220,260,667,79,15,230,190,1309,PG
2011,26,53,2009,369,806,89,258,280,548,302,354,32,173,205,514,64,12,187,152,1129,PG
2011,26,12,456,59,169,16,59,43,110,46,58,8,47,55,153,15,3,43,38,180,PG
2011,35,27,295,22,67,10,38,12,29,0,0,3,27,30,52,11,1,18,8,54,PG
2011,35,16,171,13,38,7,23,6,15,0,0,3,19,22,24,8,0,11,6,33,PG
2011,35,11,124,9,29,3,15,6,14,0,0,0,8,8,28,3,1,7,2,21,PG
2011,27,26,391,41,126,13,45,28,81,9,12,7,41,48,22,9,3,16,34,104,SF
2011,24,75,1747,323,795,88,253,235,542,293,356,32,117,149,252,47,17,102,128,1027,SG
2011,24,65,1865,246,537,37,110,209,427,147,174,68,245,313,88,34,23,62,104,676,SF
2011,28,58,1788,291,730,79,244,212,486,151,177,21,132,153,380,53,10,171,150,812,PG
2011,28,36,1065,178,462,36,136,142,326,85,102,15,82,97,257,33,10,105,91,477,PG
2011,28,22,723,113,268,43,108,70,160,66,75,6,50,56,123,20,0,66,59,335,PG
2011,24,80,1626,268,572,102,241,166,331,100,134,45,171,216,121,28,3,57,124,738,SF
2011,24,64,1323,164,385,85,212,79,173,41,49,60,179,239,47,39,51,46,164,454,PF
2011,27,59,911,103,220,0,0,103,220,58,75,93,180,273,32,23,26,43,126,264,PF
2011,27,42,713,82,181,0,0,82,181,34,46,74,149,223,19,18,22,37,92,198,PF
2011,27,17,198,21,39,0,0,21,39,24,29,19,31,50,13,5,4,6,34,66,PF
2011,23,21,290,43,115,6,22,37,93,14,21,4,47,51,38,9,0,33,25,106,SG
2011,23,10,206,29,73,4,12,25,61,5,10,3,33,36,31,5,0,25,21,67,SG
2011,23,11,84,14,42,2,10,12,32,9,11,1,14,15,7,4,0,8,4,39,SG
2011,31,82,2410,261,658,83,233,178,425,92,136,100,167,267,175,124,36,90,181,697,SF
2011,26,7,31,1,8,0,4,1,4,0,0,2,1,3,0,1,0,1,3,2,SG
2011,23,37,379,60,117,0,0,60,117,21,31,31,58,89,12,11,17,14,34,141,PF
2011,23,21,195,38,63,0,0,38,63,7,14,14,27,41,5,3,10,10,19,83,PF
2011,23,16,184,22,54,0,0,22,54,14,17,17,31,48,7,8,7,4,15,58,PF
2011,25,82,3147,485,1146,194,516,291,630,180,228,88,343,431,242,124,63,133,171,1344,SF
2011,23,52,766,82,160,2,10,80,150,22,43,47,71,118,58,39,20,43,45,188,SF
2011,25,64,2034,412,935,105,271,307,664,186,228,26,148,174,75,45,17,90,144,1115,SG
2011,25,78,1577,233,494,17,50,216,444,89,116,40,147,187,71,68,23,61,120,572,SF
2011,22,82,2135,458,847,6,22,452,825,123,174,153,281,434,82,90,26,99,170,1045,PF
2012,25,8,63,7,16,0,0,7,16,7,12,5,17,22,1,0,2,2,13,21,PF
2012,26,62,2086,329,699,88,221,241,478,197,247,40,157,197,149,36,13,85,134,943,SG
2012,27,4,30,4,14,2,9,2,5,0,0,0,2,2,1,0,0,5,4,10,PG
2012,23,14,122,13,36,0,0,13,36,7,8,15,32,47,3,2,9,5,11,33,C
2012,23,26,173,22,42,0,0,22,42,13,14,13,35,48,3,8,16,9,22,57,C
2012,26,55,1994,483,943,2,11,481,932,223,274,150,292,442,134,51,45,111,153,1191,PF
2012,22,41,624,79,167,0,0,79,167,11,14,47,124,171,34,13,18,20,73,169,PF
2012,36,46,1565,226,493,106,234,120,259,97,106,14,128,142,109,49,8,68,83,655,SG
2012,30,58,1525,210,448,8,26,202,422,140,175,98,135,233,79,104,33,94,142,568,SG
2012,26,4,67,6,17,1,3,5,14,1,3,1,7,8,2,7,0,1,6,14,SG
2012,21,66,1477,150,365,13,47,137,318,86,114,95,213,308,66,59,34,91,136,399,SF
2012,29,60,753,89,207,0,0,89,207,35,82,94,128,222,14,27,44,45,125,213,PF
2012,33,32,486,59,108,0,0,59,108,50,82,48,100,148,6,19,46,17,52,168,C
2012,29,17,461,55,142,24,61,31,81,29,34,8,26,34,26,5,3,25,35,163,SF
2012,22,51,603,66,174,19,68,47,106,39,52,16,63,79,41,8,2,30,35,190,SG
2012,23,61,1964,332,757,166,422,166,335,150,171,224,247,471,54,50,26,57,146,980,PF
2012,27,55,1876,441,1025,68,203,373,822,295,367,88,256,344,200,62,24,144,156,1245,SF
2012,29,64,1349,85,152,0,0,85,152,49,71,100,150,250,9,36,84,45,126,219,C
2012,30,17,211,26,64,13,39,13,25,7,10,2,16,18,18,11,1,12,35,72,PG
2012,26,41,1350,168,403,29,87,139,316,79,102,41,174,215,135,69,25,76,73,444,SF
2012,25,66,971,79,156,0,0,79,156,47,103,127,223,350,32,30,68,68,121,205,C
2012,24,48,1408,183,487,61,179,122,308,105,120,24,85,109,307,36,1,110,65,532,PG
2012,26,54,1088,140,261,0,1,140,260,39,63,86,179,265,74,53,46,46,118,319,PF
2012,24,20,106,15,36,0,0,15,36,4,7,12,21,33,4,3,2,2,16,34,C
2012,28,3,18,3,8,1,3,2,5,0,0,0,0,0,0,1,0,4,1,7,SG
2012,22,40,537,71,173,43,100,28,73,17,20,16,79,95,16,10,4,27,46,202,SF
2012,27,14,115,16,32,2,9,14,23,8,11,6,20,26,5,4,3,6,14,42,SF
2012,29,64,1382,271,637,65,170,206,467,101,124,33,95,128,96,56,7,94,135,708,SG
2012,29,42,946,198,454,40,111,158,343,76,91,21,58,79,63,36,7,68,101,512,SG
2012,29,22,436,73,183,25,59,48,124,25,33,12,37,49,33,20,0,26,34,196,SG
2012,27,41,1032,167,418,53,143,114,275,76,98,14,100,114,232,21,0,103,61,463,PG
2012,26,31,1032,209,484,34,115,175,369,151,173,24,148,172,61,18,15,69,52,603,C
2012,31,63,1440,175,387,46,138,129,249,95,128,97,247,344,126,35,48,73,152,491,SF
2012,30,2,9,2,4,0,0,2,4,0,0,1,0,1,0,0,0,0,5,4,C
2012,26,59,1868,303,632,0,0,303,632,132,163,95,270,365,55,34,54,65,135,738,PF
2012,35,27,295,19,51,0,1,19,50,4,4,8,59,67,16,4,6,4,26,42,C
2012,33,65,1499,113,292,62,183,51,109,23,37,56,100,156,82,64,33,37,105,311,SF
2012,23,59,1791,289,641,107,274,182,367,133,159,81,190,271,84,57,60,90,105,818,SF
2012,23,31,705,117,276,44,104,73,172,75,88,8,58,66,118,24,4,53,70,353,PG
2012,23,47,1087,221,497,38,101,183,396,61,95,39,168,207,45,18,19,80,83,541,SF
2012,23,53,1151,188,445,38,132,150,313,58,69,19,132,151,152,56,28,70,98,472,PG
2012,25,66,1966,286,686,107,284,179,402,101,129,19,153,172,101,48,5,69,115,780,SG
2012,35,34,796,81,174,34,87,47,87,21,25,6,43,49,38,13,2,21,78,217,SG
2012,23,3,9,0,1,0,0,0,1,0,0,2,1,3,0,0,0,0,0,0,C
2012,33,39,557,35,124,27,85,8,39,6,8,5,54,59,80,21,3,20,45,103,PG
2012,25,47,739,39,64,0,0,39,64,1,9,45,131,176,16,23,45,14,125,79,C
2012,35,20,607,83,228,48,125,35,103,85,95,4,46,50,80,9,3,38,40,299,SG
2012,19,63,1455,129,278,0,0,129,278,69,143,113,255,368,27,20,115,71,145,327,C
2012,22,64,1363,269,504,0,1,269,503,73,119,154,197,351,78,59,12,92,168,611,PF
2012,31,53,1237,101,268,53,158,48,110,21,27,9,76,85,175,39,2,72,75,276,PG
2012,25,26,626,93,245,2,7,91,238,33,49,42,108,150,28,20,17,37,54,221,PF
2012,22,40,464,49,126,6,30,43,96,28,44,22,43,65,66,31,14,47,58,132,PG
2012,31,5,94,8,21,3,12,5,9,2,5,5,6,11,3,2,0,3,15,21,SF
2012,27,12,364,61,136,0,1,61,135,14,23,22,78,100,31,12,24,24,36,136,C
2012,31,65,1326,154,350,105,250,49,100,16,21,29,185,214,61,15,21,14,68,429,PF
2012,24,50,1261,181,341,1,2,180,339,56,93,119,206,325,40,48,43,58,138,419,PF
2012,30,66,1948,448,842,0,1,448,841,95,137,114,450,564,125,63,24,115,168,991,PF
2012,27,57,2007,393,807,10,35,383,772,229,279,94,358,452,103,51,45,117,128,1025,PF
2012,35,8,111,12,36,2,9,10,27,13,15,0,11,11,17,1,0,7,5,39,PG
2012,24,14,88,9,33,3,9,6,24,1,2,5,10,15,8,0,1,4,6,22,PF
2012,21,64,1368,200,402,22,54,178,348,62,78,34,81,115,87,43,12,75,109,484,PG
2012,32,60,1732,287,581,0,1,287,580,85,116,145,284,429,97,58,97,65,176,659,C
2012,25,59,1287,201,463,33,127,168,336,90,130,43,107,150,88,72,17,56,113,525,SF
2012,26,66,1635,190,445,19,69,171,376,56,100,72,159,231,137,72,21,59,64,455,SG
2012,24,35,239,15,45,0,1,15,44,7,15,33,42,75,9,4,1,10,33,37,PF
2012,23,56,1648,274,640,47,150,227,490,113,148,70,130,200,131,52,15,118,116,708,SG
2012,24,65,1443,212,409,6,24,206,385,94,141,95,141,236,67,48,12,55,96,524,SF
2012,29,9,187,21,40,0,0,21,40,15,34,16,41,57,4,8,0,14,21,57,C
2012,26,59,1400,251,598,68,188,183,410,80,99,38,119,157,69,44,15,64,66,650,SG
2012,33,58,2232,574,1336,87,287,487,1049,381,451,66,247,313,264,69,18,204,105,1616,SG
2012,23,58,1298,208,471,88,219,120,252,54,70,38,179,217,74,29,7,55,65,558,SF
2012,20,59,939,153,357,15,45,138,312,104,143,57,75,132,55,27,5,51,84,425,SG
2012,31,63,1871,287,705,92,257,195,448,87,107,44,186,230,78,52,9,77,123,753,SF
2012,22,42,359,32,79,2,11,30,68,43,56,23,33,56,14,11,5,14,20,109,SG
2012,32,34,453,41,133,21,77,20,56,7,12,6,60,66,19,7,5,15,39,110,SF
2012,27,2,37,3,11,0,6,3,5,4,4,6,5,11,1,2,0,0,2,10,PF
2012,24,60,2112,444,796,1,5,443,791,234,338,192,517,709,85,27,116,152,104,1123,C
2012,29,36,514,74,194,7,29,67,165,49,64,10,46,56,66,23,3,54,61,204,PG
2012,30,53,1799,218,477,59,159,159,318,60,68,19,141,160,468,47,3,104,94,555,PG
2012,37,59,1352,128,287,2,5,126,282,29,64,157,373,530,107,50,85,57,126,287,C
2012,37,40,894,67,161,0,0,67,161,18,38,105,249,354,75,33,56,47,88,152,C
2012,37,19,458,61,126,2,5,59,121,11,26,52,124,176,32,17,29,10,38,135,C
2012,34,44,277,14,55,10,49,4,6,5,6,4,30,34,16,8,2,8,38,43,SF
2012,25,4,21,6,6,0,0,6,6,0,0,0,3,3,3,0,0,2,1,12,PF
2012,25,20,327,37,99,7,19,30,80,14,16,28,22,50,15,12,1,9,36,95,SF
2012,31,53,596,52,157,8,43,44,114,30,38,8,50,58,38,16,7,24,52,142,SG
2012,36,24,209,17,53,5,17,12,36,8,10,5,28,33,34,8,4,17,20,47,PG
2012,35,61,1542,223,542,74,205,149,337,95,115,32,173,205,139,56,25,84,134,615,SG
2012,23,65,1341,166,412,53,168,113,244,74,108,63,165,228,66,37,21,64,115,459,SF
2012,25,64,1825,223,498,101,260,122,238,80,101,16,155,171,222,97,11,142,166,627,PG
2012,29,62,2061,241,355,0,2,241,353,217,315,212,400,612,56,56,89,102,186,699,C
2012,24,8,215,31,79,3,12,28,67,10,12,6,35,41,17,6,6,18,18,75,SF
2012,28,34,491,48,99,4,24,44,75,0,2,31,64,95,34,14,6,9,38,100,SF
2012,24,45,559,51,139,0,0,51,139,21,29,35,89,124,18,12,32,25,72,123,PF
2012,23,65,1260,177,450,21,76,156,374,66,85,21,70,91,133,44,2,105,124,441,PG
2012,33,30,308,16,40,0,0,16,40,7,15,12,36,48,10,4,3,10,34,39,C
2012,24,60,1878,230,523,34,94,196,429,127,153,30,157,187,287,49,14,114,101,621,PG
2012,31,63,1307,120,201,0,1,120,200,44,62,119,155,274,82,33,28,61,153,284,PF
2012,24,62,2174,296,684,60,159,236,525,136,158,22,134,156,404,136,11,125,133,788,PG
2012,31,32,276,31,98,10,50,21,48,9,10,10,53,63,10,6,5,11,48,81,PF
2012,31,16,121,11,49,5,27,6,22,4,4,4,19,23,2,2,4,4,26,31,PF
2012,31,16,155,20,49,5,23,15,26,5,6,6,34,40,8,4,1,7,22,50,PF
2012,24,57,989,109,296,79,228,30,68,14,22,12,110,122,15,22,11,16,69,311,SG
2012,21,64,1950,448,999,2,14,446,985,262,373,265,438,703,102,93,75,170,257,1160,C
2012,31,60,1613,283,737,80,260,203,477,191,206,16,102,118,191,55,14,111,74,837,PG
2012,23,64,1753,349,872,79,273,270,599,161,203,44,124,168,190,59,5,141,111,938,SG
2012,24,64,1124,144,279,0,2,144,277,45,69,91,155,246,37,42,34,29,98,333,PF
2012,29,14,83,12,26,0,0,12,26,6,8,4,8,12,1,0,2,10,17,30,C
2012,23,26,732,145,296,55,121,90,175,38,47,15,73,88,138,39,8,65,62,383,PG
2012,30,65,1446,200,395,0,1,200,394,90,113,158,298,456,33,37,111,82,162,490,C
2012,36,15,83,1,8,0,0,1,8,0,0,10,15,25,4,1,4,3,9,2,C
2012,31,38,484,52,143,0,10,52,133,17,23,16,50,66,47,21,9,28,36,121,SG
2012,32,29,595,68,184,26,85,42,99,16,24,13,43,56,135,34,3,76,61,178,PG
2012,22,66,1534,172,335,0,1,172,334,71,106,134,304,438,60,40,63,67,156,415,PF
2012,26,61,1427,225,534,2,14,223,520,114,167,107,224,331,47,43,19,75,106,566,PF
2012,31,15,130,10,27,4,13,6,14,4,8,16,11,27,6,7,1,3,19,28,PF
2012,27,4,39,7,12,0,0,7,12,1,2,5,5,10,0,1,2,3,6,15,C
2012,23,41,603,73,227,13,62,60,165,35,43,14,77,91,33,22,21,40,62,194,SF
2012,29,54,1537,182,453,86,239,96,214,38,48,20,188,208,123,79,10,66,99,488,SF
2012,26,54,2129,311,755,79,215,232,540,127,165,77,273,350,157,56,36,96,81,828,SF
2012,26,6,91,10,28,2,14,8,14,4,6,0,8,8,10,2,0,7,10,26,PG
2012,26,2,19,2,6,0,4,2,2,0,0,0,1,1,1,1,0,1,2,4,PG
2012,26,4,72,8,22,2,10,6,12,4,6,0,7,7,9,1,0,6,8,22,PG
2012,22,63,2206,381,903,24,92,357,811,268,331,40,171,211,128,48,17,123,162,1054,SG
2012,29,57,1424,156,351,31,99,125,252,22,35,70,210,280,205,34,25,112,125,365,PF
2012,29,37,1018,116,283,23,86,93,197,17,27,47,148,195,158,20,19,84,71,272,PF
2012,29,20,406,40,68,8,13,32,55,5,8,23,62,85,47,14,6,28,54,93,PF
2012,28,2,14,0,2,0,0,0,2,2,2,0,1,1,0,0,0,1,1,2,PF
2012,30,27,325,15,42,0,0,15,42,1,6,33,52,85,23,6,13,19,36,31,C
2012,31,46,662,66,163,27,81,39,82,23,31,3,36,39,51,13,2,34,57,182,SG
2012,25,38,656,94,290,27,117,67,173,22,26,16,56,72,77,29,1,56,55,237,PG
2012,25,66,1752,277,600,68,202,209,398,153,190,53,115,168,351,85,10,157,166,775,PG
2012,26,65,2020,312,643,80,209,232,434,119,164,95,206,301,112,49,19,72,107,823,SG
2012,29,63,1226,85,203,50,119,35,84,17,21,14,88,102,151,35,9,81,71,237,PG
2012,35,58,1634,361,733,0,4,361,729,173,249,110,410,520,132,38,88,97,98,895,C
2012,31,55,1445,239,504,83,208,156,296,116,143,29,175,204,117,28,8,58,87,677,SF
2012,23,66,2546,643,1297,133,344,510,953,431,501,40,487,527,231,88,77,248,133,1850,SF
2012,24,9,180,19,48,1,8,18,40,28,36,2,17,19,18,11,2,20,19,67,PG
2012,22,24,396,37,89,0,9,37,80,23,35,26,28,54,12,11,6,18,26,97,SG
2012,24,51,973,122,302,35,108,87,194,32,40,14,85,99,33,26,10,26,56,311,SG
2012,26,58,2120,450,1040,62,201,388,839,219,275,20,180,200,346,85,18,177,136,1181,SG
2012,26,37,1365,305,704,50,156,255,548,151,186,16,111,127,223,56,12,123,84,811,SG
2012,26,21,755,145,336,12,45,133,291,68,89,4,69,73,123,29,6,54,52,370,SG
2012,35,5,16,1,3,0,0,1,3,0,0,0,1,1,1,1,1,1,0,2,C
2012,29,6,45,4,7,0,1,4,6,5,8,2,4,6,1,2,1,2,2,13,SF
2012,25,28,333,39,74,0,0,39,74,21,41,20,52,72,9,10,5,16,60,99,C
2012,24,29,217,27,42,0,1,27,41,8,16,19,31,50,13,6,24,5,23,62,SF
2012,33,24,343,45,112,17,45,28,67,10,13,8,16,24,9,14,0,10,36,117,SF
2012,31,56,771,34,72,0,0,34,72,36,71,100,171,271,17,31,6,44,118,104,PF
2012,22,63,2162,408,900,20,99,388,801,201,258,64,225,289,283,84,29,171,136,1037,SG
2012,22,7,102,6,25,1,3,5,22,4,8,4,10,14,5,3,5,3,7,17,SF
2012,22,6,83,3,19,1,2,2,17,2,6,3,9,12,4,3,4,2,7,9,SF
2012,22,1,19,3,6,0,1,3,5,2,2,1,1,2,1,0,1,1,0,8,SF
2012,22,46,1037,181,309,0,0,181,309,109,164,142,210,352,36,34,47,54,116,471,PF
2012,25,39,831,147,315,55,125,92,190,57,63,7,54,61,129,24,2,68,49,406,PG
2012,20,65,1376,222,445,0,0,222,445,126,194,158,267,425,43,38,65,103,145,570,PF
2012,27,60,1906,261,642,62,203,199,439,100,124,27,122,149,390,78,10,170,122,684,PG
2012,26,31,710,99,225,40,122,59,103,30,43,9,56,65,75,31,3,40,37,268,SG
2012,25,3,17,2,5,0,0,2,5,4,6,2,7,9,1,2,0,0,2,8,C
2012,23,66,1894,236,513,31,121,205,392,77,137,59,219,278,169,79,17,102,99,580,SG
2012,37,63,1508,129,348,35,109,94,239,57,67,12,109,121,170,51,4,73,117,350,PG
2012,37,43,1101,92,240,24,74,68,166,44,53,10,82,92,142,40,3,58,85,252,PG
2012,37,20,407,37,108,11,35,26,73,13,14,2,27,29,28,11,1,15,32,98,PG
2012,22,29,416,46,131,10,34,36,97,29,39,8,31,39,96,6,2,36,23,131,PG
2012,22,11,135,12,41,2,9,10,32,11,14,1,7,8,28,3,1,9,8,37,PG
2012,22,18,281,34,90,8,25,26,65,18,25,7,24,31,68,3,1,27,15,94,PG
2012,24,4,39,2,6,0,0,2,6,0,0,1,5,6,0,0,1,2,5,4,C
2012,26,48,713,112,271,29,83,83,188,66,91,27,75,102,54,24,4,54,56,319,SG
2012,28,14,191,19,43,2,8,17,35,11,14,3,15,18,45,9,2,23,23,51,PG
2012,23,10,95,11,32,3,13,8,19,10,15,6,9,15,10,3,0,10,5,35,PG
2012,23,4,46,5,12,1,4,4,8,6,9,4,4,8,5,0,0,5,3,17,PG
2012,23,6,49,6,20,2,9,4,11,4,6,2,5,7,5,3,0,5,2,18,PG
2012,35,11,141,9,18,1,1,8,17,6,9,18,24,42,4,8,1,7,26,25,C
2012,28,65,1682,256,644,127,329,129,315,73,85,25,113,138,146,46,24,73,130,712,SG
2012,22,61,1135,172,446,78,216,94,230,40,48,17,56,73,108,30,3,67,73,462,PG
2012,28,64,1669,255,613,91,263,164,350,73,82,71,308,379,88,42,70,63,176,674,PF
2012,33,2,13,0,2,0,0,0,2,0,2,1,4,5,0,1,1,1,4,0,C
2012,25,57,793,102,271,28,82,74,189,59,96,27,81,108,126,55,2,52,58,291,SG
2012,23,43,1351,193,466,60,183,133,283,182,209,28,174,202,116,42,23,68,86,628,SF
2012,30,49,798,86,229,38,131,48,98,24,30,11,88,99,31,36,37,22,73,234,SF
2012,35,60,1864,391,777,3,9,388,768,162,189,66,428,494,175,56,61,107,141,947,C
2012,27,65,2370,357,740,1,12,356,728,237,317,120,459,579,204,62,121,121,201,952,C
2012,31,65,2430,459,917,7,27,452,890,204,261,183,495,678,237,37,88,142,127,1129,PF
2012,25,65,2422,485,1067,54,173,431,894,208,263,130,287,417,147,95,55,161,138,1232,SF
2012,24,63,1827,227,551,44,137,183,414,167,212,101,221,322,113,83,17,114,149,665,SG
2012,21,66,1958,281,639,90,234,191,405,146,182,56,314,370,158,108,38,117,191,798,SG
2012,25,35,916,87,248,55,139,32,109,34,43,11,90,101,76,26,16,45,69,263,SG
2012,26,63,1284,200,404,0,0,200,404,84,135,135,197,332,47,27,81,60,131,484,PF
2012,34,34,792,150,285,52,126,98,159,88,101,18,98,116,151,24,12,64,56,440,SG
2012,25,26,252,25,59,0,0,25,59,6,12,14,44,58,5,4,20,7,32,56,PF
2012,25,8,28,1,3,0,0,1,3,0,0,1,10,11,2,1,1,3,8,2,PF
2012,25,18,224,24,56,0,0,24,56,6,12,13,34,47,3,3,19,4,24,54,PF
2012,29,32,425,31,95,4,29,27,66,8,11,14,47,61,12,16,0,15,34,74,SF
2012,30,56,1469,287,657,16,55,271,602,176,208,130,233,363,144,46,34,109,112,766,C
2012,28,52,1398,234,530,63,147,171,383,117,136,14,107,121,127,34,11,115,114,648,SG
2012,23,9,310,63,140,10,40,53,100,49,65,2,23,25,31,13,4,24,20,185,PG
2012,27,66,2114,427,769,0,2,427,767,163,251,185,474,659,59,48,99,90,142,1017,C
2012,23,40,419,68,174,28,75,40,99,11,12,5,26,31,20,4,0,21,32,175,SG
2012,28,62,2062,391,941,123,323,268,618,254,291,79,228,307,109,62,40,110,144,1159,SF
2012,27,49,813,83,161,0,0,83,161,25,47,83,198,281,27,22,17,51,127,191,C
2012,24,66,1522,211,477,102,234,109,243,79,100,54,174,228,86,58,46,67,107,603,SG
2012,26,31,781,154,320,43,110,111,210,49,65,15,93,108,34,28,17,55,80,400,SF
2012,30,53,922,153,325,50,113,103,212,48,56,15,65,80,40,23,6,33,74,404,SG
2012,23,53,777,108,266,25,105,83,161,44,55,19,114,133,34,18,29,32,67,285,PF
2012,22,66,2392,561,1022,2,16,559,1006,244,468,218,499,717,210,54,48,150,216,1368,PF
2012,26,35,206,26,48,0,1,26,47,18,26,28,43,71,8,1,26,21,43,70,C
2012,21,26,258,48,111,17,47,31,64,2,5,11,51,62,20,4,3,16,15,115,SF
2012,33,28,697,140,310,17,46,123,264,29,37,20,46,66,84,12,1,49,56,326,SG
2012,26,66,1442,194,479,0,1,194,478,226,278,113,177,290,30,54,9,65,159,614,PF
2012,24,21,231,23,65,5,21,18,44,9,12,20,33,53,6,6,3,4,17,60,PF
2012,22,62,1946,309,629,114,292,195,337,312,369,30,222,252,229,62,15,137,150,1044,SG
2012,22,14,84,9,31,2,13,7,18,0,1,3,9,12,2,2,3,6,5,20,PF
2012,22,37,540,63,149,20,59,43,90,16,26,47,97,144,11,23,20,20,48,162,PF
2012,31,64,1761,345,773,101,303,244,470,119,176,72,318,390,88,58,12,112,181,910,PF
2012,28,63,1741,241,542,77,213,164,329,156,209,12,100,112,316,64,13,122,136,715,PG
2012,22,26,456,60,150,12,36,48,114,41,59,11,59,70,31,13,6,27,28,173,SG
2012,24,22,318,29,83,8,39,21,44,14,21,18,33,51,26,9,2,25,34,80,SG
2012,19,42,479,79,169,6,23,73,146,44,54,30,71,101,22,13,7,31,45,208,SF
2012,31,64,1589,151,357,0,0,151,357,83,102,117,353,470,42,35,24,60,142,385,PF
2012,23,37,920,156,319,3,12,153,307,40,55,78,192,270,98,16,48,55,100,355,C
2012,28,54,1039,73,170,0,2,73,168,26,39,72,162,234,77,36,17,50,111,172,C
2012,21,66,2015,267,586,55,159,212,427,193,232,59,171,230,207,53,41,109,106,782,SF
2012,25,26,141,13,38,4,14,9,24,7,12,2,14,16,4,3,1,9,18,37,SF
2012,32,54,1146,118,228,0,0,118,228,45,96,139,185,324,19,24,54,46,121,281,C
2012,24,55,1831,332,723,11,47,321,676,155,204,64,161,225,126,49,20,100,128,830,SG
2012,20,45,759,90,228,7,17,83,211,52,85,24,82,106,35,26,8,35,59,239,SG
2012,25,65,1937,332,668,0,1,332,667,170,239,213,359,572,108,32,128,128,195,834,C
2012,23,54,1244,183,392,0,2,183,390,86,134,133,202,335,45,30,35,70,85,452,PF
2012,23,35,644,64,173,0,1,64,172,37,58,67,110,177,22,18,17,39,44,165,PF
2012,23,19,600,119,219,0,1,119,218,49,76,66,92,158,23,12,18,31,41,287,PF
2012,22,38,423,52,160,4,20,48,140,42,60,7,28,35,36,5,6,39,40,150,PG
2012,29,39,1110,211,393,0,4,211,389,113,168,63,228,291,80,42,38,96,95,535,C
2012,29,28,826,143,281,0,2,143,279,90,133,43,165,208,61,36,25,77,69,376,C
2012,29,11,284,68,112,0,2,68,110,23,35,20,63,83,19,6,13,19,26,159,C
2012,25,50,1274,168,380,54,147,114,233,91,117,31,120,151,145,42,17,52,98,481,PG
2012,39,49,1378,201,451,14,53,187,398,83,109,29,142,171,107,41,29,65,88,499,SF
2012,24,39,551,82,165,0,3,82,162,30,47,61,125,186,16,14,27,31,71,194,C
2012,24,32,469,68,135,0,3,68,132,25,39,47,108,155,14,9,21,24,60,161,C
2012,24,7,82,14,30,0,0,14,30,5,8,14,17,31,2,5,6,7,11,33,C
2012,31,48,1237,122,295,47,136,75,159,25,32,11,90,101,132,38,11,58,100,316,SG
2012,24,5,39,2,13,0,6,2,7,0,0,0,3,3,6,0,0,2,1,4,SG
2012,21,65,2196,360,834,65,171,295,663,94,120,57,155,212,290,103,18,135,137,879,PG
2012,27,39,522,46,84,0,0,46,84,39,75,34,48,82,9,5,17,35,78,131,C
2012,27,24,362,28,56,0,0,28,56,33,55,25,31,56,6,4,12,24,55,89,C
2012,27,15,160,18,28,0,0,18,28,6,20,9,17,26,3,1,5,11,23,42,C
2012,21,15,88,8,24,1,3,7,21,3,5,3,11,14,7,4,3,2,3,20,SF
2012,25,11,348,57,103,0,1,57,102,22,30,26,51,77,24,10,14,16,21,136,C
2012,23,8,22,1,4,0,1,1,3,3,4,2,3,5,0,0,0,1,1,5,PF
2012,26,54,2070,416,726,0,7,416,719,281,572,200,585,785,104,81,116,175,159,1113,C
2012,31,43,991,144,361,9,37,135,324,75,97,39,119,158,50,32,10,53,91,372,SF
2012,38,28,190,17,55,0,0,17,55,8,10,18,29,47,10,4,1,20,18,42,PF
2012,27,16,334,62,162,16,64,46,98,34,41,7,39,46,36,14,3,32,26,174,PG
2012,27,13,314,59,151,15,61,44,90,32,38,7,39,46,35,14,3,30,26,165,PG
2012,27,3,20,3,11,1,3,2,8,2,3,0,0,0,1,0,0,2,0,9,PG
2012,33,9,114,5,22,1,7,4,15,1,2,1,4,5,7,2,0,12,10,12,PG
2012,26,62,2162,323,671,0,0,323,671,209,278,233,448,681,90,50,74,119,173,855,PF
2012,22,66,1792,262,490,1,3,261,487,78,118,193,305,498,28,33,241,79,179,603,PF
2012,28,62,2209,287,632,76,193,211,439,121,196,56,325,381,339,107,30,115,92,771,SF
2012,24,60,1655,294,597,51,112,243,485,143,183,196,333,529,71,42,44,76,133,782,PF
2012,19,51,1558,350,747,73,183,277,564,171,196,44,147,191,275,54,20,160,110,944,PG
2012,30,34,354,26,73,18,53,8,20,1,8,1,23,24,10,14,0,9,36,71,SG
2012,28,45,1530,266,583,39,112,227,471,129,148,23,153,176,285,31,9,106,93,700,PG
2012,21,45,501,51,159,13,62,38,97,25,29,14,39,53,71,25,1,36,31,140,PG
2012,33,47,1212,159,425,49,170,110,255,94,114,22,141,163,118,54,13,103,99,461,SF
2012,33,26,712,97,272,30,108,67,164,50,60,16,66,82,77,26,6,66,61,274,SF
2012,33,21,500,62,153,19,62,43,91,44,54,6,75,81,41,28,7,37,38,187,SF
2012,24,7,170,13,35,0,1,13,34,8,12,7,26,33,3,7,7,12,17,34,SF
2012,27,62,2326,621,1169,54,149,567,1020,387,502,94,398,492,387,115,50,213,96,1683,SF
2012,36,11,120,20,49,6,10,14,39,7,8,2,8,10,29,4,2,14,20,53,PG
2012,35,65,2151,421,1044,91,267,330,777,185,271,123,285,408,131,51,43,90,164,1118,PF
2012,27,61,2075,516,1048,1,4,515,1044,137,177,133,452,585,134,47,101,62,155,1170,C
2012,31,63,1748,203,488,113,269,90,219,59,85,26,193,219,88,37,19,50,121,578,SF
2012,31,41,1168,132,319,80,190,52,129,35,50,18,125,143,55,25,12,32,83,379,SF
2012,31,22,580,71,169,33,79,38,90,24,35,8,68,76,33,12,7,18,38,199,SF
2012,30,39,729,59,144,3,16,56,128,49,72,69,83,152,26,29,25,29,89,170,PF
2012,22,51,893,130,291,3,20,127,271,34,39,8,60,68,170,33,6,60,85,297,PG
2012,22,66,2331,469,1121,129,388,340,733,193,239,49,177,226,365,104,22,146,114,1260,PG
2012,24,64,1468,212,453,32,106,180,347,100,124,96,212,308,43,41,21,66,162,556,PF
2012,24,30,203,31,82,3,10,28,72,14,21,12,37,49,5,7,8,14,23,79,PF
2012,24,64,1553,196,340,2,5,194,335,58,84,149,259,408,79,33,69,94,209,452,PF
2012,22,9,124,20,43,1,3,19,40,6,6,1,12,13,11,5,0,6,9,47,PG
2012,22,1,5,1,1,0,0,1,1,0,0,0,1,1,0,1,0,1,0,2,PG
2012,22,8,119,19,42,1,3,18,39,6,6,1,11,12,11,4,0,5,9,45,PG
2012,29,15,119,11,35,4,15,7,20,1,3,1,8,9,22,8,0,7,11,27,PG
2012,26,27,175,20,41,0,0,20,41,15,19,15,25,40,2,6,9,15,33,55,C
2012,26,20,93,11,23,0,0,11,23,10,12,8,10,18,1,1,8,7,20,32,C
2012,26,7,82,9,18,0,0,9,18,5,7,7,15,22,1,5,1,8,13,23,C
2012,27,56,934,141,275,2,6,139,269,72,100,65,161,226,32,43,18,69,116,356,PF
2012,22,36,298,54,121,0,0,54,121,6,9,20,38,58,6,5,14,14,25,114,PF
2012,24,62,1561,233,518,19,60,214,458,81,115,74,218,292,122,71,84,101,177,566,SF
2012,30,60,2127,423,931,125,322,298,609,158,186,53,168,221,232,48,13,116,75,1129,SG
2012,27,11,61,8,14,0,0,8,14,5,5,3,9,12,4,1,0,5,10,21,SG
2012,24,65,1469,158,397,53,169,105,228,24,34,24,153,177,59,35,48,60,115,393,SF
2012,31,65,1052,115,281,33,77,82,204,83,99,23,94,117,63,23,11,46,119,346,SF
2012,23,33,268,29,73,1,8,28,65,29,37,9,35,44,42,10,5,28,28,88,SG
2012,31,51,666,57,150,46,114,11,36,25,30,6,43,49,19,17,9,10,45,185,SG
2012,27,10,96,1,8,0,0,1,8,4,5,11,6,17,2,4,5,5,12,6,PF
2012,27,11,196,23,53,0,0,23,53,15,18,21,20,41,7,5,6,13,31,61,C
2012,23,66,1798,206,326,0,1,206,325,74,141,202,344,546,17,30,134,74,189,486,C
2012,25,21,108,17,33,0,0,17,33,8,10,14,13,27,4,1,6,2,15,42,C
2012,20,29,266,22,70,3,15,19,55,11,17,5,20,25,34,7,3,12,16,58,PG
2012,29,47,1372,266,597,0,0,266,597,84,107,89,275,364,101,25,77,129,106,616,C
2012,19,66,874,117,236,0,1,117,235,70,105,107,171,278,8,18,23,54,87,304,C
2012,30,27,269,21,55,8,27,13,28,4,4,2,12,14,11,3,0,6,21,54,SG
2012,22,2,59,5,12,2,4,3,8,0,2,1,6,7,3,2,0,3,7,12,SF
2012,38,48,1379,99,273,79,223,20,50,22,28,15,183,198,264,82,10,91,83,299,PG
2012,27,49,1057,165,410,62,179,103,231,81,100,42,157,199,46,23,4,64,119,473,SF
2012,20,66,2129,319,769,105,276,214,493,104,137,33,178,211,251,49,10,171,154,847,PG
2012,30,65,1469,178,412,118,271,60,141,55,66,26,133,159,112,36,15,53,110,529,SG
2012,22,48,792,115,192,0,0,115,192,33,55,95,163,258,15,24,41,33,96,263,C
2012,28,41,999,182,362,0,3,182,359,147,184,78,136,214,38,13,12,64,89,511,PF
2012,24,61,2124,374,767,73,200,301,567,178,216,54,173,227,401,82,6,149,94,999,PG
2012,26,58,1757,251,580,87,217,164,363,71,86,26,133,159,88,68,22,64,106,660,SG
2012,28,57,2121,464,922,0,5,464,917,219,280,171,374,545,162,54,22,149,179,1147,PF
2012,21,19,243,23,59,2,10,21,49,14,17,9,17,26,31,8,4,17,22,62,SG
2012,20,64,1534,199,404,41,109,158,295,68,88,104,223,327,70,85,24,44,88,507,SF
2012,21,10,45,5,14,0,0,5,14,4,9,6,3,9,5,2,2,2,4,14,SG
2012,22,46,555,97,191,3,9,94,182,21,28,45,75,120,25,14,17,18,67,218,PF
2012,32,28,729,85,221,16,67,69,154,31,37,34,75,109,27,23,10,32,49,217,SF
2012,23,17,115,12,25,0,4,12,21,9,19,6,9,15,5,6,0,10,6,33,SF
2012,23,35,940,171,383,24,75,147,308,146,183,18,89,107,216,55,9,126,78,512,PG
2012,26,58,1092,127,271,2,3,125,268,62,79,39,84,123,122,27,20,66,79,318,SG
2012,23,5,136,38,77,0,0,38,77,20,32,8,10,18,6,1,4,6,8,96,C
2012,23,64,895,124,269,0,0,124,269,100,140,90,119,209,20,18,60,43,128,348,C
2012,23,55,2145,474,1059,105,282,369,777,379,460,226,508,734,111,47,28,128,152,1432,PF
2012,25,47,1510,210,513,79,211,131,302,171,198,37,176,213,310,73,14,130,133,670,PG
2012,29,49,726,143,358,55,140,88,218,28,32,22,54,76,108,19,1,42,42,369,PG
2012,21,64,779,88,220,12,42,76,178,42,59,12,80,92,131,28,2,48,50,230,PG
2012,25,23,135,19,35,0,0,19,35,8,14,14,20,34,5,4,4,3,9,46,C
2012,32,32,881,139,373,24,66,115,307,178,208,21,104,125,39,23,1,59,83,480,SF
2012,33,34,374,17,45,0,0,17,45,7,27,25,88,113,6,4,10,22,66,41,C
2012,25,61,1139,130,238,0,1,130,237,94,147,108,181,289,12,38,31,50,176,354,C
2012,33,63,1919,288,646,20,68,268,578,74,93,145,320,465,132,67,36,98,87,670,SF
2012,27,17,391,59,134,29,75,30,59,11,19,12,46,58,10,11,2,13,35,158,SF
2012,34,42,940,97,220,3,13,94,207,20,54,49,132,181,18,44,43,32,103,217,PF
2012,28,40,1264,222,537,78,225,144,312,160,179,13,93,106,110,28,3,70,70,682,SG
2012,31,52,697,103,258,59,154,44,104,21,27,7,62,69,47,13,5,32,33,286,SG
2012,25,66,2228,314,763,129,337,185,426,147,171,56,168,224,113,96,15,73,148,904,SG
2012,28,65,1466,183,383,0,2,183,381,58,106,126,207,333,41,32,50,71,151,424,PF
2012,24,9,137,14,39,6,17,8,22,4,4,3,10,13,22,5,0,11,13,38,PG
2012,24,66,1771,300,736,100,275,200,461,133,172,30,180,210,169,71,23,124,137,833,SG
2012,25,43,1009,133,261,1,4,132,257,66,103,77,150,227,29,40,22,39,93,333,PF
2012,24,61,1535,307,552,0,0,307,552,77,167,163,314,477,31,35,132,87,166,691,C
2012,24,41,1124,214,400,0,0,214,400,58,116,127,235,362,25,25,101,68,118,486,C
2012,24,20,411,93,152,0,0,93,152,19,51,36,79,115,6,10,31,19,48,205,C
2012,32,52,837,101,231,15,33,86,198,56,83,23,131,154,110,16,15,53,35,273,SF
2012,26,64,1127,94,210,0,4,94,206,39,53,73,173,246,110,44,36,56,104,227,PF
2012,24,50,718,56,118,3,7,53,111,23,36,61,110,171,51,15,18,31,74,138,PF
2012,24,66,1644,191,467,97,266,94,201,77,85,17,144,161,54,40,3,29,82,556,SG
2012,24,56,1145,177,465,46,150,131,315,108,136,27,89,116,69,46,18,53,122,508,SG
2012,26,29,472,59,130,0,0,59,130,16,37,35,62,97,17,9,25,32,59,134,C
2012,35,66,1809,242,552,18,83,224,469,137,169,53,168,221,441,63,9,177,133,639,SG
2012,35,15,146,9,27,7,15,2,12,10,12,4,15,19,24,4,2,12,10,35,C
2012,31,39,752,91,209,53,117,38,92,2,5,22,106,128,42,14,6,30,58,237,SG
2012,23,16,261,63,130,24,56,39,74,15,15,4,24,28,39,10,1,26,14,165,PG
2012,26,64,2100,426,861,7,31,419,830,202,255,180,383,563,150,118,52,112,222,1061,PF
2012,34,63,692,79,169,0,1,79,168,13,23,59,111,170,14,20,37,26,101,171,C
2012,21,66,2082,407,781,0,1,407,780,201,272,239,398,637,152,83,46,161,180,1015,C
2012,31,8,123,7,24,2,10,5,14,2,2,2,20,22,5,1,5,8,5,18,SF
2012,22,38,331,43,113,17,45,26,68,7,7,4,29,33,34,11,3,21,33,110,PG
2012,36,7,118,9,20,0,0,9,20,6,7,7,15,22,5,3,3,7,24,24,C
2012,21,19,169,18,42,4,9,14,33,6,9,2,14,16,21,2,0,19,16,46,PG
2012,22,17,126,16,54,2,17,14,37,6,8,5,11,16,3,2,2,4,12,40,PF
2012,22,63,1227,174,436,43,124,131,312,76,106,69,210,279,65,41,42,70,179,467,PF
2012,26,62,1636,272,658,106,286,166,372,97,104,31,96,127,61,46,9,70,86,747,SG
2012,25,44,687,100,190,0,0,100,190,39,57,53,126,179,22,15,42,53,86,239,C
2012,22,65,1465,251,591,12,51,239,540,92,112,96,231,327,57,21,52,74,137,606,C
2012,31,59,956,77,171,28,67,49,104,6,9,40,151,191,51,15,16,26,98,188,PF
2012,25,3,3,0,1,0,0,0,1,0,0,0,0,0,0,0,0,0,0,0,C
2012,35,22,270,24,64,8,29,16,35,2,4,11,39,50,12,19,4,7,40,58,PF
2012,37,62,1961,295,555,55,141,240,414,127,142,26,160,186,664,38,8,229,53,772,PG
2012,27,56,1206,212,486,83,198,129,288,50,64,12,106,118,117,27,2,60,75,557,SG
2012,29,57,1706,259,606,87,231,172,375,71,88,29,152,181,325,38,5,135,130,676,PG
2012,26,64,1945,249,490,0,1,249,489,154,206,242,387,629,160,41,92,92,162,652,C
2012,32,11,56,5,20,1,6,4,14,6,11,1,13,14,1,1,1,5,4,17,SF
2012,28,54,1020,161,337,133,282,28,55,22,26,9,95,104,12,16,9,21,59,477,PF
2012,33,62,2079,473,1034,78,212,395,822,318,355,46,372,418,136,42,30,117,129,1342,PF
2012,33,25,570,52,120,0,0,52,120,21,31,37,98,135,10,8,43,21,80,125,C
2012,32,50,1027,123,349,28,111,95,238,58,98,36,172,208,83,20,18,52,97,332,SF
2012,29,27,781,114,214,0,0,114,214,38,74,70,143,213,24,16,26,37,73,266,C
2012,32,17,454,52,139,23,72,29,67,3,5,22,59,81,30,9,5,25,45,130,C
2012,21,16,187,17,30,0,1,17,29,11,25,19,20,39,5,8,9,7,30,45,PF
2012,27,39,500,60,175,16,60,44,115,31,46,19,42,61,16,19,21,20,34,167,SF
2012,29,7,75,4,11,2,5,2,6,3,4,2,11,13,4,0,1,2,10,13,SF
2012,27,58,1640,169,339,0,0,169,339,117,158,154,303,457,79,55,29,81,172,455,C
2012,32,50,671,105,253,53,138,52,115,19,20,9,64,73,96,20,2,49,64,282,PG
2012,25,44,424,50,150,10,38,40,112,16,27,12,25,37,55,15,0,46,46,126,PG
2012,36,51,1280,141,326,50,138,91,188,35,56,10,128,138,120,38,7,50,65,367,SF
2012,29,60,1923,427,890,14,61,413,829,227,284,22,149,171,463,57,5,153,75,1095,PG
2012,23,63,1804,248,549,60,178,188,371,43,78,90,210,300,134,73,29,81,142,599,SF
2012,22,64,1483,225,511,0,3,225,508,40,57,112,174,286,53,27,36,49,113,490,PF
2012,26,60,2181,425,890,79,213,346,677,260,302,42,171,213,543,152,4,124,138,1189,PG
2012,28,45,527,50,128,17,58,33,70,3,8,4,68,72,18,20,15,20,54,120,SF
2012,26,47,1264,256,454,0,0,256,454,139,187,181,165,346,31,29,31,87,98,651,C
2012,27,65,1744,128,262,0,0,128,262,73,112,120,306,426,78,25,73,118,189,329,C
2012,26,59,920,109,260,1,1,108,259,31,37,68,156,224,45,21,23,38,122,250,C
2012,34,61,2075,394,890,100,273,294,617,293,344,37,280,317,274,70,26,173,147,1181,SF
2012,29,42,921,104,270,61,182,43,88,20,31,18,112,130,25,21,10,33,81,289,SG
2012,23,35,301,44,94,0,0,44,94,18,28,27,44,71,9,8,8,17,73,106,C
2012,23,64,1002,108,239,22,73,86,166,33,53,55,71,126,27,27,5,30,90,271,SF
2012,25,44,568,59,174,26,88,33,86,28,35,13,48,61,86,20,2,32,30,172,PG
2012,28,36,517,49,130,13,44,36,86,20,25,18,38,56,67,34,3,46,72,131,PG
2012,31,63,2087,336,798,37,104,299,694,89,115,72,209,281,153,27,32,74,77,798,SF
2012,32,27,449,22,48,0,0,22,48,11,18,29,109,138,6,4,16,22,66,55,C
2012,31,49,755,74,197,50,135,24,62,22,29,34,109,143,54,21,15,35,62,220,SF
2012,22,34,517,94,200,0,1,94,199,64,84,42,81,123,19,13,35,40,56,252,PF
2012,30,28,735,132,285,2,8,130,277,58,88,78,147,225,48,21,4,40,57,324,PF
2012,32,51,770,144,360,42,132,102,228,88,111,14,63,77,33,13,0,37,29,418,SG
2012,27,65,1765,248,584,112,268,136,316,143,157,18,132,150,164,27,6,68,92,751,SG
2012,25,5,17,4,5,0,0,4,5,0,0,1,1,2,0,0,0,1,1,8,PF
2012,31,54,1591,243,596,102,277,141,319,41,69,36,158,194,107,53,22,60,91,629,SG
2012,31,48,866,74,197,42,121,32,76,25,30,15,108,123,38,28,6,29,74,215,SF
2012,30,53,1750,242,550,49,152,193,398,106,119,19,122,141,252,56,16,96,136,639,SG
2012,27,51,1192,205,484,66,181,139,303,94,113,15,85,100,231,59,2,75,118,570,PG
2012,25,53,1957,256,572,10,42,246,530,108,181,62,195,257,620,95,3,193,99,630,PG
2012,23,39,1375,302,695,54,173,248,522,194,239,26,105,131,307,35,28,119,52,852,PG
2012,21,41,1404,139,389,32,94,107,295,126,157,21,150,171,336,91,8,131,97,436,PG
2012,26,65,1717,235,469,99,219,136,250,65,82,33,218,251,88,35,58,68,64,634,SF
2012,29,28,357,33,95,4,13,29,82,14,22,7,19,26,58,18,1,33,29,84,PG
2012,32,46,1250,141,345,33,112,108,233,29,45,20,114,134,93,37,7,45,77,344,SF
2012,23,54,825,105,231,0,0,105,231,82,117,63,117,180,20,20,20,56,113,292,C
2012,23,52,643,84,184,0,2,84,182,18,38,62,98,160,33,32,76,43,133,186,PF
2012,33,28,122,14,30,1,7,13,23,3,6,8,13,21,15,5,6,9,9,32,PF
2012,31,66,2067,436,888,0,3,436,885,153,198,122,306,428,140,35,24,153,214,1025,PF
2012,27,42,914,67,155,31,71,36,84,38,43,21,107,128,47,37,17,40,78,203,SG
2012,20,28,237,25,72,2,15,23,57,11,14,2,13,15,30,7,0,29,17,63,PG
2012,22,57,1176,203,382,0,1,203,381,47,70,103,177,280,33,19,76,66,133,453,C
2012,25,64,1707,242,565,43,97,199,468,194,248,33,181,214,354,44,3,141,100,721,PG
2012,25,41,1006,141,354,26,62,115,292,122,147,19,108,127,212,27,1,82,63,430,PG
2012,25,23,701,101,211,17,35,84,176,72,101,14,73,87,142,17,2,59,37,291,PG
2012,21,59,1705,214,534,48,157,166,377,87,109,42,144,186,164,101,8,111,173,563,PG
2012,24,2,39,4,15,1,6,3,9,2,3,2,2,4,3,0,0,3,5,11,SG
2012,31,28,418,28,90,20,60,8,30,4,7,17,38,55,11,15,3,10,41,80,SF
2012,22,66,1431,116,312,44,127,72,185,30,44,43,190,233,49,70,30,38,176,306,SF
2012,30,12,262,41,75,2,9,39,66,14,15,25,56,81,15,9,8,10,27,98,PF
2012,35,1,4,0,1,0,0,0,1,0,0,0,0,0,0,0,0,0,1,0,C
2012,24,33,669,79,198,2,25,77,173,23,30,18,49,67,105,13,3,49,37,183,PG
2012,24,5,20,3,8,0,1,3,7,0,0,1,4,5,5,1,0,2,3,6,PG
2012,24,3,41,5,14,0,2,5,12,2,4,2,1,3,8,2,0,5,2,12,PG
2012,24,25,608,71,176,2,22,69,154,21,26,15,44,59,92,10,3,42,32,165,PG
2012,28,47,464,59,117,0,1,59,116,38,53,33,77,110,19,16,5,24,55,156,PF
2012,21,8,69,7,11,0,0,7,11,0,0,5,15,20,1,2,5,1,17,14,C
2012,23,26,234,31,81,3,9,28,72,7,10,7,28,35,41,15,2,13,15,72,PG
2012,23,6,63,12,30,2,5,10,25,1,2,2,7,9,9,4,0,1,4,27,PG
2012,23,20,171,19,51,1,4,18,47,6,8,5,21,26,32,11,2,12,11,45,PG
2012,26,35,967,165,405,67,193,98,212,39,55,29,107,136,84,54,6,46,87,436,SG
2012,25,40,947,181,348,1,9,180,339,33,47,72,124,196,34,21,41,40,102,396,PF
2012,24,5,46,3,14,1,6,2,8,0,0,2,5,7,4,5,0,0,5,7,PG
2012,26,66,2329,504,1101,28,109,476,992,203,322,136,496,632,257,93,115,164,172,1239,PF
2012,23,44,541,67,180,13,45,54,135,20,28,17,39,56,62,18,3,42,55,167,PG
2012,24,60,1345,221,488,0,3,221,485,84,109,133,241,374,48,21,29,74,147,526,PF
2012,27,59,1121,212,343,0,0,212,343,125,181,93,213,306,65,21,47,87,134,549,C
2012,37,30,273,37,100,13,38,24,62,21,23,6,17,23,14,10,3,13,12,108,SF
2012,21,42,442,47,125,4,30,43,95,8,17,12,41,53,46,21,5,36,30,106,SG
2012,30,51,960,49,172,41,145,8,27,9,16,7,94,101,41,19,4,19,59,148,SF
2012,26,55,766,66,121,0,0,66,121,29,41,48,129,177,28,37,85,33,144,161,C
2012,23,22,179,13,31,2,11,11,20,8,11,5,20,25,37,8,6,11,18,36,SG
2012,29,47,1543,316,654,5,21,311,633,186,243,106,261,367,52,38,45,112,138,823,PF
2012,25,55,1644,256,597,33,104,223,493,267,320,38,104,142,210,44,10,106,124,812,SG
2012,24,15,209,28,65,5,16,23,49,7,9,8,15,23,10,7,0,8,31,68,SF
2012,23,66,2183,320,672,51,149,269,523,140,185,21,138,159,321,106,37,134,145,831,PG
2012,26,60,895,141,342,33,105,108,237,53,67,20,71,91,138,41,12,68,120,368,PG
2012,34,63,2000,357,830,138,365,219,465,98,111,16,133,149,226,73,11,127,69,950,SG
2012,24,20,139,11,21,0,0,11,21,13,20,16,26,42,0,1,10,8,20,35,C
2012,24,5,23,3,3,0,0,3,3,0,0,1,6,7,0,0,2,0,5,6,C
2012,24,15,116,8,18,0,0,8,18,13,20,15,20,35,0,1,8,8,15,29,C
2012,22,65,1656,256,571,83,219,173,352,154,185,48,120,168,266,53,8,105,121,749,PG
2012,39,53,803,73,157,0,0,73,157,14,20,39,149,188,46,24,31,31,123,160,C
2012,23,42,630,57,126,0,1,57,125,52,62,49,77,126,12,10,7,24,78,166,PF
2012,23,3,15,0,3,0,0,0,3,1,2,1,2,3,1,1,1,0,0,1,PF
2012,25,54,1013,120,327,1,3,119,324,63,83,49,151,200,35,36,60,53,144,304,PF
2012,21,24,119,24,61,4,13,20,48,5,7,4,20,24,3,3,3,6,10,57,C
2012,25,64,1657,237,443,0,2,237,441,109,181,166,277,443,79,43,44,68,149,583,PF
2012,21,66,1608,318,718,111,268,207,450,79,91,24,137,161,133,49,20,103,155,826,SG
2012,23,5,95,7,24,4,11,3,13,0,0,0,5,5,7,2,1,5,8,18,SG
2012,20,60,1424,194,442,0,2,194,440,106,192,187,202,389,27,27,62,81,134,494,PF
2012,24,51,1780,352,803,107,310,245,493,141,163,84,104,188,98,71,12,84,111,952,SG
2012,33,37,507,57,141,10,37,47,104,13,17,6,39,45,123,17,8,52,47,137,PG
2012,26,51,882,71,182,25,101,46,81,41,55,50,103,153,22,18,19,35,86,208,SF
2012,29,17,279,19,33,0,1,19,32,13,22,20,50,70,10,14,17,14,39,51,C
2012,29,4,58,3,3,0,0,3,3,0,0,1,11,12,5,6,3,6,7,6,C
2012,29,13,221,16,30,0,1,16,29,13,22,19,39,58,5,8,14,8,32,45,C
2012,32,53,1653,209,504,91,258,118,246,67,95,24,175,199,233,45,17,142,139,576,SF
2012,23,65,1713,263,590,11,49,252,541,73,108,27,349,376,180,40,20,105,117,610,SF
2012,20,42,568,88,209,0,1,88,208,29,52,54,86,140,16,16,20,36,84,205,C
2012,25,4,52,5,18,1,5,4,13,3,3,2,8,10,1,1,1,1,1,14,SF
2012,24,61,1290,127,295,0,2,127,293,86,114,100,154,254,57,40,102,53,174,340,C
2012,24,38,827,82,185,0,0,82,185,46,64,58,89,147,31,25,65,35,115,210,C
2012,24,23,463,45,110,0,2,45,108,40,50,42,65,107,26,15,37,18,59,130,C
2012,29,59,1080,146,332,17,59,129,273,39,55,26,76,102,227,37,1,77,69,348,SG
2012,23,18,370,35,99,0,1,35,98,11,19,19,48,67,61,17,3,19,31,81,PG
2012,23,2,13,2,5,0,0,2,5,0,0,2,2,4,2,1,0,0,1,4,PG
2012,23,16,357,33,94,0,1,33,93,11,19,17,46,63,59,16,3,19,30,77,PG
2012,29,25,785,114,222,0,4,114,218,43,64,109,178,287,43,35,17,45,62,271,C
2012,25,66,1706,225,523,43,135,182,388,96,117,23,150,173,359,60,8,148,126,589,SG
2012,21,57,1078,117,218,0,1,117,217,33,62,101,148,249,47,39,32,60,156,267,PF
2012,27,13,180,35,91,15,45,20,46,6,7,9,39,48,6,7,5,7,25,91,PF
2012,21,51,812,131,291,3,8,128,283,18,34,88,158,246,31,20,34,33,111,283,C
2012,30,49,1625,416,837,15,56,401,781,235,297,73,164,237,225,82,63,129,110,1082,SG
2012,26,33,469,71,157,14,39,57,118,38,54,6,39,45,29,10,3,35,26,194,SG
2012,24,32,620,68,171,36,113,32,58,17,20,9,71,80,37,19,7,35,84,189,SG
2012,21,66,1792,281,767,69,226,212,541,168,213,30,204,234,289,60,20,119,79,799,PG
2012,21,66,2386,378,894,3,42,375,852,317,402,48,252,300,530,95,57,255,137,1076,PG
2012,37,62,980,34,86,1,4,33,82,16,47,81,188,269,43,47,51,34,60,85,C
2012,29,58,2076,287,632,46,150,241,482,180,225,87,299,386,164,85,36,111,145,800,SF
2012,29,42,1503,203,430,26,98,177,332,125,161,63,214,277,115,62,25,84,107,557,SF
2012,29,16,573,84,202,20,52,64,150,55,64,24,85,109,49,23,11,27,38,243,SF
2012,31,9,65,6,14,0,4,6,10,0,0,6,8,14,5,2,0,2,9,12,SF
2012,31,21,299,18,51,7,16,11,35,0,0,7,28,35,30,3,1,25,32,43,PF
2012,29,35,503,74,180,1,10,73,170,76,99,31,61,92,30,8,3,36,35,225,PF
2012,27,5,98,7,14,0,0,7,14,9,18,8,19,27,3,5,4,8,14,23,C
2012,27,49,1159,161,437,68,173,93,264,84,104,21,84,105,200,45,8,97,103,474,PG
2012,32,50,1033,54,160,10,52,44,108,31,46,30,91,121,217,54,22,85,105,149,PG
2012,25,47,1140,115,272,37,109,78,163,57,72,42,126,168,40,31,17,46,86,324,SF
2012,31,66,1925,349,716,2,9,347,707,142,176,118,315,433,140,52,46,93,160,842,PF
2012,28,44,1060,166,360,27,76,139,284,62,70,13,88,101,139,58,11,76,67,421,PG
2012,23,66,2331,578,1266,62,196,516,1070,340,413,96,205,301,362,112,21,239,147,1558,PG
2012,25,58,1098,174,353,1,1,173,352,43,61,50,159,209,47,17,23,43,94,392,PF
2012,22,18,109,12,27,0,0,12,27,5,12,16,23,39,0,3,15,5,12,29,C
2012,29,28,481,64,107,0,0,64,107,24,39,38,84,122,12,11,9,30,64,152,C
2012,32,60,922,76,193,7,23,69,170,34,54,22,78,100,44,29,13,30,85,193,SF
2012,27,55,1999,391,961,115,342,276,619,257,305,23,160,183,481,67,20,219,121,1154,PG
2012,20,66,1418,205,498,37,138,168,360,136,195,77,234,311,38,30,31,77,95,583,PF
2012,22,24,149,37,74,8,27,29,47,6,18,7,12,19,6,6,3,5,18,88,SG
2012,21,43,635,77,152,0,0,77,152,43,66,66,90,156,11,21,15,23,61,197,C
2012,25,64,1682,318,782,83,229,235,553,237,292,30,125,155,221,53,18,71,90,956,PG
2012,25,57,1500,203,470,58,149,145,321,115,146,76,218,294,71,47,18,39,84,579,SF
2012,29,52,1472,260,611,93,239,167,372,72,80,23,76,99,160,51,7,86,103,685,SG
2012,25,33,747,106,255,33,107,73,148,29,40,27,66,93,60,20,3,33,34,274,SF
2012,25,11,107,14,22,0,0,14,22,12,13,13,12,25,5,4,8,10,18,40,C
2012,25,8,65,12,16,0,0,12,16,5,6,9,4,13,2,1,5,7,14,29,C
2012,25,3,42,2,6,0,0,2,6,7,7,4,8,12,3,3,3,3,4,11,C
2012,25,25,514,42,147,21,87,21,60,8,11,20,48,68,16,10,11,13,44,113,SF
2012,28,58,1276,96,201,0,0,96,201,76,104,141,209,350,35,47,39,66,149,268,C
2012,24,30,550,85,198,16,46,69,152,27,46,13,89,102,65,20,7,43,35,213,SG
2012,24,12,181,20,57,8,19,12,38,6,12,2,26,28,10,4,1,10,16,54,SG
2012,24,18,369,65,141,8,27,57,114,21,34,11,63,74,55,16,6,33,19,159,SG
2012,32,64,1720,183,465,56,189,127,276,71,115,71,147,218,140,69,27,69,137,493,SF
2012,24,49,791,144,233,0,1,144,232,52,82,62,112,174,13,22,63,21,61,340,C
2012,23,24,186,23,45,0,0,23,45,24,31,19,26,45,4,7,13,8,22,70,SF
2012,26,61,1650,222,526,105,292,117,234,80,98,60,218,278,94,58,26,51,97,629,SF
2012,26,62,1729,316,784,103,282,213,502,144,169,31,102,133,56,44,17,83,141,879,SG
2012,26,40,1211,240,591,73,197,167,394,112,130,20,77,97,46,30,11,59,90,665,SG
2012,26,22,518,76,193,30,85,46,108,32,39,11,25,36,10,14,6,24,51,214,SG
2012,26,35,375,45,127,5,17,40,110,19,26,20,42,62,15,17,6,16,23,114,SF
2012,26,21,240,32,83,0,9,32,74,10,12,14,27,41,9,11,2,9,12,74,SF
2012,26,14,135,13,44,5,8,8,36,9,14,6,15,21,6,6,4,7,11,40,SF
2012,23,63,1755,348,687,1,4,347,683,111,144,137,188,325,74,64,41,55,127,808,PF
2013,22,29,342,42,75,1,2,41,73,31,38,30,47,77,11,13,15,17,53,116,PF
2013,26,52,713,72,168,0,2,72,166,65,100,68,128,196,36,18,27,32,80,209,PF
2013,27,64,2307,397,905,72,240,325,665,191,223,29,210,239,206,40,11,138,137,1057,SF
2013,26,3,9,2,4,1,2,1,2,0,0,0,1,1,1,0,0,0,3,5,PG
2013,24,45,388,44,80,0,0,44,80,12,20,30,90,120,9,5,23,23,60,100,C
2013,24,30,213,23,43,0,0,23,43,4,9,12,45,57,6,3,9,14,41,50,C
2013,24,15,175,21,37,0,0,21,37,8,11,18,45,63,3,2,14,9,19,50,C
2013,27,74,2790,638,1318,2,14,636,1304,282,348,175,495,670,192,62,91,143,187,1560,PF
2013,23,79,1669,206,454,0,1,206,453,43,60,159,236,395,73,24,55,55,180,455,C
2013,37,79,2035,292,651,139,332,153,319,140,158,40,177,217,135,67,15,103,129,863,SG
2013,31,79,2109,284,638,3,24,281,614,134,187,121,242,363,98,119,44,94,211,705,SG
2013,22,76,2066,225,474,4,19,221,455,101,137,139,446,585,103,92,51,116,153,555,SF
2013,30,39,372,32,81,0,0,32,81,12,36,48,58,106,11,16,12,19,53,76,PF
2013,30,20,161,14,38,0,0,14,38,4,20,23,24,47,3,7,6,11,26,32,PF
2013,30,1,2,0,1,0,0,0,1,0,0,1,0,1,0,0,0,0,0,0,PF
2013,30,18,209,18,42,0,0,18,42,8,16,24,34,58,8,9,6,8,27,44,PF
2013,34,42,624,71,123,2,3,69,120,63,93,57,115,172,17,16,44,24,89,207,C
2013,30,65,1495,236,616,95,285,141,331,126,147,34,114,148,103,48,7,80,131,693,SF
2013,23,10,94,11,25,5,11,6,14,7,9,3,11,14,9,3,2,7,7,34,SF
2013,23,29,307,41,101,16,49,25,52,17,19,15,43,58,33,12,3,18,18,115,SG
2013,24,81,2503,472,1115,213,557,259,558,152,180,191,328,519,97,42,31,97,179,1309,PF
2013,28,67,2482,669,1489,157,414,512,1075,425,512,134,326,460,171,52,32,175,205,1920,PF
2013,30,62,566,35,68,0,0,35,68,17,28,45,70,115,13,13,42,22,49,87,C
2013,27,56,1471,188,451,76,209,112,242,78,95,44,222,266,113,72,20,84,72,530,SF
2013,24,59,970,162,359,5,18,157,341,33,46,68,101,169,33,24,33,43,126,362,PF
2013,26,82,2464,332,614,0,1,332,613,168,299,275,681,956,75,46,87,173,223,832,C
2013,25,76,1226,103,294,67,190,36,104,83,99,20,71,91,170,34,3,68,64,356,PG
2013,27,55,734,92,167,0,0,92,167,20,50,60,139,199,71,22,17,47,107,204,C
2013,27,43,571,67,125,0,0,67,125,19,38,40,100,140,59,13,13,38,83,153,C
2013,27,12,163,25,42,0,0,25,42,1,12,20,39,59,12,9,4,9,24,51,C
2013,25,37,369,61,126,2,4,59,122,21,23,29,75,104,15,6,12,23,44,145,PF
2013,23,62,730,86,234,62,178,24,56,10,13,15,122,137,29,14,5,22,82,244,PF
2013,30,41,513,83,193,18,47,65,146,31,41,8,38,46,58,17,6,21,51,215,PG
2013,28,74,1713,316,758,97,280,219,478,105,134,34,173,207,294,32,0,145,131,834,PG
2013,27,35,1003,170,426,38,123,132,303,65,77,26,102,128,38,21,23,54,64,443,PF
2013,20,81,2058,276,628,52,145,224,483,144,190,53,280,333,98,52,14,101,140,748,SF
2013,32,80,2058,312,675,111,325,201,350,87,117,111,255,366,123,82,63,90,233,822,SF
2013,31,12,159,18,51,0,0,18,51,3,7,22,39,61,5,5,6,11,24,39,C
2013,31,11,122,13,37,0,0,13,37,2,5,16,27,43,3,5,5,10,23,28,C
2013,31,1,37,5,14,0,0,5,14,1,2,6,12,18,2,0,1,1,1,11,C
2013,22,73,894,118,309,9,65,109,244,50,65,36,109,145,58,34,9,60,56,295,SG
2013,27,81,2239,286,589,0,2,286,587,129,150,129,296,425,84,44,64,80,188,701,PF
2013,34,72,1786,152,362,136,316,16,46,32,38,37,128,165,72,41,55,34,149,472,SF
2013,24,73,2807,352,833,165,444,187,389,178,210,97,315,412,360,91,83,190,139,1047,SF
2013,24,80,1765,260,621,71,201,189,420,102,122,22,154,176,264,59,17,120,168,693,PG
2013,26,16,141,18,36,0,1,18,35,7,12,12,20,32,5,1,6,11,23,43,C
2013,23,61,267,43,116,10,34,33,82,27,44,5,17,22,22,17,4,18,27,123,SG
2013,19,56,1745,282,687,91,236,191,451,125,159,43,168,211,137,50,29,90,113,780,SG
2013,24,75,1554,310,766,45,144,265,622,94,126,52,230,282,111,31,34,144,107,759,SF
2013,24,45,549,65,176,21,72,44,104,30,38,9,48,57,84,19,4,33,54,181,PG
2013,26,73,1882,241,610,79,221,162,389,141,168,13,127,140,148,44,6,82,140,702,SG
2013,24,41,713,79,189,36,96,43,93,34,41,45,64,109,117,37,21,44,83,228,PG
2013,26,53,495,10,21,0,0,10,21,4,13,34,119,153,14,15,42,14,101,24,C
2013,36,22,418,53,132,33,90,20,42,45,48,2,30,32,49,12,1,26,25,184,SG
2013,20,80,2186,156,346,0,0,156,346,74,142,194,388,582,35,28,143,82,195,386,C
2013,23,61,851,142,271,0,1,142,270,44,70,66,164,230,45,37,10,49,112,328,PF
2013,32,45,1175,114,270,72,171,42,99,27,35,21,111,132,173,34,6,62,83,327,PG
2013,26,82,1555,346,676,3,22,343,654,148,216,161,256,417,85,86,54,123,163,843,C
2013,23,76,1553,253,568,31,78,222,490,106,134,78,147,225,233,109,55,137,112,643,PG
2013,32,74,1408,108,284,84,245,24,39,11,17,16,104,120,76,28,4,49,108,311,SG
2013,28,32,786,83,184,1,1,82,183,19,38,68,177,245,67,20,55,35,85,186,C
2013,32,68,909,112,230,53,120,59,110,11,15,25,104,129,36,17,19,16,86,288,PF
2013,25,48,887,108,220,0,5,108,215,40,72,98,141,239,40,32,16,31,95,256,PF
2013,31,79,2546,544,1140,0,2,544,1138,193,264,175,596,771,179,66,28,176,239,1281,PF
2013,28,74,2454,485,907,21,74,464,833,241,302,131,370,501,123,66,101,128,168,1232,C
2013,22,50,1435,192,478,40,126,152,352,37,49,30,81,111,104,64,19,72,129,461,PG
2013,33,72,1527,226,478,0,1,226,477,66,93,130,300,430,70,50,90,57,192,518,C
2013,26,82,2003,375,883,91,307,284,576,149,216,55,180,235,124,118,23,102,154,990,SF
2013,27,60,853,70,198,23,76,47,122,16,39,42,98,140,50,43,6,18,33,179,SF
2013,27,46,711,64,175,22,71,42,104,16,39,29,71,100,40,34,6,14,27,166,SF
2013,27,14,142,6,23,1,5,5,18,0,0,13,27,40,10,9,0,4,6,13,SF
2013,28,53,997,143,316,50,134,93,182,40,52,13,67,80,114,30,10,67,94,376,PG
2013,28,46,959,139,303,48,127,91,176,40,52,12,66,78,108,29,7,63,89,366,PG
2013,28,7,38,4,13,2,7,2,6,0,0,1,1,2,6,1,3,4,5,10,PG
2013,24,73,912,155,335,15,55,140,280,69,94,32,72,104,76,34,16,69,93,394,SG
2013,30,22,269,17,37,0,0,17,37,7,19,23,51,74,9,6,10,8,37,41,C
2013,27,59,1402,240,571,39,141,201,430,98,125,44,105,149,108,59,15,74,92,617,SG
2013,34,78,3013,738,1595,132,407,606,1188,525,626,66,367,433,469,106,25,287,173,2133,SG
2013,24,23,508,79,191,26,81,53,110,32,42,15,56,71,25,14,7,23,29,216,SF
2013,21,64,1137,163,388,33,92,130,296,92,129,37,108,145,92,35,13,74,114,451,SG
2013,32,78,1879,305,720,128,330,177,390,75,90,41,182,223,78,51,11,72,139,813,SF
2013,23,82,2134,239,512,40,105,199,407,187,233,136,192,328,115,78,31,62,97,705,SF
2013,30,65,1219,253,540,24,76,229,464,106,131,28,69,97,231,45,5,125,128,636,PG
2013,31,73,2160,312,635,130,282,182,353,72,80,20,156,176,518,58,8,126,99,826,PG
2013,31,45,1273,187,398,79,184,108,214,47,52,14,92,106,333,28,6,75,58,500,PG
2013,31,28,887,125,237,51,98,74,139,25,28,6,64,70,185,30,2,51,41,326,PG
2013,38,24,250,17,53,0,0,17,53,8,19,24,56,80,14,7,14,15,28,42,PF
2013,26,66,1111,149,324,20,70,129,254,75,98,87,101,188,61,58,24,34,119,393,SF
2013,36,81,2093,372,855,162,399,210,456,182,223,58,276,334,194,74,44,106,226,1088,SF
2013,24,43,503,63,160,25,76,38,84,22,41,20,94,114,28,25,12,22,45,173,SF
2013,26,77,2068,227,529,123,301,104,228,89,112,19,152,171,273,118,12,119,196,666,PG
2013,30,66,2164,255,400,0,0,255,400,179,258,269,434,703,62,42,75,87,188,689,C
2013,25,43,1079,210,455,52,126,158,329,88,111,45,173,218,58,45,12,60,119,560,PF
2013,29,14,100,6,21,1,3,5,18,1,2,6,9,15,5,2,2,0,3,14,SF
2013,25,59,1363,170,386,35,104,135,282,53,76,82,243,325,65,36,44,62,102,428,PF
2013,24,49,812,74,189,25,87,49,102,14,30,31,88,119,43,26,12,43,75,187,SF
2013,24,80,1590,179,425,35,98,144,327,52,80,18,112,130,164,57,7,104,155,445,PG
2013,34,38,384,9,29,0,0,9,29,23,32,22,38,60,8,12,10,18,85,41,C
2013,34,32,330,8,23,0,0,8,23,21,30,21,31,52,6,10,6,16,74,37,C
2013,34,6,54,1,6,0,0,1,6,2,2,1,7,8,2,2,4,2,11,4,C
2013,25,81,2372,341,724,48,136,293,588,242,275,31,188,219,415,100,8,173,139,972,PG
2013,32,81,1583,176,296,0,4,176,292,60,78,123,210,333,121,51,30,69,197,412,C
2013,25,80,2757,414,940,106,293,308,647,234,282,43,182,225,487,174,24,189,171,1168,PG
2013,30,4,20,0,9,0,3,0,6,1,2,1,0,1,0,0,0,0,1,1,PG
2013,25,49,441,51,167,26,91,25,76,9,12,7,54,61,19,8,7,15,26,137,SG
2013,25,16,165,21,59,11,30,10,29,2,3,5,13,18,10,6,2,6,13,55,SG
2013,25,33,276,30,108,15,61,15,47,7,9,2,41,43,9,2,5,9,13,82,SG
2013,28,56,862,182,380,59,140,123,240,63,83,34,85,119,27,16,12,50,104,486,PF
2013,22,75,2289,482,1036,4,22,478,1014,312,423,222,524,746,199,108,55,225,269,1280,C
2013,32,76,2230,445,1016,149,396,296,620,216,248,22,106,128,193,79,13,146,71,1255,SG
2013,24,70,1709,301,725,83,246,218,479,129,159,44,165,209,225,39,7,141,106,814,SG
2013,24,43,1127,211,508,59,171,152,337,87,106,31,104,135,157,27,5,97,61,568,SG
2013,24,27,582,90,217,24,75,66,142,42,53,13,61,74,68,12,2,44,45,246,SG
2013,22,78,1353,141,367,63,192,78,175,47,73,35,152,187,94,63,17,49,128,392,SF
2013,25,80,2010,314,671,0,6,314,665,67,103,142,266,408,67,84,38,56,153,695,PF
2013,21,8,26,6,14,2,3,4,11,2,2,1,2,3,1,1,0,2,3,16,SG
2013,30,2,25,4,8,0,0,4,8,1,4,2,2,4,0,0,0,3,7,9,C
2013,24,78,2983,626,1388,272,600,354,788,262,291,59,255,314,539,126,12,240,198,1786,PG
2013,31,47,765,137,253,1,1,136,252,38,55,105,171,276,21,17,53,51,90,313,C
2013,32,59,1085,132,351,20,72,112,279,40,54,48,102,150,65,51,10,45,77,324,SF
2013,19,64,1846,349,676,0,6,349,670,169,225,165,357,522,63,75,112,89,158,867,PF
2013,23,45,1087,186,339,0,0,186,339,66,102,95,205,300,55,25,38,45,111,438,C
2013,23,36,544,74,143,0,0,74,143,37,65,57,103,160,8,13,47,18,80,185,PF
2013,27,34,1064,214,478,0,2,214,476,84,117,55,191,246,70,32,21,64,88,512,PF
2013,24,55,676,90,208,41,98,49,110,26,34,16,107,123,42,14,22,29,82,247,SF
2013,24,24,348,43,97,21,40,22,57,15,18,10,53,63,21,5,8,13,43,122,SF
2013,24,31,328,47,111,20,58,27,53,11,16,6,54,60,21,9,14,16,39,125,SF
2013,25,72,920,105,241,31,82,74,159,35,44,23,115,138,138,41,6,81,87,276,SG
2013,30,67,1689,251,620,158,421,93,199,48,56,18,202,220,135,68,9,72,114,708,SF
2013,27,75,2903,466,1093,75,233,391,860,230,282,162,314,476,222,81,32,144,105,1237,SF
2013,27,2,4,0,2,0,0,0,2,0,0,0,0,0,0,0,0,0,0,0,PG
2013,23,82,3013,548,1231,34,120,514,1111,355,427,48,272,320,204,76,24,151,173,1485,SG
2013,30,75,1709,179,332,30,78,149,254,47,65,66,188,254,180,52,27,84,143,435,PF
2013,31,22,226,8,27,0,1,8,26,0,1,10,41,51,13,5,16,8,19,16,C
2013,32,7,82,10,21,5,12,5,9,6,7,0,1,1,8,1,0,5,8,31,PG
2013,26,71,1289,188,466,82,216,106,250,76,84,34,104,138,151,71,3,81,145,534,PG
2013,26,49,913,139,352,61,162,78,190,60,68,23,67,90,93,40,2,56,103,399,PG
2013,26,22,376,49,114,21,54,28,60,16,16,11,37,48,58,31,1,25,42,135,PG
2013,26,6,63,5,14,0,4,5,10,7,10,0,5,5,4,2,0,1,4,17,SG
2013,26,77,2581,401,906,88,276,313,630,244,326,60,178,238,569,124,26,212,214,1134,PG
2013,19,60,1243,208,342,1,2,207,340,59,159,169,288,457,30,59,95,57,144,476,C
2013,27,79,2170,313,669,106,271,207,398,129,162,79,166,245,203,75,8,101,128,861,SF
2013,30,46,820,47,123,33,91,14,32,6,13,11,57,68,133,20,1,40,56,133,PG
2013,36,69,2078,490,976,2,7,488,969,245,300,124,562,686,184,50,183,147,117,1227,C
2013,32,75,1943,276,624,128,299,148,325,105,128,31,260,291,145,39,35,90,135,785,SF
2013,24,81,3119,731,1433,139,334,592,1099,679,750,46,594,640,374,116,105,280,143,2280,SF
2013,23,19,197,24,73,6,22,18,51,11,14,10,31,41,10,3,1,11,23,65,SF
2013,25,78,1661,226,529,94,240,132,289,68,75,25,141,166,104,45,3,57,81,614,SG
2013,25,40,676,81,199,41,97,40,102,15,16,5,47,52,42,16,1,24,38,218,SG
2013,25,38,985,145,330,53,143,92,187,53,59,20,94,114,62,29,2,33,43,396,SG
2013,27,82,3076,597,1436,94,328,503,1108,289,374,45,271,316,496,169,36,254,164,1577,SG
2013,24,41,407,42,112,14,50,28,62,21,29,8,29,37,26,16,3,19,46,119,SG
2013,25,37,215,27,44,0,1,27,43,21,33,26,32,58,11,8,13,8,30,75,PF
2013,32,80,1967,125,261,0,0,125,261,113,222,260,628,888,43,74,13,111,199,363,PF
2013,23,65,2016,366,765,45,133,321,632,210,271,56,231,287,229,90,27,128,133,987,SG
2013,23,78,1120,74,169,0,0,74,169,43,81,141,172,313,22,23,74,63,157,191,C
2013,23,80,2248,380,689,0,0,380,689,163,266,260,474,734,77,81,83,113,234,923,PF
2013,21,77,1787,274,568,0,5,274,563,179,260,184,362,546,75,67,130,129,247,727,PF
2013,28,68,2313,377,882,93,258,284,624,101,128,51,143,194,372,94,14,155,130,948,PG
2013,24,51,1037,102,223,2,14,100,209,34,53,59,149,208,60,32,8,42,63,240,SF
2013,38,9,229,23,65,10,23,13,42,21,23,0,15,15,31,5,2,18,24,77,PG
2013,38,24,346,32,96,20,57,12,39,14,15,2,20,22,16,14,1,12,31,98,SG
2013,20,38,428,75,152,22,54,53,98,30,39,6,29,35,44,19,1,32,65,202,SG
2013,29,82,2249,293,738,178,434,115,304,118,144,17,110,127,167,66,27,92,190,882,SG
2013,23,69,967,172,409,65,156,107,253,85,99,19,52,71,92,31,3,68,64,494,SG
2013,25,51,477,58,142,0,0,58,142,18,27,40,79,119,13,13,11,19,67,134,PF
2013,24,71,2309,364,871,135,362,229,509,286,348,65,302,367,176,64,36,111,130,1149,SF
2013,31,40,710,77,205,40,109,37,96,12,14,7,61,68,43,32,31,20,66,206,SG
2013,31,18,319,41,95,27,70,14,25,6,7,1,22,23,20,14,7,12,22,115,SF
2013,36,68,2022,422,850,2,16,420,834,158,201,75,455,530,159,78,62,110,154,1004,C
2013,24,19,149,16,49,3,15,13,34,5,10,5,10,15,31,10,0,16,5,40,PG
2013,28,80,2796,429,869,1,14,428,855,268,316,184,438,622,318,80,139,157,255,1127,C
2013,32,49,1655,270,579,8,28,262,551,125,178,111,310,421,200,24,61,104,93,673,PF
2013,26,75,2687,521,1253,84,260,437,993,240,295,99,362,461,202,113,53,198,182,1366,SF
2013,26,42,1541,281,688,40,129,241,559,121,156,56,193,249,108,56,31,104,87,723,SF
2013,26,33,1146,240,565,44,131,196,434,119,139,43,169,212,94,57,22,94,95,643,SF
2013,25,82,2541,305,744,69,219,236,525,163,205,75,245,320,133,107,29,132,199,842,SF
2013,29,36,644,72,139,16,52,56,87,21,24,32,67,99,26,16,4,16,47,181,SF
2013,22,79,2972,493,1176,170,469,323,707,221,274,88,515,603,327,143,51,233,227,1377,SF
2013,26,46,919,84,247,56,163,28,84,26,37,5,55,60,82,30,4,31,89,250,PG
2013,27,65,1459,214,441,0,4,214,437,89,131,125,220,345,61,27,90,76,166,517,PF
2013,35,60,1393,229,539,83,235,146,304,164,206,30,171,201,274,80,13,132,114,705,SG
2013,31,16,151,20,61,1,5,19,56,11,16,13,18,31,6,5,6,9,21,52,C
2013,29,75,1560,310,760,113,292,197,468,107,127,18,112,130,141,35,16,136,134,840,SG
2013,24,42,1264,235,584,56,173,179,411,187,222,10,67,77,137,45,8,117,75,713,SG
2013,28,61,1876,295,566,0,3,295,563,90,138,128,388,516,75,40,98,99,127,680,C
2013,24,1,6,0,2,0,0,0,2,0,0,1,0,1,0,0,0,0,0,0,SG
2013,29,5,74,10,35,2,10,8,25,5,8,3,6,9,3,2,1,4,6,27,SF
2013,28,42,513,48,90,0,0,48,90,23,44,48,85,133,33,7,5,36,85,119,C
2013,25,80,2201,297,663,177,413,120,250,67,79,36,208,244,141,92,54,94,124,838,SG
2013,22,79,1061,84,257,14,67,70,190,45,55,58,202,260,53,42,25,51,159,227,SF
2013,27,60,1080,155,424,59,188,96,236,52,65,31,110,141,50,19,23,53,64,421,SF
2013,26,81,2252,376,806,70,182,306,624,214,265,55,263,318,128,56,68,132,175,1036,PF
2013,31,72,1188,178,386,71,166,107,220,23,32,17,80,97,55,29,12,31,96,450,SG
2013,23,80,2598,577,1072,5,28,572,1044,281,426,186,476,662,299,97,50,185,231,1440,PF
2013,27,30,322,35,82,0,0,35,82,14,27,43,68,111,12,6,27,31,60,84,C
2013,27,13,87,7,21,0,0,7,21,1,2,10,14,24,4,1,6,4,15,15,C
2013,27,17,235,28,61,0,0,28,61,13,25,33,54,87,8,5,21,27,45,69,C
2013,22,40,397,84,201,27,73,57,128,13,26,32,63,95,23,15,8,19,24,208,SF
2013,34,50,1088,204,475,16,52,188,423,66,77,16,67,83,119,24,5,84,93,490,SG
2013,25,28,200,15,45,6,23,9,22,21,27,2,16,18,21,7,2,18,23,57,PG
2013,27,81,1366,176,407,0,3,176,404,216,300,161,212,373,36,29,18,78,152,568,PF
2013,23,78,2985,585,1337,179,486,406,851,674,792,62,317,379,455,142,38,295,178,2023,SG
2013,19,76,1974,260,564,32,117,228,447,73,128,122,213,335,50,88,62,69,144,625,SF
2013,23,6,31,4,9,1,5,3,4,1,2,3,4,7,0,1,1,3,4,10,C
2013,32,10,119,20,57,8,30,12,27,3,4,6,21,27,10,4,1,7,18,51,C
2013,29,58,1421,194,443,77,230,117,213,112,154,6,110,116,197,64,13,88,103,577,SG
2013,25,20,137,4,27,0,8,4,19,7,10,4,22,26,9,2,3,17,17,15,SG
2013,25,7,29,2,8,0,1,2,7,6,8,4,5,9,2,0,0,4,3,10,SG
2013,25,13,108,2,19,0,7,2,12,1,2,0,17,17,7,2,3,13,14,5,SG
2013,20,28,325,53,115,7,21,46,94,23,26,17,40,57,13,8,7,18,31,136,SF
2013,20,27,974,180,397,27,87,153,310,80,111,56,174,230,56,24,37,48,89,467,PF
2013,32,75,1414,129,251,0,0,129,251,32,45,97,307,404,38,30,15,45,173,290,PF
2013,24,82,2233,376,811,31,87,345,724,122,157,173,417,590,183,24,113,131,233,905,C
2013,29,74,1209,84,190,0,1,84,189,30,48,113,186,299,112,31,18,44,114,198,C
2013,22,72,2104,336,773,102,246,234,527,243,294,51,174,225,213,58,38,120,125,1017,SF
2013,26,4,31,2,10,0,4,2,6,6,6,0,4,4,3,2,0,0,3,10,SF
2013,33,61,1162,93,216,0,1,93,215,30,66,125,165,290,29,16,49,50,125,216,C
2013,25,68,2133,382,855,33,100,349,755,258,313,55,195,250,177,68,34,108,149,1055,SG
2013,21,50,625,66,161,4,11,62,150,58,92,21,69,90,13,16,5,31,72,194,SF
2013,22,63,827,162,336,0,3,162,333,56,105,116,181,297,31,19,42,47,83,380,PF
2013,26,79,2269,385,859,1,4,384,855,166,224,296,360,656,113,39,206,162,279,937,C
2013,24,80,2323,418,744,0,2,418,742,182,268,266,562,828,88,48,51,145,160,1018,C
2013,23,6,32,6,19,1,5,5,14,1,2,1,2,3,5,3,0,0,5,14,SG
2013,30,61,1659,285,594,0,1,285,593,196,269,101,306,407,177,55,37,139,171,766,PF
2013,26,76,2620,386,871,130,353,256,518,174,213,47,237,284,355,81,26,116,134,1076,PG
2013,40,29,437,38,98,3,11,35,87,14,24,6,43,49,26,11,7,25,39,93,SF
2013,25,29,458,77,155,0,2,77,153,40,61,82,84,166,13,8,19,26,55,194,PF
2013,32,60,1764,159,422,71,182,88,240,70,98,16,142,158,314,63,25,99,192,459,PG
2013,22,78,2926,555,1288,91,247,464,1041,182,242,89,240,329,625,123,32,292,170,1383,PG
2013,23,9,142,16,48,4,16,12,32,6,8,0,14,14,15,3,6,9,7,42,SG
2013,28,60,663,70,114,0,0,70,114,66,88,50,89,139,11,6,34,44,133,206,C
2013,22,9,32,3,11,0,2,3,9,2,2,3,7,10,2,0,1,5,2,8,SF
2013,26,74,2756,576,1060,3,6,573,1054,134,208,195,562,757,240,78,78,147,163,1289,C
2013,27,76,2722,470,813,1,6,469,807,355,721,251,694,945,108,84,186,225,291,1296,C
2013,32,11,207,31,77,5,16,26,61,7,12,9,27,36,4,10,3,10,18,74,SF
2013,39,7,51,10,19,0,0,10,19,1,1,0,8,8,6,0,0,4,9,21,PF
2013,27,65,1191,139,310,0,2,139,308,97,123,126,239,365,32,16,33,57,127,375,PF
2013,23,80,2486,446,778,20,57,426,721,143,191,222,395,617,43,28,242,125,213,1055,PF
2013,29,80,2779,396,879,91,287,305,592,155,270,82,341,423,433,139,52,206,127,1038,SG
2013,25,73,2012,371,803,95,214,276,589,125,157,154,366,520,117,68,36,75,185,962,PF
2013,20,59,2048,484,1070,109,279,375,791,248,290,34,182,216,350,89,21,191,146,1325,PG
2013,31,53,698,62,144,37,88,25,56,9,16,16,41,57,32,23,3,20,73,170,SG
2013,29,79,2349,387,857,82,203,305,654,167,198,21,222,243,439,60,11,157,134,1023,SG
2013,22,70,993,149,325,24,104,125,221,52,62,21,145,166,122,29,13,53,84,374,PG
2013,34,55,1075,123,330,46,170,77,160,49,70,22,133,155,80,37,14,77,89,341,SF
2013,27,46,457,53,103,0,2,53,101,25,41,52,79,131,6,12,38,18,64,131,C
2013,28,76,2877,765,1354,103,254,662,1100,403,535,97,513,610,551,129,67,226,110,2036,PF
2013,37,45,862,101,271,48,125,53,146,23,29,9,63,72,139,26,3,55,95,273,PG
2013,36,76,1636,267,575,84,233,183,342,94,136,109,253,362,50,30,22,53,124,712,PF
2013,28,78,2578,611,1236,2,17,609,1219,167,217,156,564,720,164,80,89,105,170,1391,C
2013,32,56,568,62,136,14,45,48,91,38,53,5,79,84,31,14,7,23,45,176,SF
2013,31,38,350,16,54,0,2,16,52,12,23,26,34,60,14,6,6,17,58,44,PF
2013,23,47,291,35,83,1,2,34,81,10,18,5,16,21,28,9,1,19,18,81,SG
2013,23,12,150,14,38,0,0,14,38,2,4,3,8,11,16,6,1,2,4,30,PG
2013,21,61,902,131,294,53,138,78,156,59,70,17,77,94,56,12,10,40,37,374,SG
2013,23,80,2897,497,1247,173,461,324,786,230,281,59,187,246,521,125,10,203,155,1397,PG
2013,25,49,892,142,316,25,83,117,233,68,88,68,117,185,43,38,8,42,90,377,PF
2013,25,81,2325,336,606,5,13,331,593,136,187,227,384,611,122,81,110,117,301,813,PF
2013,27,30,284,48,75,0,0,48,75,21,34,20,40,60,8,7,28,13,49,117,C
2013,22,8,102,11,25,6,18,5,7,1,2,5,6,11,2,4,0,3,5,29,SF
2013,28,69,1035,185,356,1,13,184,343,81,131,76,190,266,46,56,14,71,131,452,PF
2013,25,54,878,117,283,2,21,115,262,40,67,49,96,145,58,41,50,68,99,276,SF
2013,31,72,2642,445,1052,148,395,297,657,132,161,53,165,218,253,49,14,123,99,1170,SG
2013,23,51,619,72,180,36,94,36,86,23,32,20,90,110,47,11,9,29,51,203,SG
2013,25,50,953,161,396,50,155,111,241,27,35,21,102,123,34,22,18,48,56,399,SF
2013,23,4,6,0,4,0,1,0,3,0,0,1,3,4,1,0,0,0,0,0,SG
2013,32,78,1016,82,222,11,49,71,173,87,113,24,77,101,48,22,6,38,119,262,SF
2013,32,50,635,50,140,8,37,42,103,66,82,13,57,70,28,10,5,22,73,174,SF
2013,32,28,381,32,82,3,12,29,70,21,31,11,20,31,20,12,1,16,46,88,SF
2013,22,63,803,95,218,9,35,86,183,34,51,17,88,105,16,19,22,30,55,233,SF
2013,24,29,338,40,109,1,9,39,100,35,53,18,27,45,83,14,2,38,29,116,PG
2013,32,38,221,21,61,16,53,5,8,2,4,0,22,22,13,2,6,3,16,60,SF
2013,23,32,334,43,107,0,0,43,107,9,15,38,40,78,10,9,5,8,25,95,PF
2013,21,38,280,39,99,0,2,39,97,10,15,12,50,62,10,5,6,15,23,88,SF
2013,28,2,26,0,1,0,0,0,1,0,0,1,2,3,0,0,1,3,3,0,PF
2013,21,19,276,43,94,5,19,38,75,13,17,28,37,65,15,12,19,13,21,104,PF
2013,24,82,2010,314,488,0,0,314,488,96,249,210,384,594,28,48,112,100,192,724,C
2013,21,28,388,51,110,6,21,45,89,18,21,12,40,52,53,15,4,21,25,126,PG
2013,24,10,54,2,14,0,3,2,11,5,8,1,6,7,1,3,0,2,3,9,SF
2013,24,6,24,2,11,0,2,2,9,3,4,1,4,5,1,0,0,2,2,7,SF
2013,24,4,30,0,3,0,1,0,2,2,4,0,2,2,0,3,0,0,1,2,SF
2013,30,66,1363,313,617,0,1,313,616,67,85,97,275,372,51,29,52,103,141,693,C
2013,20,70,1078,206,379,1,1,205,378,93,117,135,169,304,31,28,32,101,116,506,C
2013,39,76,2043,152,409,114,325,38,84,40,48,50,273,323,249,125,25,76,125,458,SG
2013,19,78,2025,281,613,2,9,279,604,140,187,131,324,455,117,54,70,101,164,704,SF
2013,31,64,2034,284,560,35,120,249,440,188,250,102,260,362,177,96,62,119,82,791,SF
2013,28,20,376,48,144,20,66,28,78,32,38,10,42,52,16,4,2,14,45,148,SF
2013,21,75,2365,357,878,120,327,237,551,165,225,54,193,247,303,58,8,205,157,999,PG
2013,31,74,2259,277,601,189,414,88,187,67,78,23,270,293,146,70,37,70,170,810,SF
2013,23,81,1817,295,508,0,1,295,507,58,104,211,351,562,32,44,103,53,246,648,C
2013,25,25,224,33,46,0,0,33,46,11,37,24,21,45,9,5,9,14,32,77,C
2013,21,47,577,60,163,14,37,46,126,20,34,8,38,46,32,13,0,26,52,154,SG
2013,21,23,280,33,95,4,16,29,79,8,15,3,14,17,20,7,0,16,27,78,SG
2013,21,24,297,27,68,10,21,17,47,12,19,5,24,29,12,6,0,10,25,76,SG
2013,20,23,147,24,68,9,30,15,38,14,14,5,13,18,5,2,2,6,13,71,SF
2013,29,81,1876,325,602,1,3,324,599,223,273,180,303,483,65,35,31,115,190,874,PF
2013,25,73,2513,448,971,85,232,363,739,235,311,36,162,198,501,107,8,182,135,1216,PG
2013,27,78,1941,246,530,58,156,188,374,62,72,31,159,190,143,89,21,84,139,612,SG
2013,29,79,2907,602,1160,0,4,602,1156,255,320,218,668,886,279,67,22,207,246,1459,PF
2013,22,16,289,29,76,8,24,21,52,12,20,15,24,39,20,12,6,10,30,78,SG
2013,21,58,1810,260,526,65,174,195,352,104,126,63,283,346,93,97,32,62,99,689,SF
2013,20,69,1206,151,277,3,7,148,270,72,89,80,175,255,33,11,38,49,168,377,C
2013,23,9,91,10,28,0,3,10,25,2,6,5,8,13,5,2,0,5,11,22,C
2013,23,19,96,15,24,0,0,15,24,4,7,8,16,24,3,4,0,3,10,34,PF
2013,33,55,792,103,249,51,131,52,118,28,45,19,102,121,30,21,14,33,67,285,PF
2013,24,39,290,21,47,7,19,14,28,9,18,13,40,53,15,18,3,14,33,58,SG
2013,22,82,3167,553,1288,185,503,368,785,271,321,42,215,257,531,74,19,243,172,1562,PG
2013,24,82,2640,396,897,87,257,309,640,216,275,32,215,247,497,134,29,236,205,1095,PG
2013,27,66,1455,166,346,0,4,166,342,85,98,31,127,158,215,48,31,76,127,417,PG
2013,27,17,320,24,66,0,3,24,63,15,15,2,35,37,38,11,2,17,22,63,PG
2013,27,49,1135,142,280,0,1,142,279,70,83,29,92,121,177,37,29,59,105,354,PG
2013,24,74,2253,570,1094,0,1,570,1093,297,392,208,304,512,70,33,154,131,152,1437,C
2013,24,82,2136,384,719,0,0,384,719,161,207,226,236,462,64,32,128,110,167,929,C
2013,24,18,618,105,298,20,92,85,206,100,142,64,188,252,42,13,9,39,34,330,PF
2013,26,68,2020,250,623,101,279,149,344,190,239,56,265,321,435,94,24,157,218,791,PG
2013,30,63,827,129,334,57,151,72,183,18,25,8,57,65,105,23,1,26,50,333,PG
2013,22,6,21,3,6,0,1,3,5,2,2,0,1,1,6,2,0,8,0,8,PG
2013,22,7,141,16,40,4,13,12,27,1,2,3,13,16,23,6,0,8,10,37,PG
2013,22,4,7,1,2,0,1,1,1,0,0,0,0,0,1,0,0,2,1,2,SG
2013,22,20,268,41,84,14,35,27,49,8,14,0,24,24,44,9,0,24,28,104,PG
2013,33,18,257,27,76,5,21,22,55,36,48,5,20,25,19,6,2,17,42,95,SF
2013,26,80,1322,149,329,0,2,149,327,104,171,115,196,311,27,39,66,92,201,402,C
2013,34,67,2010,355,690,23,73,332,617,79,101,146,379,525,163,75,47,103,111,812,PF
2013,21,48,702,56,151,23,73,33,78,8,14,4,38,42,143,22,4,57,48,143,PG
2013,28,41,694,96,252,58,146,38,106,20,28,11,89,100,20,19,6,32,58,270,SF
2013,35,18,431,56,93,0,0,56,93,17,40,34,61,95,8,16,17,16,64,129,C
2013,29,77,2136,350,778,158,371,192,407,219,246,31,147,178,106,72,8,101,138,1077,SG
2013,32,69,1219,132,305,66,159,66,146,39,43,11,121,132,74,26,11,51,104,369,SG
2013,26,69,2403,352,808,169,425,183,383,149,187,35,156,191,174,90,18,109,172,1022,SG
2013,29,72,1789,204,457,0,0,204,457,90,145,135,274,409,54,32,95,81,172,498,PF
2013,25,37,391,36,115,15,46,21,69,17,21,5,13,18,73,10,0,31,19,104,PG
2013,25,27,572,70,166,19,50,51,116,28,41,4,24,28,109,12,1,48,36,187,SG
2013,25,82,2913,461,1026,142,349,319,677,191,233,36,255,291,361,93,23,210,195,1255,SG
2013,26,58,1326,151,377,13,37,138,340,72,126,89,167,256,55,42,14,70,82,387,SF
2013,25,79,1433,303,527,1,1,302,526,110,186,158,223,381,24,30,157,90,184,717,C
2013,27,26,387,24,56,0,0,24,56,3,10,19,59,78,20,13,11,12,39,51,SF
2013,27,15,230,15,32,0,0,15,32,2,6,11,37,48,10,5,8,7,26,32,SF
2013,27,9,145,9,21,0,0,9,21,1,2,7,21,28,9,8,3,5,13,19,SF
2013,27,2,12,0,3,0,0,0,3,0,2,1,1,2,1,0,0,0,0,0,SF
2013,25,67,1487,156,343,24,84,132,259,65,85,93,232,325,141,32,27,66,131,401,PF
2013,25,41,685,60,153,17,55,43,98,22,30,41,96,137,70,10,12,28,65,159,PF
2013,25,26,802,96,190,7,29,89,161,43,55,52,136,188,71,22,15,38,66,242,PF
2013,25,78,1663,205,530,122,342,83,188,86,96,37,134,171,69,58,5,52,103,618,SG
2013,22,6,36,3,6,0,0,3,6,1,4,0,3,3,0,2,2,1,7,7,C
2013,21,27,475,62,141,14,45,48,96,27,32,4,46,50,28,15,4,11,53,165,SG
2013,25,65,1364,255,614,126,328,129,286,93,107,24,150,174,63,49,17,69,138,729,SF
2013,27,1,5,0,1,0,0,0,1,0,0,0,1,1,0,0,0,2,1,0,C
2013,36,82,2151,303,632,17,64,286,568,163,194,60,178,238,484,73,11,172,159,786,PG
2013,22,52,694,44,108,22,56,22,52,8,8,8,70,78,44,17,12,23,89,118,SF
2013,32,59,900,100,231,73,175,27,56,8,11,18,139,157,99,21,4,35,63,281,SF
2013,20,7,26,4,12,0,1,4,11,1,2,1,1,2,3,1,0,1,3,9,PF
2013,24,58,656,113,241,52,130,61,111,16,19,9,41,50,62,26,4,39,55,294,PG
2013,27,78,2375,429,875,13,39,416,836,264,356,177,377,554,201,102,80,138,232,1135,PF
2013,35,63,693,66,180,0,2,66,178,34,47,73,122,195,26,21,32,24,97,166,C
2013,22,81,2687,514,1058,0,4,514,1054,270,392,236,541,777,281,105,55,234,190,1298,C
2013,23,75,1682,237,598,67,197,170,401,47,59,48,119,167,206,51,23,105,122,588,SG
2013,22,48,683,73,188,24,66,49,122,24,37,24,33,57,76,21,2,45,58,194,PG
2013,23,54,1154,171,400,74,194,97,206,49,75,63,156,219,47,27,16,53,120,465,PF
2013,23,23,370,51,126,12,39,39,87,17,42,17,41,58,15,18,4,24,40,131,SF
2013,23,82,1837,266,653,45,134,221,519,93,127,131,265,396,108,77,64,104,209,670,PF
2013,27,41,383,64,145,16,43,48,102,20,22,11,19,30,13,13,1,8,43,164,SG
2013,27,24,301,47,111,15,38,32,73,16,18,10,16,26,9,12,1,4,33,125,SG
2013,27,17,82,17,34,1,5,16,29,4,4,1,3,4,4,1,0,4,10,39,SG
2013,22,44,538,97,213,24,83,73,130,32,51,36,57,93,31,7,10,37,73,250,PF
2013,22,47,542,78,134,0,0,78,134,18,28,76,69,145,10,17,10,19,43,174,PF
2013,26,41,366,44,87,0,2,44,85,20,26,50,57,107,9,6,18,25,57,108,C
2013,23,53,1428,217,563,66,208,151,355,64,99,71,266,337,81,34,32,74,110,564,PF
2013,22,17,52,7,28,1,5,6,23,0,0,0,4,4,2,1,0,3,4,15,SG
2013,32,14,256,22,61,11,35,11,26,10,11,7,42,49,7,10,6,7,29,65,PF
2013,38,50,1627,236,475,57,130,179,345,107,116,26,116,142,333,30,5,126,70,636,PG
2013,28,68,1484,246,597,89,251,157,346,64,74,13,130,143,129,30,2,69,93,645,SG
2013,30,56,1977,306,780,121,355,185,425,89,102,23,186,209,413,71,6,154,161,822,PG
2013,23,75,1249,256,486,0,0,256,486,75,94,69,189,258,44,24,32,79,133,587,PF
2013,27,66,2426,303,630,0,5,303,625,178,237,260,473,733,262,78,141,176,185,784,C
2013,29,81,1641,178,430,149,351,29,79,30,33,17,135,152,35,28,8,12,97,535,SF
2013,34,53,1661,343,728,65,157,278,571,166,193,37,326,363,132,38,37,70,93,917,PF
2013,34,55,1029,179,371,0,0,179,371,96,115,82,211,293,42,19,78,73,126,454,C
2013,22,57,638,101,197,0,1,101,196,30,45,65,144,209,52,11,26,37,107,232,C
2013,33,82,1616,146,366,18,90,128,276,20,42,117,363,480,142,69,58,86,214,330,PF
2013,24,3,12,1,3,0,0,1,3,1,1,0,1,1,1,1,0,4,1,3,C
2013,30,79,2052,328,687,0,0,328,687,109,191,199,493,692,93,45,77,107,145,765,C
2013,22,13,104,12,26,0,0,12,26,9,17,13,13,26,4,4,3,4,13,33,C
2013,28,38,444,74,177,14,50,60,127,38,52,17,44,61,21,11,8,19,35,200,SF
2013,28,52,1134,114,241,0,3,114,238,78,103,132,204,336,79,35,12,70,128,306,C
2013,33,32,507,78,212,39,116,39,96,12,13,10,25,35,67,18,3,41,42,207,PG
2013,33,7,102,8,32,3,20,5,12,2,2,0,6,6,14,0,1,8,8,21,PG
2013,33,7,113,13,38,7,20,6,18,2,2,1,6,7,19,3,0,5,8,35,PG
2013,33,18,292,57,142,29,76,28,66,8,9,9,13,22,34,15,2,28,26,151,PG
2013,26,25,447,75,187,18,57,57,130,28,41,7,25,32,64,12,2,37,32,196,PG
2013,26,14,208,24,63,7,17,17,46,14,21,1,16,17,28,1,0,13,14,69,SG
2013,30,66,2174,519,995,24,68,495,927,279,330,18,180,198,499,54,6,170,92,1341,PG
2013,24,76,2758,456,939,152,395,304,544,113,155,79,325,404,269,75,32,147,148,1177,SF
2013,23,71,1775,319,623,51,132,268,491,48,63,113,224,337,81,31,40,61,138,737,PF
2013,23,47,1219,236,455,35,96,201,359,37,49,73,148,221,51,18,27,42,90,544,PF
2013,23,24,556,83,168,16,36,67,132,11,14,40,76,116,30,13,13,19,48,193,PF
2013,27,70,2335,412,856,76,232,336,624,286,323,53,209,262,678,169,10,159,143,1186,PG
2013,29,39,528,42,119,18,60,24,59,1,6,7,49,56,32,24,5,14,59,103,SG
2013,27,62,1959,385,741,0,0,385,741,241,324,230,315,545,53,43,50,101,143,1011,C
2013,28,78,1954,143,313,0,1,143,312,44,72,110,356,466,111,43,83,109,227,330,C
2013,27,31,352,48,110,1,4,47,106,11,12,33,79,112,16,10,9,24,48,108,C
2013,35,77,2575,476,1092,145,382,331,710,333,423,45,442,487,370,84,30,214,210,1430,SF
2013,30,19,386,34,98,20,64,14,34,12,18,5,31,36,9,12,6,16,33,100,SF
2013,24,11,32,4,11,0,0,4,11,0,3,7,5,12,0,0,0,3,8,8,C
2013,24,4,12,3,5,0,0,3,5,0,0,4,3,7,0,0,0,2,4,6,C
2013,24,7,20,1,6,0,0,1,6,0,3,3,2,5,0,0,0,1,4,2,C
2013,24,14,55,5,21,0,0,5,21,3,4,12,10,22,2,0,3,3,5,13,C
2013,24,59,1243,128,299,60,152,68,147,59,75,43,89,132,61,35,6,42,95,375,SF
2013,26,57,1278,161,413,70,200,91,213,49,62,20,94,114,205,33,3,64,73,441,PG
2013,29,39,510,39,120,10,39,29,81,17,24,13,31,44,73,26,3,34,61,105,PG
2013,35,78,1263,100,220,53,134,47,86,22,25,41,102,143,236,69,2,86,127,275,PG
2013,32,82,2631,359,820,38,94,321,726,96,130,72,292,364,196,48,25,89,86,852,SF
2013,32,45,1457,215,484,23,53,192,431,74,93,43,166,209,111,21,13,54,45,527,SF
2013,32,37,1174,144,336,15,41,129,295,22,37,29,126,155,85,27,12,35,41,325,SF
2013,33,12,68,1,4,0,0,1,4,0,2,5,16,21,4,1,2,4,10,2,C
2013,29,7,78,4,16,0,5,4,11,2,2,1,1,2,9,3,0,6,4,10,SG
2013,32,25,144,13,43,5,27,8,16,2,3,10,18,28,8,8,4,7,29,33,PF
2013,23,39,329,56,114,0,8,56,106,31,45,29,66,95,12,19,21,37,41,143,PF
2013,29,16,198,28,48,0,0,28,48,11,27,28,42,70,4,8,7,10,38,67,PF
2013,31,76,2607,471,1024,2,23,469,1001,225,300,310,544,854,108,61,31,150,180,1169,PF
2013,28,78,2379,382,880,165,451,217,429,171,190,17,154,171,296,38,9,138,117,1100,SG
2013,28,50,1575,262,582,117,300,145,282,115,129,9,110,119,220,29,5,105,70,756,SG
2013,28,28,804,120,298,48,151,72,147,56,61,8,44,52,76,9,4,33,47,344,SG
2013,32,33,936,135,336,57,167,78,169,20,33,19,108,127,51,40,15,26,57,347,SG
2013,32,1,29,1,11,1,4,0,7,2,2,5,5,10,1,0,0,2,1,5,SF
2013,31,82,2474,367,811,66,212,301,599,139,164,41,165,206,311,82,15,130,187,939,SG
2013,20,61,1418,145,390,28,86,117,304,59,108,16,93,109,127,26,9,74,122,377,SG
2013,27,78,1324,213,511,59,153,154,358,70,77,17,80,97,219,37,3,71,108,555,PG
2013,28,82,2086,399,921,141,348,258,573,135,169,29,155,184,358,85,10,144,207,1074,PG
2013,21,70,1056,138,321,0,1,138,320,57,109,122,193,315,46,41,26,88,124,333,PF
2013,21,51,809,103,243,0,0,103,243,41,71,92,146,238,36,25,21,65,95,247,PF
2013,21,19,247,35,78,0,1,35,77,16,38,30,47,77,10,16,5,23,29,86,PF
2013,26,38,1423,225,465,12,50,213,415,60,93,43,169,212,420,70,9,148,96,522,PG
2013,21,73,1239,186,457,65,196,121,261,30,42,35,109,144,53,43,14,48,122,467,SG
2013,28,5,122,11,35,0,9,11,26,7,10,3,11,14,23,3,0,7,5,29,SG
2013,22,57,1691,185,514,27,92,158,422,211,264,44,185,229,418,137,5,172,143,608,PG
2013,27,2,25,6,9,0,2,6,7,2,3,0,1,1,2,0,0,3,5,14,SF
2013,23,32,203,18,48,0,0,18,48,7,11,9,25,34,6,0,10,10,38,43,C
2013,33,76,2278,244,612,99,267,145,345,85,110,33,174,207,226,51,25,85,143,672,SF
2013,24,18,196,22,60,0,1,22,59,14,24,10,18,28,8,3,3,6,30,58,C
2013,24,71,1937,306,605,0,2,306,603,84,136,224,448,672,83,53,201,87,233,696,C
2013,32,82,2184,432,915,3,16,429,899,181,230,158,383,541,182,67,35,126,257,1048,PF
2013,24,40,376,70,147,0,1,70,146,43,56,39,71,110,12,4,2,21,32,183,PF
2013,28,81,2229,224,466,108,258,116,208,57,69,58,259,317,125,103,44,64,177,613,SG
2013,21,10,59,6,22,1,6,5,16,7,11,0,5,5,4,2,0,7,7,20,PG
2013,23,79,1721,330,716,0,0,330,716,61,88,107,239,346,57,24,59,130,211,721,C
2013,26,61,1652,276,676,33,107,243,569,291,347,27,142,169,230,48,7,104,91,876,SG
2013,21,19,93,10,23,1,2,9,21,9,16,9,14,23,3,3,1,11,11,30,SF
2013,22,45,996,109,275,51,127,58,148,36,47,31,105,136,75,43,7,37,99,305,SG
2013,24,77,1840,236,635,85,288,151,347,108,150,41,134,175,286,54,27,147,117,665,SG
2013,22,2,5,2,3,0,0,2,3,0,0,2,0,2,0,0,0,1,1,4,C
2013,24,82,2293,275,642,70,200,205,442,100,124,109,221,330,77,57,37,98,217,720,SF
2013,23,57,924,92,241,7,36,85,205,40,70,51,133,184,37,38,24,45,124,231,PF
2013,25,20,257,27,78,7,19,20,59,20,25,3,25,28,37,5,0,13,17,81,SG
2013,22,70,1110,170,274,0,1,170,273,81,130,111,210,321,25,18,40,41,175,421,C
2013,24,52,516,56,159,8,27,48,132,3,7,12,49,61,87,21,9,37,26,123,PG
2013,24,36,378,39,116,4,17,35,99,3,7,11,35,46,57,13,6,27,14,85,PG
2013,24,16,138,17,43,4,10,13,33,0,0,1,14,15,30,8,3,10,12,38,PG
2013,27,80,2678,527,1249,155,436,372,813,237,311,64,361,425,218,100,24,134,226,1446,SG
2013,26,51,876,167,341,0,4,167,337,86,102,64,122,186,34,15,45,55,123,420,C
2013,27,76,2683,550,1182,61,201,489,981,166,321,133,506,639,321,94,136,226,175,1327,PF
2013,24,40,288,42,114,6,28,36,86,20,28,7,20,27,35,7,1,29,26,110,PG
2013,25,79,1300,260,584,3,10,257,574,135,175,146,240,386,47,24,53,80,175,658,C
2013,25,40,579,106,247,2,5,104,242,48,67,76,113,189,18,10,27,35,86,262,C
2013,25,39,721,154,337,1,5,153,332,87,108,70,127,197,29,14,26,45,89,396,C
2013,28,81,1997,315,563,0,2,315,561,208,285,144,371,515,130,63,64,100,161,838,PF
2013,38,37,544,66,172,30,89,36,83,20,23,5,28,33,35,7,4,24,31,182,SF
2013,22,78,2278,275,598,62,188,213,410,75,115,47,257,304,223,81,16,109,162,687,SG
2013,31,56,1158,98,262,76,209,22,53,12,23,18,104,122,52,29,6,23,69,284,SG
2013,27,76,1209,127,278,0,0,127,278,53,69,61,200,261,30,44,90,59,184,307,C
2013,24,4,28,2,2,0,0,2,2,3,4,2,1,3,2,1,0,2,4,7,PG
2013,30,29,682,154,267,0,0,154,267,105,130,60,85,145,13,10,21,50,89,413,PF
2013,26,76,2171,304,748,55,182,249,566,213,272,43,169,212,270,51,17,134,127,876,SG
2013,20,45,892,111,225,1,5,110,220,47,63,92,172,264,35,22,22,29,154,270,PF
2013,25,2,7,1,4,0,0,1,4,0,0,0,2,2,1,0,0,0,0,2,PF
2013,23,77,1507,172,399,53,154,119,245,75,103,51,99,150,63,47,15,48,136,472,SF
2013,22,38,221,32,87,6,13,26,74,15,27,2,16,18,21,13,0,25,25,85,PG
2013,24,80,2628,439,974,89,248,350,726,199,226,25,155,180,579,117,28,230,181,1166,PG
2013,19,48,392,43,113,4,23,39,90,9,16,3,41,44,63,9,7,35,47,99,PG
2013,27,53,499,71,185,37,108,34,77,9,11,33,62,95,23,13,8,20,53,188,PF
2013,27,59,980,112,309,53,150,59,159,54,69,13,71,84,153,37,11,64,104,331,PG
2013,27,46,795,94,247,43,113,51,134,44,57,12,56,68,114,28,10,53,84,275,PG
2013,27,13,185,18,62,10,37,8,25,10,12,1,15,16,39,9,1,11,20,56,PG
2013,26,51,1156,105,258,26,80,79,178,26,37,29,94,123,115,50,17,61,94,262,SG
2013,35,79,2124,281,648,123,331,158,317,114,131,19,140,159,198,66,11,102,110,799,SG
2013,25,66,770,64,106,0,0,64,106,32,53,69,126,195,11,30,60,41,148,160,C
2013,23,79,2122,366,832,115,321,251,511,253,287,29,132,161,316,67,3,140,167,1100,PG
2013,40,39,392,45,83,1,1,44,82,6,13,24,65,89,21,10,16,8,52,97,PF
2013,24,59,646,53,106,0,0,53,106,43,59,44,71,115,17,11,7,14,78,149,SF
2013,24,12,57,5,10,0,0,5,10,5,8,5,11,16,4,2,2,3,8,15,PF
2013,24,5,21,0,1,0,0,0,1,3,4,0,5,5,2,0,1,1,1,3,PF
2013,24,7,36,5,9,0,0,5,9,2,4,5,6,11,2,2,1,2,7,12,PF
2013,26,26,360,48,136,3,8,45,128,26,31,16,44,60,19,14,15,17,51,125,PF
2013,26,82,2285,374,745,0,3,374,742,143,206,172,377,549,84,48,61,101,227,891,PF
2013,22,82,2936,508,1205,211,526,297,679,132,157,32,274,306,183,86,45,157,237,1359,SG
2013,21,82,2564,390,799,0,3,390,796,177,291,306,467,773,108,60,71,123,234,957,PF
2013,25,72,1726,332,774,141,379,191,395,111,126,50,131,181,91,61,4,68,105,916,SG
2013,34,66,1221,86,234,39,127,47,107,18,26,17,98,115,290,64,14,106,106,229,PG
2013,27,62,963,82,216,45,133,37,83,44,51,31,124,155,32,15,12,36,66,253,SF
2013,27,79,1910,210,444,22,70,188,374,64,86,132,218,350,109,62,19,67,145,506,SG
2013,30,65,701,49,97,0,0,49,97,23,63,45,107,152,35,19,35,29,80,121,C
2013,33,11,189,14,53,1,24,13,29,3,6,4,22,26,23,7,1,12,11,32,SF
2013,24,82,2892,441,1053,58,159,383,894,154,208,56,461,517,354,71,17,187,197,1094,SF
2013,21,21,68,9,24,0,0,9,24,4,6,6,14,20,1,1,2,6,10,22,C
2013,21,20,63,9,24,0,0,9,24,4,6,6,11,17,1,1,2,6,10,22,C
2013,25,76,1312,117,269,0,1,117,268,89,119,113,138,251,43,39,85,43,139,323,C
2013,30,39,719,113,238,13,49,100,189,24,33,17,61,78,138,16,2,53,39,263,SG
2013,30,27,738,97,238,21,53,76,185,60,70,17,46,63,164,25,1,55,51,275,PG
2013,20,62,1482,204,366,0,0,204,366,146,185,121,251,372,45,17,78,94,188,554,C
2013,30,25,901,138,289,0,5,138,284,77,102,138,223,361,84,37,14,44,68,353,C
2013,24,13,58,3,7,0,0,3,7,2,4,2,7,9,3,1,2,6,10,8,PF
2013,24,5,18,2,4,0,0,2,4,2,4,1,2,3,1,1,0,1,1,6,PF
2013,24,8,40,1,3,0,0,1,3,0,0,1,5,6,2,0,2,5,9,2,PF
2013,26,78,2685,438,1012,83,243,355,769,124,154,43,294,337,704,66,6,247,190,1083,PG
2013,22,51,601,57,114,0,1,57,113,12,39,43,79,122,28,15,17,27,107,126,PF
2013,28,69,1092,175,464,90,259,85,205,27,49,49,192,241,54,31,39,39,96,467,PF
2013,22,77,2559,461,889,0,3,461,886,86,126,273,644,917,143,61,79,141,218,1008,C
2013,31,69,2391,569,1093,17,66,552,1027,308,425,86,258,344,352,128,56,194,140,1463,SG
2013,21,61,1756,336,815,63,203,273,612,159,213,22,127,149,183,59,16,121,113,894,SG
2013,22,82,2859,526,1244,107,332,419,912,296,371,60,223,283,471,160,31,200,153,1455,PG
2013,22,49,1602,324,735,12,45,312,690,246,306,35,161,196,373,65,37,157,117,906,PG
2013,30,69,2076,182,458,46,163,136,295,121,190,69,250,319,181,97,46,110,118,531,SF
2013,38,21,296,55,142,22,69,33,73,14,20,11,72,83,6,13,15,10,40,146,C
2013,32,50,857,71,181,20,67,51,114,10,20,38,107,145,166,42,13,60,98,172,PF
2013,30,28,489,67,165,0,3,67,162,60,88,21,68,89,25,13,6,29,37,194,PF
2013,30,1,7,1,2,0,0,1,2,2,2,0,0,0,0,1,0,0,0,4,PF
2013,30,27,482,66,163,0,3,66,160,58,86,21,68,89,25,12,6,29,37,190,PF
2013,28,80,1521,192,459,88,214,104,245,71,91,38,107,145,161,66,12,69,123,543,PG
2013,33,48,829,37,120,5,28,32,92,17,25,23,64,87,190,40,8,69,94,96,PG
2013,21,27,202,26,88,7,31,19,57,17,19,1,6,7,27,6,0,15,26,76,PG
2013,21,21,165,19,72,5,25,14,47,13,15,1,4,5,20,3,0,13,18,56,PG
2013,21,6,37,7,16,2,6,5,10,4,4,0,2,2,7,3,0,2,8,20,PG
2013,26,76,2200,281,636,139,329,142,307,168,198,53,241,294,143,49,17,90,166,869,SF
2013,32,73,2435,502,1009,4,19,498,990,242,315,145,418,563,213,74,69,157,149,1250,PF
2013,24,82,2861,673,1535,97,300,576,1235,460,575,111,317,428,607,145,24,273,189,1903,PG
2013,26,12,86,12,23,0,0,12,23,5,9,4,9,13,4,1,6,2,5,29,PF
2013,30,57,435,50,116,14,41,36,75,11,19,5,43,48,29,13,4,17,44,125,SF
2013,30,61,830,110,153,0,1,110,152,39,58,55,125,180,22,32,28,34,125,259,C
2013,33,61,1095,145,316,17,51,128,265,81,109,32,73,105,91,37,18,49,98,388,SG
2013,28,78,2842,495,1124,169,447,326,677,317,369,29,203,232,604,75,30,218,194,1476,PG
2013,21,78,1916,338,786,65,196,273,590,192,272,96,334,430,46,44,37,101,127,933,PF
2013,26,39,1119,187,443,72,196,115,247,105,121,8,72,80,139,44,10,74,55,551,SG
2013,26,73,1727,199,470,54,166,145,304,77,99,55,208,263,77,37,38,60,98,529,SF
2013,30,46,1418,229,533,59,154,170,379,75,85,24,86,110,285,46,9,125,105,592,PG
2013,26,40,380,57,132,22,72,35,60,10,21,8,43,51,39,12,1,19,19,146,SF
2013,25,24,318,48,97,5,15,43,82,9,21,4,40,44,38,11,2,22,13,110,SF
2013,33,75,2530,332,824,141,412,191,412,124,169,101,271,372,112,122,42,98,198,929,SF
2013,25,64,1149,241,404,0,3,241,401,59,96,85,175,260,38,26,76,34,78,541,C
2013,23,3,4,1,2,0,0,1,2,0,0,0,0,0,0,0,0,1,0,2,SG
2013,27,79,1783,237,599,135,361,102,238,120,141,42,260,302,150,62,35,64,98,729,SF
2013,19,35,272,33,86,4,16,29,70,21,29,13,15,28,43,8,4,29,34,91,SG
2013,27,59,1411,224,542,75,210,149,332,105,128,24,106,130,84,36,14,50,84,628,SG
2013,27,56,693,58,148,16,52,42,96,23,43,26,97,123,42,15,8,33,62,155,SG
2013,24,76,2629,509,958,1,8,508,950,108,188,182,389,571,125,133,55,90,191,1127,PF
2013,25,16,58,9,26,1,5,8,21,0,0,1,9,10,3,0,0,0,5,19,C
2013,23,77,2033,245,559,0,4,245,555,120,157,159,279,438,96,35,70,95,251,610,C
2014,23,63,847,66,141,4,15,62,126,35,53,72,144,216,28,23,26,30,122,171,SF
2014,23,7,61,6,14,2,5,4,9,5,8,5,10,15,4,4,3,2,8,19,SF
2014,23,56,786,60,127,2,10,58,117,30,45,67,134,201,24,19,23,28,114,152,SF
2014,20,81,1197,93,185,0,0,93,185,79,136,142,190,332,43,40,57,71,203,265,C
2014,27,53,961,143,275,0,0,143,275,76,119,102,204,306,38,24,36,39,108,362,PF
2014,27,25,256,22,40,0,0,22,40,13,25,33,55,88,7,7,15,8,35,57,PF
2014,27,28,705,121,235,0,0,121,235,63,94,69,149,218,31,17,21,31,73,305,PF
2014,28,73,2552,464,1011,128,300,336,711,274,336,32,230,262,248,35,3,146,136,1330,SG
2014,25,56,951,136,249,0,1,136,248,56,67,94,183,277,40,23,46,63,187,328,C
2014,25,46,330,33,61,0,0,33,61,26,30,37,92,129,14,8,30,18,40,92,C
2014,28,69,2498,652,1423,3,15,649,1408,296,360,166,599,765,178,63,68,123,147,1603,PF
2014,24,65,1072,134,300,2,13,132,287,33,50,119,192,311,71,24,33,44,126,303,PF
2014,24,51,960,117,266,2,13,115,253,27,40,106,171,277,65,22,27,40,115,263,PF
2014,24,14,112,17,34,0,0,17,34,6,10,13,21,34,6,2,6,4,11,40,PF
2014,38,73,1936,240,543,116,309,124,234,105,116,23,182,205,143,54,8,84,115,701,SG
2014,32,55,1278,204,413,11,47,193,366,76,121,79,129,208,94,90,19,90,121,495,SG
2014,23,80,2045,234,494,13,48,221,446,91,137,129,367,496,114,82,38,88,147,572,SF
2014,31,19,185,16,32,0,0,16,32,6,24,28,27,55,6,9,11,14,49,38,PF
2014,31,18,184,16,32,0,0,16,32,6,24,28,27,55,6,9,11,14,49,38,PF
2014,35,72,1396,177,275,3,12,174,263,120,169,129,250,379,19,32,97,53,162,477,C
2014,31,78,1773,194,485,84,248,110,237,92,118,40,135,175,81,48,11,62,147,564,SF
2014,24,80,2309,309,717,115,351,194,366,77,106,59,241,300,149,74,28,106,154,810,SG
2014,25,22,795,155,354,67,164,88,190,59,62,66,76,142,17,10,7,20,47,436,PF
2014,19,77,1897,173,418,41,118,132,300,138,202,78,261,339,150,60,61,122,173,525,SF
2014,29,77,2982,743,1643,167,415,576,1228,459,541,145,477,622,242,95,51,198,224,2112,PF
2014,31,33,186,12,32,0,0,12,32,4,8,15,23,38,2,3,12,3,17,28,C
2014,31,12,37,2,6,0,0,2,6,2,2,2,5,7,0,0,4,1,4,6,C
2014,31,21,149,10,26,0,0,10,26,2,6,13,18,31,2,3,8,2,13,22,C
2014,31,50,925,123,294,56,171,67,123,50,66,57,152,209,58,19,12,55,126,352,C
2014,28,77,2723,389,853,180,442,209,411,149,193,99,376,475,191,126,20,132,179,1107,SF
2014,29,15,97,9,19,0,0,9,19,7,16,19,28,47,5,4,4,6,11,25,C
2014,25,68,1161,162,410,24,64,138,346,53,62,52,158,210,61,39,47,58,185,401,SF
2014,27,48,968,101,190,0,0,101,190,78,126,101,277,378,25,14,37,59,92,280,C
2014,26,71,1939,298,718,133,332,165,386,201,227,15,115,130,313,53,3,125,147,930,PG
2014,26,10,82,7,24,1,11,6,13,6,6,0,4,4,10,1,0,9,7,21,PG
2014,26,61,1857,291,694,132,321,159,373,195,221,15,111,126,303,52,3,116,140,909,PG
2014,28,26,429,52,102,0,0,52,102,8,20,42,83,125,28,25,10,29,47,112,C
2014,26,73,952,101,174,0,0,101,174,38,55,89,169,258,60,13,25,63,146,240,PF
2014,23,14,132,8,30,6,27,2,3,0,0,4,13,17,3,6,0,3,13,22,SG
2014,24,27,473,60,154,36,95,24,59,14,18,18,70,88,29,7,11,15,52,170,PF
2014,31,20,368,56,131,7,25,49,106,31,39,5,32,37,32,7,4,19,30,150,PG
2014,29,79,1471,254,656,73,231,181,425,79,100,16,138,154,303,26,0,125,129,660,PG
2014,28,42,1257,222,502,30,108,192,394,84,102,69,153,222,45,14,52,58,100,558,C
2014,21,78,2204,271,679,66,190,205,489,130,181,66,245,311,116,65,20,84,158,738,SF
2014,33,63,1735,231,527,97,283,134,244,66,90,60,232,292,125,56,28,85,185,625,SF
2014,23,41,387,65,156,10,33,55,123,26,32,16,58,74,33,9,7,18,31,166,SG
2014,28,82,2266,352,725,2,6,350,719,205,239,161,309,470,87,36,71,102,190,911,PF
2014,35,73,1468,105,275,73,210,32,65,15,23,34,104,138,63,50,39,21,124,298,SF
2014,25,82,2956,381,819,145,402,236,417,163,203,116,495,611,420,75,57,208,156,1070,SF
2014,25,72,1686,248,617,76,212,172,405,94,118,22,123,145,194,60,9,82,161,666,PG
2014,25,31,650,90,239,25,83,65,156,45,57,8,51,59,66,20,5,22,72,250,PG
2014,25,41,1036,158,378,51,129,107,249,49,61,14,72,86,128,40,4,60,89,416,PG
2014,27,53,491,71,163,0,0,71,163,19,21,57,88,145,34,2,5,36,77,161,C
2014,24,67,911,147,343,43,128,104,215,66,109,10,107,117,91,43,13,79,102,403,SG
2014,24,44,268,36,97,10,39,26,58,19,36,5,35,40,20,12,6,28,42,101,SG
2014,24,23,643,111,246,33,89,78,157,47,73,5,72,77,71,31,7,51,60,302,SG
2014,20,73,2530,481,1149,138,343,343,806,149,189,54,219,273,243,71,18,128,153,1249,SG
2014,25,55,831,177,355,21,54,156,301,61,79,31,141,172,42,23,21,57,93,436,SF
2014,27,80,2016,337,695,126,293,211,402,111,131,18,208,226,179,50,7,95,130,911,SF
2014,20,52,663,80,225,13,53,67,172,44,69,49,106,155,17,21,8,47,93,217,PF
2014,25,56,1751,199,481,92,255,107,226,83,102,72,124,196,151,77,23,66,174,573,PG
2014,27,6,45,1,1,0,0,1,1,1,6,2,15,17,0,0,0,2,6,3,C
2014,37,19,309,24,79,14,48,10,31,10,12,4,24,28,42,8,1,25,25,72,SG
2014,21,77,1072,88,144,0,0,88,144,46,89,105,261,366,8,7,86,40,124,222,C
2014,24,78,1214,210,393,0,2,210,391,77,121,139,229,368,70,60,21,77,192,497,PF
2014,33,55,1498,133,353,79,210,54,143,33,43,13,146,159,307,54,8,102,85,378,PG
2014,33,27,891,88,233,52,131,36,102,28,35,8,95,103,205,34,2,71,49,256,PG
2014,33,28,607,45,120,27,79,18,41,5,8,5,51,56,102,20,6,31,36,122,PG
2014,27,73,1618,321,674,15,54,306,620,164,221,120,270,390,112,75,38,110,166,821,PF
2014,24,43,1416,265,556,50,140,215,416,183,237,27,175,202,235,69,14,143,99,763,PG
2014,21,3,15,2,4,0,1,2,3,1,5,0,3,3,1,0,0,2,1,5,SG
2014,29,67,1769,235,375,0,0,235,375,22,64,182,489,671,112,47,121,97,210,492,C
2014,33,61,690,73,164,42,98,31,66,9,12,16,114,130,31,15,11,16,49,197,PF
2014,26,72,1553,222,403,0,2,222,401,47,76,149,230,379,64,41,45,58,131,491,PF
2014,32,76,2141,447,980,0,2,447,978,148,193,137,495,632,118,53,22,154,216,1042,PF
2014,29,79,2531,492,953,74,218,418,735,223,272,98,424,522,87,80,78,125,192,1281,C
2014,23,60,1855,361,825,79,200,282,625,90,112,48,178,226,85,63,11,96,145,891,PG
2014,34,73,1414,179,332,0,2,179,330,61,94,97,264,361,74,40,88,60,192,419,C
2014,27,81,2609,388,807,59,211,329,596,163,227,63,144,207,135,151,30,105,210,998,SF
2014,28,24,160,3,15,1,8,2,7,0,2,2,12,14,10,6,1,2,4,7,SF
2014,28,23,158,3,15,1,8,2,7,0,2,2,12,14,10,6,1,2,4,7,SF
2014,29,72,1557,233,581,96,248,137,333,83,95,43,97,140,233,52,13,117,146,645,PG
2014,29,43,716,104,263,54,132,50,131,37,44,23,39,62,83,25,6,51,76,299,PG
2014,29,29,841,129,318,42,116,87,202,46,51,20,58,78,150,27,7,66,70,346,PG
2014,25,35,316,57,125,13,25,44,100,32,44,10,44,54,25,14,4,24,21,159,SG
2014,25,10,73,9,24,2,4,7,20,11,14,1,18,19,4,1,1,7,5,31,SG
2014,25,7,15,5,13,0,2,5,11,3,4,1,4,5,0,1,0,0,0,13,SG
2014,25,18,228,43,88,11,19,32,69,18,26,8,22,30,21,12,3,17,16,115,SG
2014,23,26,224,26,86,3,30,23,56,9,13,8,20,28,41,13,3,16,19,64,PG
2014,28,29,251,24,66,0,2,24,64,15,21,7,21,28,9,13,0,18,24,63,SG
2014,28,10,103,8,28,0,2,8,26,7,9,1,12,13,5,1,0,8,12,23,SG
2014,28,19,148,16,38,0,0,16,38,8,12,6,9,15,4,12,0,10,12,40,SG
2014,35,6,177,31,73,3,16,28,57,18,21,2,24,26,38,7,1,34,9,83,SG
2014,25,41,751,100,254,42,120,58,134,32,39,19,84,103,31,19,2,24,58,274,SF
2014,22,43,395,43,121,22,73,21,48,7,9,11,43,54,12,9,1,13,26,115,SF
2014,21,70,2262,341,897,111,336,230,561,102,113,37,171,208,396,42,6,131,145,895,PG
2014,22,78,2193,380,831,50,143,330,688,279,373,59,198,257,212,69,14,149,190,1089,SG
2014,33,56,1419,213,540,98,249,115,291,63,75,21,208,229,82,47,17,60,120,587,SF
2014,33,34,821,137,354,53,147,84,207,47,56,16,142,158,56,23,11,52,64,374,SF
2014,33,22,598,76,186,45,102,31,84,16,19,5,66,71,26,24,6,8,56,213,SF
2014,24,67,2591,275,693,68,240,207,453,260,338,87,243,330,175,127,36,102,106,878,SG
2014,34,50,378,51,110,26,62,25,48,8,14,6,35,41,17,7,9,11,30,136,SG
2014,24,14,146,15,48,5,17,10,31,8,9,4,19,23,10,8,0,10,11,43,PG
2014,26,26,516,94,225,0,0,94,225,37,49,53,92,145,29,6,29,34,31,225,C
2014,26,24,480,85,203,0,0,85,203,32,42,47,79,126,27,6,28,30,28,202,C
2014,26,2,36,9,22,0,0,9,22,5,7,6,13,19,2,0,1,4,3,23,C
2014,31,56,1054,184,430,20,62,164,368,97,121,24,75,99,216,39,7,103,121,485,PG
2014,24,71,1173,142,311,19,61,123,250,44,72,23,114,137,207,66,8,101,117,347,SG
2014,32,81,2468,341,748,191,425,150,323,52,63,29,163,192,377,69,11,103,136,925,PG
2014,20,80,1583,182,460,59,185,123,275,47,61,38,118,156,55,75,12,28,145,470,SG
2014,22,22,252,31,87,18,55,13,32,21,29,7,17,24,22,8,4,21,25,101,PG
2014,27,73,2341,302,642,97,268,205,374,109,141,107,296,403,134,108,21,79,188,810,SF
2014,37,81,1973,330,811,146,371,184,440,161,196,67,217,284,212,61,35,108,209,967,SG
2014,22,70,2414,427,1054,55,208,372,846,258,367,101,336,437,441,130,43,247,213,1167,PG
2014,25,71,1283,173,410,61,176,112,234,83,122,55,205,260,88,44,14,72,100,490,PF
2014,27,73,2178,254,560,87,226,167,334,121,163,41,173,214,357,119,16,162,210,716,PG
2014,31,55,1662,191,322,0,1,191,321,98,155,159,370,529,59,36,63,71,145,480,C
2014,26,62,1927,307,738,122,351,185,387,110,152,58,236,294,114,46,31,79,193,846,SF
2014,27,31,198,22,62,9,31,13,31,18,24,13,25,38,8,2,3,6,19,71,SF
2014,26,54,768,97,261,41,122,56,139,22,34,22,121,143,18,17,25,31,67,257,PF
2014,26,45,698,90,240,40,116,50,124,14,24,20,107,127,16,16,19,30,61,234,PF
2014,26,9,70,7,21,1,6,6,15,8,10,2,14,16,2,1,6,1,6,23,PF
2014,22,23,172,26,67,11,31,15,36,5,7,3,16,19,15,8,2,14,24,68,SG
2014,25,21,184,17,42,3,18,14,24,10,11,9,30,39,12,3,3,11,16,47,SF
2014,25,82,2014,207,500,60,174,147,326,53,68,17,143,160,248,77,5,127,156,527,PG
2014,35,22,172,11,24,0,3,11,21,3,4,7,12,19,4,8,1,7,30,25,C
2014,26,80,2069,324,694,71,189,253,505,192,224,47,141,188,297,93,15,132,150,911,PG
2014,33,81,1353,134,241,4,17,130,224,66,93,116,177,293,104,30,28,71,187,338,PF
2014,26,73,2446,463,1030,105,291,358,739,225,276,41,172,213,441,110,13,150,141,1256,PG
2014,29,41,265,55,117,33,79,22,38,10,14,7,25,32,18,3,7,14,38,153,SF
2014,23,71,2298,591,1191,0,7,591,1184,432,595,218,613,831,207,109,91,251,270,1614,C
2014,23,7,34,6,14,4,11,2,3,0,0,2,3,5,0,2,0,1,3,16,SF
2014,21,15,100,12,33,6,14,6,19,3,4,1,8,9,6,2,1,3,10,33,SG
2014,33,69,2094,421,1011,161,446,260,565,279,322,34,124,158,223,59,12,135,120,1282,SG
2014,25,81,1859,327,788,90,285,237,503,146,169,28,155,183,281,47,5,134,120,890,SG
2014,25,39,1198,188,455,50,157,138,298,110,126,18,102,120,224,34,3,84,76,536,SG
2014,25,42,661,139,333,40,128,99,205,36,43,10,53,63,57,13,2,50,44,354,SG
2014,23,78,1254,130,296,50,151,80,145,46,61,46,148,194,60,59,21,41,100,356,SF
2014,26,81,1635,236,509,0,5,236,504,38,67,112,218,330,83,62,58,42,146,510,PF
2014,22,13,80,6,21,1,7,5,14,13,16,1,5,6,8,3,0,2,16,26,SG
2014,22,5,22,1,2,0,1,1,1,0,2,0,1,1,3,0,0,2,3,2,SG
2014,22,8,58,5,19,1,6,4,13,13,14,1,4,5,5,3,0,0,13,24,SG
2014,23,2,13,1,3,1,1,0,2,0,0,0,1,1,0,2,0,0,0,3,PG
2014,23,1,9,1,3,1,1,0,2,0,0,0,1,1,0,2,0,0,0,3,PG
2014,25,78,2846,652,1383,261,615,391,768,308,348,46,288,334,666,128,14,294,194,1873,PG
2014,32,80,1614,214,377,0,1,214,376,101,137,200,341,541,38,41,94,90,210,529,C
2014,22,5,75,15,31,12,25,3,6,0,0,0,4,4,5,0,0,3,6,42,SG
2014,26,34,238,34,97,7,39,27,58,8,10,14,32,46,11,6,1,11,20,83,SF
2014,22,51,575,54,128,2,10,52,118,34,53,38,71,109,28,24,8,35,92,144,PF
2014,20,67,2358,522,1005,2,9,520,996,348,440,207,466,673,105,89,189,109,200,1394,PF
2014,24,63,956,155,290,0,0,155,290,47,89,92,168,260,27,17,43,40,114,357,PF
2014,28,68,1662,271,593,4,11,267,582,95,137,108,243,351,77,58,29,76,159,641,PF
2014,28,45,1354,232,512,4,10,228,502,77,114,87,195,282,70,46,22,59,111,545,PF
2014,28,23,308,39,81,0,1,39,80,18,23,21,48,69,7,12,7,17,48,96,PF
2014,25,22,148,24,68,12,37,12,31,6,10,5,22,27,8,4,4,5,18,66,SF
2014,25,8,33,3,13,0,8,3,5,2,3,2,5,7,2,0,0,0,4,8,SF
2014,25,14,115,21,55,12,29,9,26,4,7,3,17,20,6,4,4,5,14,58,SF
2014,26,47,494,64,153,18,53,46,100,31,35,14,59,73,65,22,6,35,48,177,SF
2014,26,26,301,42,93,10,31,32,62,18,22,6,39,45,32,15,3,21,25,112,SF
2014,26,21,193,22,60,8,22,14,38,13,13,8,20,28,33,7,3,14,23,65,SF
2014,24,31,390,38,83,0,0,38,83,21,32,38,89,127,5,7,22,18,66,97,C
2014,24,4,6,0,1,0,0,0,1,1,2,0,0,0,0,0,0,0,1,1,C
2014,24,11,150,15,29,0,0,15,29,7,13,11,38,49,3,0,9,9,28,37,C
2014,24,16,234,23,53,0,0,23,53,13,17,27,51,78,2,7,13,9,37,59,C
2014,23,72,1271,122,296,57,155,65,141,38,48,29,94,123,187,33,5,60,121,339,SG
2014,28,63,2213,371,860,57,189,314,671,212,268,99,262,361,183,62,9,114,111,1011,SF
2014,28,23,860,160,354,17,62,143,292,101,124,40,118,158,85,24,4,59,53,438,SF
2014,28,40,1353,211,506,40,127,171,379,111,144,59,144,203,98,38,5,55,58,573,SF
2014,24,79,3017,604,1407,64,210,540,1197,519,630,51,292,343,313,86,28,176,197,1791,SG
2014,31,79,1974,302,580,45,112,257,468,68,92,74,252,326,222,44,32,121,140,717,PF
2014,24,60,818,113,227,1,1,112,226,59,93,103,197,300,39,30,50,54,108,286,C
2014,27,51,675,73,190,31,102,42,88,25,34,18,69,87,68,19,5,34,81,202,PG
2014,27,24,265,32,86,19,59,13,27,5,8,4,22,26,19,6,2,16,34,88,PG
2014,27,27,410,41,104,12,43,29,61,20,26,14,47,61,49,13,3,18,47,114,PG
2014,27,49,1016,111,252,51,132,60,120,66,82,16,103,119,51,29,16,36,61,339,SF
2014,27,76,2668,552,1093,122,299,430,794,316,416,69,176,245,447,104,22,213,206,1542,SG
2014,20,81,2619,479,769,0,2,479,767,137,328,440,631,1071,35,101,131,110,273,1095,C
2014,28,74,1729,196,447,81,225,115,222,38,58,36,124,160,104,41,10,56,146,511,SF
2014,37,74,2158,444,906,0,5,444,901,231,316,158,563,721,220,43,139,159,134,1119,C
2014,33,82,2584,333,774,123,324,210,450,140,164,46,299,345,186,64,46,108,163,929,SF
2014,25,81,3122,849,1688,192,491,657,1197,703,805,58,540,598,445,103,59,285,174,2593,SF
2014,26,2,12,1,3,0,0,1,3,0,0,1,1,2,0,0,0,1,1,2,SF
2014,26,45,393,55,126,25,59,30,67,10,11,8,35,43,19,16,2,11,33,145,SG
2014,28,82,3023,576,1278,69,209,507,1069,339,430,38,257,295,471,141,23,264,197,1560,SG
2014,35,2,27,3,6,0,0,3,6,0,0,0,1,1,0,0,1,0,5,6,C
2014,26,66,1209,175,332,0,2,175,330,51,75,120,190,310,44,42,46,40,139,401,SF
2014,33,54,899,71,150,0,0,71,150,72,130,115,219,334,21,37,3,58,119,214,PF
2014,33,30,399,23,59,0,0,23,59,35,65,53,96,149,5,13,2,28,54,81,PF
2014,33,24,500,48,91,0,0,48,91,37,65,62,123,185,16,24,1,30,65,133,PF
2014,24,72,2028,391,897,21,95,370,802,239,310,76,265,341,363,84,21,175,155,1042,SF
2014,24,80,2178,447,820,0,3,447,817,202,311,238,446,684,96,70,69,135,193,1096,PF
2014,27,41,912,151,364,70,160,81,204,44,59,20,84,104,199,38,8,95,65,416,PG
2014,25,37,488,64,147,12,40,52,107,24,37,42,86,128,16,14,27,41,74,164,C
2014,22,73,2201,390,747,0,1,390,746,190,284,199,438,637,91,75,108,129,236,970,PF
2014,23,7,38,7,14,2,5,5,9,3,4,1,5,6,4,0,0,4,4,19,SG
2014,29,65,2017,240,608,62,195,178,413,88,122,54,143,197,365,78,27,129,157,630,PG
2014,25,30,322,27,67,0,5,27,62,14,22,15,44,59,20,10,3,11,25,68,SF
2014,39,81,1428,141,361,88,229,53,132,55,71,12,110,122,117,70,3,49,157,425,SG
2014,21,76,1503,228,544,89,237,139,307,93,123,34,168,202,112,34,7,100,179,638,SG
2014,30,81,2485,361,875,189,498,172,377,157,185,36,196,232,287,67,39,145,205,1068,SG
2014,22,21,161,16,39,5,11,11,28,2,2,4,19,23,6,4,2,11,23,39,SG
2014,24,49,519,107,227,40,84,67,143,19,21,8,44,52,64,14,3,48,35,273,SG
2014,24,41,463,94,198,36,73,58,125,17,19,7,38,45,61,14,3,44,28,241,SG
2014,24,8,56,13,29,4,11,9,18,2,2,1,6,7,3,0,0,4,7,32,SG
2014,26,52,727,77,162,0,2,77,160,20,29,88,120,208,36,10,22,32,95,174,C
2014,30,82,2312,336,778,160,432,176,346,78,95,73,343,416,98,60,63,89,245,910,PF
2014,32,55,1083,118,294,69,193,49,101,10,19,21,101,122,63,27,33,30,120,315,SF
2014,37,54,1109,157,356,0,3,157,353,38,47,60,298,358,82,43,40,69,123,352,C
2014,25,71,1048,101,265,36,96,65,169,10,12,11,86,97,120,41,5,75,75,248,PG
2014,29,59,1970,336,711,2,11,334,700,185,241,84,340,424,215,59,76,111,150,859,C
2014,33,60,1884,425,885,4,14,421,871,187,254,124,456,580,201,27,92,141,124,1041,C
2014,27,73,2531,537,1179,65,197,472,982,318,387,113,324,437,209,95,56,224,171,1457,SF
2014,27,18,639,130,335,22,59,108,276,68,88,29,104,133,40,28,23,59,47,350,SF
2014,27,55,1892,407,844,43,138,364,706,250,299,84,220,304,169,67,33,165,124,1107,SF
2014,26,65,1020,98,236,19,58,79,178,43,61,35,114,149,47,39,15,44,96,258,SF
2014,23,80,2898,577,1362,182,500,395,862,401,464,64,478,542,283,151,22,224,198,1737,SF
2014,28,82,2351,429,896,0,7,429,889,211,281,200,358,558,91,41,112,150,207,1069,PF
2014,36,68,1550,294,627,90,258,204,369,160,188,30,172,202,293,70,17,139,128,838,SG
2014,21,45,434,36,74,0,0,36,74,32,65,51,104,155,7,8,41,32,57,104,C
2014,31,5,34,3,8,0,2,3,6,0,0,0,4,4,1,0,0,1,5,6,SF
2014,32,22,395,76,143,7,17,69,126,24,27,37,77,114,15,10,7,17,53,183,C
2014,19,52,533,76,167,5,36,71,131,37,55,25,62,87,20,20,11,44,45,194,SG
2014,30,19,279,37,108,8,29,29,79,17,21,3,24,27,21,10,2,21,18,99,SG
2014,25,64,2057,356,817,101,258,255,559,175,223,30,135,165,208,74,12,134,114,988,SG
2014,29,81,2655,455,840,1,1,454,839,157,229,202,565,767,138,41,121,126,201,1068,C
2014,30,41,847,116,307,43,128,73,179,63,67,31,102,133,41,12,17,46,62,338,SF
2014,30,29,653,80,223,31,94,49,129,51,53,24,81,105,33,9,13,36,41,242,SF
2014,30,12,194,36,84,12,34,24,50,12,14,7,21,28,8,3,4,10,21,96,SF
2014,29,37,355,27,61,0,1,27,60,11,20,42,69,111,22,10,8,31,64,65,C
2014,29,4,20,2,3,0,0,2,3,1,2,3,5,8,3,0,0,4,7,5,C
2014,29,33,335,25,58,0,1,25,57,10,18,39,64,103,19,10,8,27,57,60,C
2014,26,68,1651,218,505,132,318,86,187,50,63,25,204,229,104,65,61,76,107,618,SG
2014,23,82,1797,187,459,55,165,132,294,82,123,86,323,409,152,102,72,91,231,511,SF
2014,28,82,2330,448,1006,204,510,244,496,195,230,48,227,275,122,70,42,145,220,1295,SG
2014,27,82,2805,482,1171,135,396,347,775,283,356,54,326,380,138,57,47,165,180,1382,SF
2014,32,55,869,102,271,41,121,61,150,28,34,12,66,78,50,22,11,34,96,273,SG
2014,24,80,2863,718,1359,12,44,706,1315,482,674,192,565,757,309,92,51,224,265,1930,PF
2014,25,15,244,25,54,3,12,22,42,9,12,3,19,22,30,10,1,14,37,62,PG
2014,23,60,1019,147,376,70,198,77,178,40,51,32,162,194,52,44,20,46,67,404,SF
2014,23,39,670,99,254,45,129,54,125,23,31,23,110,133,34,31,13,27,31,266,SF
2014,23,21,349,48,122,25,69,23,53,17,20,9,52,61,18,13,7,19,36,138,SF
2014,23,8,72,9,20,3,9,6,11,5,5,4,3,7,0,5,0,4,8,26,C
2014,23,7,68,9,20,3,9,6,11,5,5,4,3,7,0,4,0,3,8,26,C
2014,28,64,978,93,196,0,2,93,194,126,185,120,167,287,17,28,19,47,132,312,PF
2014,21,81,1875,294,687,130,358,164,329,106,128,19,102,121,66,44,7,47,144,824,SG
2014,24,73,2777,549,1205,177,483,372,722,576,665,61,283,344,446,115,29,265,177,1851,SG
2014,20,80,1950,224,483,59,154,165,329,85,143,69,195,264,80,97,50,86,140,592,SF
2014,24,32,317,38,82,12,31,26,51,5,7,30,46,76,15,6,15,10,44,93,C
2014,33,34,511,82,207,34,100,48,107,27,35,15,65,80,28,14,0,34,72,225,PF
2014,30,40,818,96,254,31,101,65,153,92,115,8,77,85,178,28,2,59,72,315,PG
2014,24,2,11,0,1,0,0,0,1,0,0,1,0,1,1,1,0,0,0,0,SF
2014,24,9,180,28,70,7,20,21,50,10,12,7,27,34,11,4,1,9,10,73,SG
2014,30,20,225,29,61,0,2,29,59,26,27,15,18,33,5,16,7,11,36,84,PF
2014,21,61,1850,332,716,32,126,300,590,197,244,88,336,424,82,41,24,78,143,893,PF
2014,33,46,653,74,146,0,0,74,146,25,44,42,133,175,13,11,15,24,79,173,PF
2014,25,80,2470,403,883,128,308,275,575,119,152,131,529,660,240,44,94,173,237,1053,C
2014,25,53,1666,264,586,81,203,183,383,79,101,88,364,452,176,31,67,119,154,688,C
2014,25,27,804,139,297,47,105,92,192,40,51,43,165,208,64,13,27,54,83,365,C
2014,30,61,754,56,130,0,1,56,129,20,25,69,141,210,35,34,12,33,95,132,C
2014,30,16,179,14,32,0,0,14,32,5,7,20,27,47,6,11,2,7,18,33,C
2014,30,45,575,42,98,0,1,42,97,15,18,49,114,163,29,23,10,26,77,99,C
2014,23,77,2800,426,1032,85,280,341,752,311,381,62,329,391,400,110,40,212,155,1248,SF
2014,26,77,2461,403,930,40,115,363,815,235,309,31,279,310,199,51,32,113,159,1081,SG
2014,22,43,908,144,345,28,81,116,264,116,177,25,89,114,51,44,7,57,79,432,SF
2014,23,70,1856,344,639,0,1,344,638,91,177,171,326,497,113,41,116,114,185,779,PF
2014,27,81,2409,331,754,2,5,329,749,207,269,202,336,538,91,29,182,148,269,871,C
2014,25,69,1859,332,654,0,8,332,646,150,290,206,426,632,96,47,51,128,177,814,PF
2014,31,53,1560,299,594,1,5,298,589,155,266,65,229,294,153,64,47,117,164,754,PF
2014,27,76,2434,272,616,95,260,177,356,142,176,53,230,283,265,75,23,92,158,781,PG
2014,26,72,1500,286,521,0,1,286,520,124,181,194,341,535,54,29,64,75,172,696,PF
2014,22,28,226,17,40,7,23,10,17,6,7,9,32,41,12,5,2,13,19,47,SF
2014,33,73,2116,243,619,85,242,158,377,95,125,31,161,192,286,80,26,120,203,666,PG
2014,23,34,1143,203,454,30,77,173,377,51,63,28,114,142,268,56,12,105,92,487,PG
2014,29,61,482,53,72,0,0,53,72,35,56,31,59,90,8,9,31,29,87,141,PF
2014,24,2,7,0,4,0,2,0,2,1,2,0,0,0,1,1,0,0,0,1,SG
2014,27,29,958,238,420,4,11,234,409,58,85,66,178,244,76,27,44,64,56,538,C
2014,28,71,2396,473,800,2,7,471,793,349,638,231,635,866,131,60,128,229,240,1297,C
2014,24,53,655,67,177,32,89,35,88,15,16,35,97,132,23,16,2,10,57,181,SF
2014,28,69,1376,231,461,0,2,231,459,117,144,127,282,409,67,31,61,64,136,579,PF
2014,24,81,2666,524,978,23,60,501,918,156,199,224,485,709,85,39,219,123,233,1227,PF
2014,30,63,2040,220,458,62,175,158,283,86,132,53,240,293,263,95,18,100,103,588,SF
2014,26,55,1478,237,579,37,131,200,448,107,130,107,235,342,72,46,8,61,135,618,PF
2014,21,71,2496,532,1237,123,344,409,893,291,338,52,207,259,433,108,23,190,163,1478,PG
2014,32,2,5,0,2,0,1,0,1,0,0,0,1,1,0,0,0,0,1,0,SG
2014,30,80,2252,286,698,63,185,223,513,125,149,22,201,223,324,56,22,133,133,760,PG
2014,23,80,2277,403,916,83,245,320,671,158,177,43,270,313,331,85,9,168,142,1047,PG
2014,35,9,107,6,26,1,14,5,12,2,4,2,8,10,5,6,1,6,11,15,SF
2014,28,30,146,11,23,0,1,11,22,6,11,15,27,42,3,3,8,10,24,28,C
2014,26,5,50,2,9,0,2,2,7,2,2,1,11,12,3,0,1,1,3,6,SF
2014,29,77,2902,767,1353,116,306,651,1047,439,585,81,452,533,488,121,26,270,126,2089,PF
2014,38,11,77,5,21,1,5,4,16,0,2,0,7,7,17,2,0,5,11,11,PG
2014,37,22,248,29,92,8,41,21,51,18,25,9,46,55,7,9,3,7,29,84,PF
2014,28,6,47,3,6,0,2,3,4,3,4,1,8,9,1,0,0,1,3,9,SG
2014,28,4,34,3,5,0,1,3,4,1,2,1,5,6,1,0,0,0,2,7,SG
2014,29,73,2553,700,1376,3,15,697,1361,191,277,156,636,792,155,67,79,124,176,1594,C
2014,33,82,2213,294,654,123,301,171,353,120,162,18,201,219,130,56,14,94,168,831,SF
2014,22,13,158,16,42,4,18,12,24,4,4,3,19,22,11,1,1,11,11,40,SG
2014,24,80,2728,423,1135,154,457,269,678,241,321,59,185,244,609,101,8,215,157,1241,PG
2014,26,64,741,98,208,31,74,67,134,43,59,51,124,175,39,21,6,43,85,270,PF
2014,26,77,2214,344,612,20,66,324,546,91,143,172,333,505,115,56,88,123,271,799,PF
2014,23,40,789,85,214,43,127,42,87,37,43,31,66,97,31,27,4,22,63,250,SF
2014,26,52,956,143,308,22,87,121,221,76,90,60,106,166,111,42,57,66,102,384,SF
2014,32,79,2575,462,1018,162,404,300,614,159,195,48,222,270,216,47,10,120,129,1245,SG
2014,24,45,392,36,113,9,47,27,66,19,26,9,46,55,20,6,2,15,26,100,SG
2014,24,38,342,33,96,8,41,25,55,17,22,7,44,51,16,6,1,14,23,91,SG
2014,24,7,50,3,17,1,6,2,11,2,4,2,2,4,4,0,1,1,3,9,SG
2014,26,79,2240,277,651,100,271,177,380,61,77,70,278,348,124,86,77,90,207,715,SF
2014,24,3,15,0,7,0,3,0,4,0,2,0,2,2,1,1,0,2,3,0,SG
2014,33,20,236,31,68,28,54,3,14,7,11,2,21,23,9,3,4,4,6,97,SF
2014,22,62,764,83,181,22,61,61,120,28,42,28,86,114,26,14,19,21,62,216,PF
2014,29,11,85,6,17,0,0,6,17,2,4,8,8,16,2,2,2,2,12,14,PF
2014,22,76,2078,386,712,31,101,355,611,118,195,162,366,528,87,53,99,71,139,921,PF
2014,25,82,2870,348,515,0,0,348,515,160,374,331,783,1114,74,80,203,123,264,856,C
2014,22,68,936,126,265,12,38,114,227,79,96,32,75,107,114,35,14,43,84,343,SG
2014,31,39,736,176,346,0,3,176,343,52,68,54,175,229,58,11,40,74,93,404,C
2014,21,80,2138,419,853,0,1,419,852,149,204,222,376,598,75,28,42,144,230,987,C
2014,20,22,156,12,35,4,19,8,16,9,10,0,16,16,6,3,1,11,22,37,SF
2014,22,59,1312,157,371,48,142,109,229,110,135,42,177,219,95,32,45,47,147,472,PF
2014,20,62,1502,167,353,1,9,166,344,113,184,109,215,324,52,43,39,60,145,448,SF
2014,32,45,857,82,160,1,5,81,155,61,119,55,91,146,72,40,19,54,65,226,PF
2014,22,72,2400,461,1092,110,338,351,754,259,323,46,209,255,352,69,17,188,146,1291,PG
2014,32,71,2408,289,609,185,392,104,217,87,94,22,260,282,208,70,24,102,147,850,SG
2014,24,80,1349,227,459,0,0,227,459,60,93,160,258,418,39,32,71,67,182,514,C
2014,26,20,59,8,15,0,0,8,15,4,8,9,8,17,1,0,1,6,7,20,C
2014,23,21,92,5,13,0,0,5,13,5,11,10,11,21,2,3,4,10,17,15,C
2014,22,53,695,63,160,36,90,27,70,29,36,8,41,49,43,11,1,27,54,191,SG
2014,21,78,1538,263,609,88,247,175,362,51,64,27,162,189,115,56,26,61,143,665,SG
2014,30,18,233,31,60,0,0,31,60,14,17,15,42,57,5,3,1,9,34,76,PF
2014,21,48,489,52,137,12,38,40,99,16,25,11,31,42,71,26,1,39,46,132,PG
2014,26,62,2222,347,806,72,202,275,604,324,406,40,175,215,543,100,10,200,113,1090,PG
2014,21,11,33,6,17,3,8,3,9,4,4,0,2,2,2,1,0,2,2,19,SG
2014,28,79,1973,295,614,72,194,223,420,99,112,29,158,187,115,65,28,73,127,761,SG
2014,28,30,504,90,183,23,52,67,131,18,22,8,41,49,32,20,9,25,37,221,SG
2014,28,49,1469,205,431,49,142,156,289,81,90,21,117,138,83,45,19,48,90,540,SG
2014,30,69,2288,513,981,0,1,513,980,231,296,182,461,643,147,48,26,152,206,1257,PF
2014,20,42,362,33,78,0,0,33,78,20,31,39,60,99,4,4,18,26,68,86,C
2014,22,66,1923,337,645,69,182,268,463,101,126,76,336,412,133,114,50,80,127,844,SF
2014,21,40,355,41,91,0,6,41,85,16,21,26,85,111,18,7,5,15,76,98,C
2014,24,49,642,121,246,23,49,98,197,37,47,37,121,158,20,18,13,27,63,302,PF
2014,34,60,971,98,236,46,134,52,102,26,33,24,86,110,57,53,8,35,90,268,SF
2014,25,1,1,1,1,0,0,1,1,0,0,1,0,1,0,0,0,0,0,2,SG
2014,23,82,2937,553,1304,218,554,335,750,371,426,35,253,288,457,64,22,193,197,1695,PG
2014,25,71,2054,295,662,82,229,213,433,218,265,34,153,187,294,68,27,176,166,890,PG
2014,28,76,1974,235,487,1,6,234,481,158,191,67,179,246,245,93,31,105,172,629,PG
2014,25,17,533,129,229,0,1,129,228,94,115,39,63,102,16,9,30,28,52,352,C
2014,25,82,2603,355,644,0,1,355,643,198,242,326,374,700,73,25,139,84,196,908,C
2014,25,77,2797,650,1421,190,505,460,916,520,633,224,739,963,341,59,35,196,136,2010,PF
2014,27,79,2862,457,1080,190,500,267,580,313,385,88,281,369,586,121,15,194,267,1417,PG
2014,31,42,591,62,190,25,84,37,106,10,16,12,27,39,42,14,0,22,41,159,PG
2014,23,73,1490,209,501,62,184,147,317,64,74,21,139,160,271,50,2,89,100,544,PG
2014,27,77,1248,91,189,0,1,91,188,90,145,107,150,257,24,41,72,58,207,272,C
2014,35,76,2409,341,708,58,162,283,546,51,65,132,365,497,124,90,37,95,125,791,SF
2014,22,54,1564,170,419,71,178,99,241,19,36,15,140,155,477,48,4,150,76,430,PG
2014,29,59,870,111,264,59,151,52,113,48,65,13,97,110,33,27,7,34,71,329,SF
2014,29,53,822,106,256,56,146,50,110,46,61,12,93,105,31,26,7,33,68,314,SF
2014,29,6,48,5,8,3,5,2,3,2,4,1,4,5,2,1,0,1,3,15,SF
2014,36,32,633,63,123,0,1,63,122,11,19,36,98,134,50,25,27,26,85,137,PF
2014,30,68,2177,440,1023,115,297,325,726,303,340,34,169,203,121,66,6,106,123,1298,SG
2014,33,25,260,25,67,17,48,8,19,7,7,1,21,22,19,6,1,9,26,74,SG
2014,27,82,2780,445,1009,201,511,244,498,252,301,51,238,289,197,76,14,110,176,1343,SG
2014,30,34,488,47,105,0,0,47,105,15,31,28,58,86,9,8,20,14,47,109,PF
2014,26,31,327,32,101,12,37,20,64,6,11,9,30,39,52,9,3,29,17,82,PG
2014,26,23,215,21,72,8,25,13,47,2,3,7,17,24,40,5,1,17,13,52,PG
2014,26,8,112,11,29,4,12,7,17,4,8,2,13,15,12,4,2,12,4,30,PG
2014,26,52,1346,224,550,84,227,140,323,76,88,24,100,124,113,28,13,95,111,608,SG
2014,27,9,196,15,32,1,3,14,29,9,13,9,18,27,15,9,5,4,18,40,SF
2014,27,55,807,72,161,3,14,69,147,37,54,47,72,119,21,21,9,36,50,184,PF
2014,22,45,897,113,300,22,59,91,241,32,43,18,61,79,120,22,9,39,69,280,PG
2014,22,38,476,74,178,30,80,44,98,23,34,7,41,48,27,14,2,35,53,201,SG
2014,26,5,79,17,38,0,0,17,38,1,1,10,7,17,2,1,7,8,16,35,C
2014,20,82,2187,255,679,95,297,160,382,115,143,53,182,235,82,45,18,96,201,720,SG
2014,26,78,2360,247,566,105,291,142,275,62,85,85,288,373,333,58,46,83,189,661,PF
2014,26,77,2556,413,892,162,404,251,488,221,258,30,164,194,138,111,4,111,119,1209,SG
2014,25,31,292,30,86,5,20,25,66,8,12,5,22,27,63,4,1,31,31,73,PG
2014,22,82,2460,376,854,120,290,256,564,118,137,60,250,310,169,83,20,123,243,990,SF
2014,26,51,984,178,409,83,211,95,198,64,75,18,85,103,52,46,15,44,103,503,SG
2014,37,58,982,106,231,11,21,95,210,60,77,28,102,130,197,34,9,61,75,283,SG
2014,37,30,570,66,144,9,18,57,126,35,47,16,57,73,100,15,7,33,32,176,SG
2014,37,28,412,40,87,2,3,38,84,25,30,12,45,57,97,19,2,28,43,107,SG
2014,23,45,723,73,166,25,77,48,89,29,36,9,43,52,43,24,9,22,88,200,SF
2014,33,82,1707,213,443,107,233,106,210,46,56,30,177,207,130,26,5,77,95,579,SF
2014,21,52,789,94,256,30,94,64,162,39,55,36,111,147,26,22,32,48,70,257,PF
2014,25,81,1527,309,666,135,318,174,348,73,82,34,135,169,149,68,9,63,114,826,PG
2014,28,74,2482,483,1047,76,212,407,835,286,391,154,473,627,232,129,78,185,210,1328,PF
2014,24,3,10,3,5,0,1,3,4,0,0,1,0,1,1,1,0,0,0,6,SF
2014,21,21,79,5,12,1,1,4,11,11,19,15,11,26,2,6,3,4,9,22,PF
2014,36,80,562,54,126,0,0,54,126,16,30,66,109,175,20,14,30,37,77,124,C
2014,23,82,2690,504,1015,0,1,504,1014,241,367,256,504,760,171,91,47,166,205,1249,PF
2014,24,79,1506,195,456,57,161,138,295,52,68,29,107,136,112,60,13,55,106,499,SG
2014,23,27,313,39,96,12,38,27,58,17,26,7,19,26,44,13,0,27,33,107,PG
2014,23,12,193,29,67,10,24,19,43,15,21,3,10,13,31,8,0,19,21,83,PG
2014,23,10,54,4,13,0,7,4,6,1,2,0,5,5,5,2,0,2,9,9,PG
2014,23,5,66,6,16,2,7,4,9,1,3,4,4,8,8,3,0,6,3,15,PG
2014,24,82,1800,288,651,99,260,189,391,121,159,84,235,319,88,72,18,95,157,796,SF
2014,24,81,2153,411,845,34,108,377,737,259,327,139,346,485,144,68,51,147,232,1115,PF
2014,28,76,1426,238,520,88,195,150,325,72,87,29,111,140,59,38,12,51,102,636,SG
2014,23,62,952,131,296,21,84,110,212,58,96,60,165,225,34,20,21,49,132,341,PF
2014,23,12,187,16,38,0,0,16,38,4,5,11,24,35,2,8,4,7,22,36,PF
2014,27,82,1770,285,545,4,24,281,521,196,260,171,357,528,62,27,100,122,213,770,C
2014,21,37,290,57,124,3,11,54,113,26,40,24,29,53,6,8,1,16,24,143,SG
2014,24,45,414,73,165,33,89,40,76,10,20,24,68,92,14,15,11,27,64,189,C
2014,24,27,167,26,64,13,39,13,25,2,6,7,25,32,6,6,3,13,33,67,C
2014,24,18,247,47,101,20,50,27,51,8,14,17,43,60,8,9,8,14,31,122,C
2014,23,24,62,3,13,0,3,3,10,0,0,2,6,8,2,0,4,2,7,6,C
2014,24,51,373,56,129,5,12,51,117,23,39,13,31,44,49,19,1,34,46,140,PG
2014,22,20,215,31,73,0,3,31,70,14,14,17,35,52,7,3,10,12,29,76,PF
2014,27,14,74,3,9,0,0,3,9,0,1,5,13,18,3,0,4,3,15,6,C
2014,39,15,313,36,94,8,24,28,70,22,24,4,25,29,86,7,2,31,18,102,PG
2014,29,52,1114,193,471,68,180,125,291,94,105,10,80,90,83,18,0,64,65,548,SG
2014,29,30,607,108,277,40,111,68,166,45,54,8,42,50,46,7,0,39,26,301,SG
2014,29,22,507,85,194,28,69,57,125,49,51,2,38,40,37,11,0,25,39,247,SG
2014,22,24,142,8,39,3,18,5,21,7,8,3,12,15,13,0,1,13,13,26,SG
2014,31,68,2179,294,747,136,391,158,356,96,112,29,202,231,476,52,5,166,146,820,PG
2014,24,76,1174,180,420,28,89,152,331,47,57,53,202,255,25,18,23,51,150,435,PF
2014,28,80,2820,380,800,0,2,380,798,247,335,282,618,900,431,99,121,194,245,1007,C
2014,30,54,540,60,146,52,122,8,24,6,6,8,50,58,13,12,4,5,44,178,PF
2014,35,80,2628,633,1273,131,329,502,944,338,376,40,458,498,216,73,45,117,165,1735,PF
2014,23,13,165,15,46,8,25,7,21,6,9,1,18,19,8,6,2,7,11,44,SF
2014,23,4,54,6,18,3,10,3,8,3,4,1,7,8,2,1,1,4,2,18,SF
2014,23,9,111,9,28,5,15,4,13,3,5,0,11,11,6,5,1,3,9,26,SF
2014,35,44,883,125,248,0,0,125,248,99,132,85,157,242,25,14,40,52,102,349,PF
2014,23,69,1188,186,371,0,3,186,368,57,83,100,264,364,78,39,88,78,165,429,C
2014,26,23,212,27,49,0,0,27,49,13,23,23,31,54,1,7,13,12,52,67,C
2014,21,80,2487,392,936,74,226,318,710,248,318,43,286,329,327,129,37,256,210,1106,PG
2014,22,70,1400,234,502,40,114,194,388,99,122,140,225,365,109,35,27,106,227,607,C
2014,26,5,30,1,5,0,0,1,5,1,2,2,6,8,3,0,0,1,3,3,PF
2014,26,3,25,1,4,0,0,1,4,1,2,2,5,7,3,0,0,1,3,3,PF
2014,26,2,5,0,1,0,0,0,1,0,0,0,1,1,0,0,0,0,0,0,PF
2014,23,22,251,21,47,0,0,21,47,23,30,16,45,61,15,6,16,18,38,65,C
2014,29,63,1065,130,326,41,117,89,209,42,52,36,132,168,48,20,19,26,94,343,SF
2014,29,53,1325,149,349,0,1,149,348,110,130,141,192,333,136,45,14,92,124,408,C
2014,34,29,242,52,118,24,60,28,58,8,11,1,19,20,52,14,1,26,17,136,PG
2014,31,68,1997,456,914,25,67,431,847,197,243,17,138,155,388,36,9,151,86,1134,PG
2014,25,74,2783,466,987,130,351,336,636,164,221,69,340,409,298,88,29,144,168,1226,SF
2014,24,65,1533,225,489,55,151,170,338,50,71,117,225,342,78,55,37,65,159,555,PF
2014,24,17,415,50,122,9,39,41,83,9,16,34,65,99,15,13,3,16,39,118,PF
2014,24,48,1118,175,367,46,112,129,255,41,55,83,160,243,63,42,34,49,120,437,PF
2014,28,62,2171,406,870,78,212,328,658,295,345,38,230,268,663,154,4,145,157,1185,PG
2014,28,54,1663,379,701,0,0,379,701,186,249,206,262,468,50,30,23,84,129,944,C
2014,29,62,1207,87,193,0,1,87,192,37,67,82,223,305,67,26,32,90,177,211,C
2014,36,75,2098,321,712,112,300,209,412,256,310,26,322,348,178,86,31,153,190,1010,SF
2014,25,2,3,0,1,0,0,0,1,0,2,3,0,3,0,0,0,0,0,0,C
2014,23,70,1275,199,302,0,3,199,299,122,195,99,209,308,60,49,55,77,171,520,C
2014,25,80,1964,286,553,0,0,286,553,74,132,198,428,626,43,50,90,111,185,646,C
2014,25,15,270,31,79,11,34,20,45,21,26,10,16,26,20,5,1,15,18,94,SG
2014,20,37,319,33,91,4,21,29,70,8,12,21,36,57,10,8,1,14,26,78,SF
2014,31,1,19,2,6,0,0,2,6,0,0,0,5,5,0,0,1,1,1,4,PF
2014,22,75,1132,78,253,28,106,50,147,29,45,20,85,105,241,68,5,87,97,213,PG
2014,27,28,99,19,46,6,22,13,24,0,2,1,9,10,13,1,0,7,5,44,SG
2014,30,31,377,28,92,9,43,19,49,9,13,8,35,43,66,25,2,26,50,74,SG
2014,36,66,1283,88,191,65,140,23,51,11,12,36,93,129,228,67,2,60,132,252,PG
2014,33,76,1948,200,492,20,69,180,423,34,60,32,202,234,119,39,19,41,63,454,SF
2014,26,48,465,68,126,0,0,68,126,45,55,54,54,108,23,7,13,28,84,181,C
2014,24,43,527,68,176,18,61,50,115,52,69,20,102,122,32,26,19,39,64,206,PF
2014,30,14,95,7,14,0,0,7,14,6,11,7,18,25,1,3,1,5,15,20,PF
2014,32,79,2705,560,1198,2,20,558,1178,250,337,265,530,795,200,54,23,183,210,1372,PF
2014,29,35,987,181,398,73,185,108,213,97,106,9,65,74,78,28,3,42,65,532,SG
2014,23,11,109,11,37,5,17,6,20,5,7,4,16,20,7,6,1,9,7,32,SG
2014,32,61,1141,126,327,37,108,89,219,17,26,23,74,97,176,32,8,66,92,306,PG
2014,32,36,763,84,219,25,68,59,151,13,19,15,47,62,122,23,2,46,55,206,PG
2014,32,25,378,42,108,12,40,30,68,4,7,8,27,35,54,9,6,20,37,100,PG
2014,21,69,1339,192,474,36,99,156,375,110,173,26,103,129,160,45,9,77,134,530,PG
2014,22,40,399,33,68,2,13,31,55,7,10,36,58,94,15,19,10,19,74,75,SG
2014,28,72,1667,244,581,64,178,180,403,125,133,17,119,136,234,43,7,95,132,677,PG
2014,29,44,866,164,383,58,154,106,229,71,85,21,60,81,112,36,4,58,92,457,PG
2014,22,70,873,141,293,0,1,141,292,57,101,105,202,307,34,23,20,57,131,339,PF
2014,27,30,998,141,350,26,90,115,260,42,67,22,142,164,294,40,2,99,65,350,PG
2014,25,10,311,58,164,16,47,42,117,27,32,9,23,32,43,5,1,34,15,159,PG
2014,22,81,2159,318,751,161,408,157,343,82,98,43,209,252,79,64,27,88,183,879,SG
2014,23,82,2638,255,670,44,133,211,537,227,283,61,281,342,704,191,11,221,218,781,PG
2014,28,38,418,30,90,16,47,14,43,3,5,5,39,44,24,5,9,20,31,79,SG
2014,24,65,1089,143,300,0,0,143,300,64,94,82,172,254,51,24,47,44,134,350,C
2014,34,18,445,41,117,16,42,25,75,7,7,8,38,46,44,12,8,14,32,105,SF
2014,34,60,1281,109,296,47,121,62,175,33,45,12,105,117,103,35,11,40,92,298,SG
2014,25,23,584,76,162,0,1,76,161,26,55,60,105,165,19,18,40,26,74,178,C
2014,20,49,641,72,188,10,42,62,146,29,43,5,55,60,93,17,0,61,54,183,PG
2014,33,82,1399,263,560,1,7,262,553,99,136,86,305,391,81,26,16,108,164,626,PF
2014,25,80,1482,301,628,62,200,239,428,103,132,62,222,284,75,30,7,79,121,767,PF
2014,29,61,1584,141,340,48,152,93,188,53,69,50,170,220,94,79,17,55,90,383,SG
2014,24,53,578,111,220,0,0,111,220,27,31,53,75,128,17,3,26,41,103,249,C
2014,27,83,2214,330,769,35,124,295,645,326,404,38,165,203,340,49,9,148,90,1021,PG
2014,27,55,1305,190,465,15,68,175,397,183,234,22,95,117,206,33,6,93,50,578,PG
2014,27,28,909,140,304,20,56,120,248,143,170,16,70,86,134,16,3,55,40,443,PG
2014,29,3,11,0,3,0,1,0,2,1,2,0,0,0,4,0,0,2,2,1,PG
2014,22,26,154,13,28,0,6,13,22,3,8,4,12,16,14,3,1,12,18,29,SF
2014,22,17,137,11,24,0,6,11,18,3,8,4,10,14,12,2,1,11,16,25,SF
2014,22,9,17,2,4,0,0,2,4,0,0,0,2,2,2,1,0,1,2,4,SF
2014,23,74,1962,183,484,76,228,107,256,53,71,81,227,308,129,92,13,79,209,495,SG
2014,25,63,664,76,237,30,102,46,135,68,90,21,60,81,68,26,16,48,36,250,SG
2014,23,46,875,130,274,0,1,130,273,90,121,104,133,237,52,28,20,41,116,350,C
2014,23,20,168,18,45,0,0,18,45,8,14,22,34,56,5,5,7,8,32,44,C
2014,23,26,707,112,229,0,1,112,228,82,107,82,99,181,47,23,13,33,84,306,C
2014,25,82,2337,269,602,94,246,175,356,152,184,116,187,303,75,61,38,79,211,784,SF
2014,24,25,250,25,67,7,19,18,48,18,25,18,37,55,6,9,3,17,25,75,SF
2014,23,24,224,18,57,7,25,11,32,11,15,2,12,14,34,9,1,18,27,54,SG
2014,26,48,392,44,117,10,42,34,75,12,20,4,40,44,50,10,1,22,19,110,SG
2014,23,11,100,18,28,0,0,18,28,2,5,11,16,27,0,1,2,5,17,38,C
2014,25,70,1006,119,281,1,23,118,258,22,39,31,98,129,179,49,13,65,66,261,PG
2014,28,74,2421,396,955,189,480,207,475,90,138,35,261,296,219,65,20,108,196,1071,SF
2014,27,31,830,131,282,0,0,131,282,39,50,51,130,181,29,11,29,28,100,301,PF
2014,28,77,2730,517,1233,70,265,447,968,160,301,102,418,520,252,105,110,199,197,1264,SF
2014,22,77,1231,129,336,57,178,72,158,31,41,19,105,124,68,29,15,44,84,346,SG
2014,23,4,30,5,15,3,6,2,9,1,2,0,8,8,0,1,2,1,3,14,SF
2014,23,1,3,0,3,0,1,0,2,0,0,0,0,0,0,0,0,0,0,0,SF
2014,23,3,27,5,12,3,5,2,7,1,2,0,8,8,0,1,2,1,3,14,SF
2014,26,79,982,195,442,8,31,187,411,110,134,101,189,290,32,10,34,66,148,508,C
2014,29,59,1271,181,346,0,3,181,343,121,173,123,240,363,90,29,31,75,117,483,C
2014,23,3,15,3,7,0,0,3,7,1,1,1,4,5,0,0,0,0,0,7,SG
2014,23,78,2752,427,870,86,244,341,626,140,197,95,463,558,359,54,7,210,195,1080,SG
2014,28,55,1007,70,122,0,1,70,121,19,32,72,154,226,36,35,57,44,169,159,C
2014,25,21,120,7,17,2,8,5,9,2,3,2,18,20,12,3,0,5,13,18,SG
2014,31,65,1466,311,558,0,0,311,558,150,203,112,208,320,34,23,37,91,159,772,C
2014,27,73,1950,372,853,24,88,348,765,244,292,39,130,169,152,54,10,125,131,1012,SG
2014,21,74,2041,384,899,56,208,328,691,158,203,241,360,601,118,35,49,119,251,982,PF
2014,24,26,629,82,218,18,67,64,151,26,47,15,45,60,22,13,5,25,62,208,SF
2014,23,23,270,31,91,3,12,28,79,24,30,3,12,15,36,12,1,31,29,89,PG
2014,25,79,2542,456,1040,74,225,382,815,318,376,34,174,208,528,89,17,232,158,1304,PG
2014,20,40,443,38,119,5,18,33,101,26,35,1,39,40,58,10,5,39,46,107,SG
2014,20,19,242,16,66,2,10,14,56,11,16,1,18,19,28,2,4,17,25,45,SG
2014,20,21,201,22,53,3,8,19,45,15,19,0,21,21,30,8,1,22,21,62,SG
2014,28,72,1396,221,529,136,349,85,180,44,62,60,206,266,57,29,23,54,143,622,SF
2014,27,75,638,51,141,6,29,45,112,30,43,21,47,68,72,35,11,42,72,138,SG
2014,36,35,570,55,152,39,103,16,49,10,15,4,33,37,56,13,0,27,48,159,PG
2014,26,23,192,13,23,0,0,13,23,1,5,9,31,40,1,4,9,14,47,27,C
2014,20,6,37,6,14,1,5,5,9,1,1,0,3,3,3,0,0,1,6,14,SF
2014,20,4,24,3,9,0,3,3,6,1,1,0,3,3,2,0,0,0,2,7,SF
2014,20,2,13,3,5,1,2,2,3,0,0,0,0,0,1,0,0,1,4,7,SF
2014,24,72,2497,496,1096,127,364,369,732,346,407,47,163,210,454,93,8,213,185,1465,PG
2014,25,5,42,2,9,0,0,2,9,2,4,2,5,7,3,0,0,2,4,6,SF
2014,25,8,63,7,16,1,4,6,12,0,2,5,16,21,2,0,3,9,5,15,PF
2014,25,1,15,1,4,0,0,1,4,0,2,1,8,9,0,0,2,1,0,2,PF
2014,25,7,48,6,12,1,4,5,8,0,0,4,8,12,2,0,1,8,5,13,PF
2014,22,77,1742,171,372,67,167,104,205,52,73,73,174,247,73,53,12,60,144,461,SF
2014,27,82,2007,251,496,0,0,251,496,84,145,153,374,527,53,32,56,95,251,586,PF
2014,23,81,2868,559,1259,223,535,336,724,147,185,38,211,249,181,74,37,135,234,1488,SG
2014,22,82,2594,363,761,0,1,363,760,235,339,269,485,754,72,42,35,108,188,961,PF
2014,26,72,1741,252,639,109,316,143,323,90,112,57,141,198,77,58,11,67,110,703,SG
2014,26,46,1121,142,373,57,179,85,194,42,52,39,85,124,47,31,8,38,74,383,SG
2014,26,26,620,110,266,52,137,58,129,48,60,18,56,74,30,27,3,29,36,320,SG
2014,35,8,110,4,20,1,15,3,5,0,0,2,9,11,23,2,0,9,10,9,PG
2014,28,64,1298,129,307,102,247,27,60,33,41,33,135,168,42,19,15,23,82,393,PF
2014,28,81,2490,265,615,74,191,191,424,156,201,161,368,529,141,110,23,102,204,760,SF
2014,31,31,606,64,107,0,0,64,107,21,50,55,119,174,24,8,50,24,65,149,C
2014,34,38,392,42,109,22,50,20,59,9,18,11,78,89,33,19,10,16,50,115,SF
2014,25,81,2457,434,1021,50,156,384,865,213,262,62,346,408,262,67,7,189,195,1131,SF
2014,25,54,1886,356,831,38,132,318,699,189,228,50,272,322,198,56,5,155,147,939,SF
2014,25,27,571,78,190,12,24,66,166,24,34,12,74,86,64,11,2,34,48,192,SF
2014,22,41,398,60,116,0,0,60,116,26,48,38,71,109,8,6,20,26,70,146,C
2014,26,42,804,57,143,0,0,57,143,30,47,61,87,148,31,15,44,38,96,144,PF
2014,31,41,643,78,178,19,42,59,136,25,30,10,49,59,116,23,4,47,50,200,SG
2014,31,31,588,68,160,17,40,51,120,20,24,10,47,57,110,22,3,42,46,173,SG
2014,31,10,55,10,18,2,2,8,16,5,6,0,2,2,6,1,1,5,4,27,SG
2014,21,81,2282,359,676,0,1,359,675,198,260,226,488,714,57,24,71,136,249,916,C
2014,31,65,1800,227,459,0,7,227,452,92,135,187,442,629,140,69,39,72,164,546,C
2014,25,24,339,36,60,0,0,36,60,27,52,19,44,63,13,10,29,10,62,99,PF
2014,25,23,337,36,60,0,0,36,60,27,52,19,44,63,13,10,29,10,61,99,PF
2014,27,18,465,65,150,16,50,49,100,30,32,5,29,34,95,6,1,27,38,176,PG
2014,27,61,1314,212,508,93,239,119,269,65,76,15,124,139,228,25,4,101,105,582,SG
2014,23,54,776,89,173,0,0,89,173,19,56,81,110,191,21,53,35,36,121,197,PF
2014,23,33,470,48,92,0,0,48,92,8,30,53,60,113,10,26,19,22,64,104,PF
2014,23,21,306,41,81,0,0,41,81,11,26,28,50,78,11,27,16,14,57,93,PF
2014,29,20,180,35,92,14,56,21,36,8,14,6,28,34,6,4,5,7,16,92,PF
2014,23,57,1812,353,696,0,0,353,696,105,137,185,441,626,104,60,47,112,169,811,C
2014,29,2,10,2,5,1,2,1,3,0,0,0,3,3,0,1,0,3,1,5,SG
2014,32,54,1775,415,761,9,32,406,729,189,258,60,181,241,252,79,29,161,106,1028,SG
2014,22,70,2072,430,993,92,250,338,743,161,235,32,163,195,209,63,17,154,153,1113,SG
2014,23,73,2614,449,1143,109,327,340,816,282,337,39,267,306,447,86,32,169,128,1289,PG
2014,23,82,2980,579,1337,108,308,471,1029,317,394,38,295,333,721,149,40,295,219,1583,PG
2014,31,58,1416,116,230,19,64,97,166,47,101,36,176,212,143,73,14,97,79,298,SF
2014,24,9,116,18,42,7,21,11,21,5,6,0,9,9,10,8,0,5,11,48,PG
2014,29,63,1193,146,334,53,145,93,189,69,88,19,82,101,107,60,8,60,66,414,PG
2014,34,24,161,3,11,2,7,1,4,4,4,5,10,15,28,5,1,17,33,12,PG
2014,22,2,9,1,2,0,0,1,2,0,0,0,2,2,2,2,0,0,4,2,PG
2014,27,78,2157,254,587,146,372,108,215,105,125,38,184,222,97,41,15,58,150,759,SF
2014,33,80,2472,458,939,4,15,454,924,198,251,120,422,542,223,61,74,133,186,1118,PF
2014,25,46,1412,346,791,68,214,278,577,242,293,55,208,263,319,88,7,177,104,1002,PG
2014,27,2,10,0,1,0,0,0,1,0,0,0,2,2,0,1,0,0,1,0,PF
2014,22,3,9,0,1,0,0,0,1,0,0,0,0,0,0,0,0,0,2,0,PF
2014,29,64,2059,322,716,98,268,224,448,173,216,15,153,168,392,93,13,143,148,915,PG
2014,22,11,162,19,54,2,15,17,39,14,16,3,23,26,1,4,4,6,9,54,PF
2014,22,67,1658,187,428,24,84,163,344,172,243,68,229,297,55,44,16,70,105,570,SF
2014,24,67,1157,140,337,37,125,103,212,87,119,30,100,130,72,35,3,68,126,404,SG
2014,27,60,1445,197,493,79,231,118,262,152,179,10,114,124,210,45,4,92,65,625,PG
2014,27,66,1674,231,526,84,234,147,292,57,73,82,252,334,78,54,31,53,151,603,PF
2014,31,74,1834,280,672,83,225,197,447,78,89,42,111,153,321,55,10,149,197,721,PG
2014,27,3,17,5,9,1,3,4,6,0,0,0,0,0,1,1,0,2,1,11,SF
2014,27,36,751,73,192,42,129,31,63,14,20,25,142,167,30,19,30,21,93,202,PF
2014,23,58,684,69,129,0,1,69,128,52,73,49,101,150,26,15,50,20,73,190,C
2014,22,58,1309,170,389,18,62,152,327,59,90,33,116,149,187,35,15,57,67,417,PG
2014,34,29,388,56,141,17,54,39,87,10,16,18,41,59,17,24,8,19,44,139,SF
2014,26,58,1077,224,331,0,0,224,331,77,106,102,142,244,31,32,55,35,94,525,C
2014,25,8,126,21,35,0,1,21,34,6,15,10,10,20,5,7,5,5,17,48,SF
2014,28,68,984,111,297,69,202,42,95,52,69,29,162,191,64,23,16,39,62,343,SF
2014,20,72,1765,345,808,40,188,305,620,209,326,69,159,228,217,78,16,204,151,939,PG
2014,28,64,1810,387,889,135,350,252,539,235,285,29,137,166,95,46,12,95,156,1144,SG
2014,25,79,2718,582,1283,90,292,492,991,163,229,166,310,476,182,167,36,165,213,1417,PF
2014,21,82,1416,172,404,0,1,172,403,146,200,118,235,353,92,40,41,87,170,490,C
2014,24,70,1049,156,290,0,1,156,289,87,121,103,179,282,36,18,38,60,137,399,C
2015,24,68,1287,152,331,18,60,134,271,76,97,79,222,301,68,27,22,60,147,398,PF
2015,20,30,248,35,86,10,25,25,61,14,23,9,19,28,16,16,7,14,24,94,SG
2015,21,70,1771,217,399,0,2,217,397,103,205,199,324,523,66,38,86,99,222,537,C
2015,28,17,215,19,44,0,0,19,44,22,38,23,54,77,15,4,9,9,30,60,PF
2015,29,78,2502,375,884,118,333,257,551,167,198,27,220,247,129,41,7,116,167,1035,SG
2015,29,53,1750,281,657,82,243,199,414,127,151,21,159,180,101,32,5,83,108,771,SG
2015,29,25,752,94,227,36,90,58,137,40,47,6,61,67,28,9,2,33,59,264,SG
2015,26,68,957,181,329,0,0,181,329,81,99,104,211,315,47,21,51,69,151,443,C
2015,23,41,540,40,78,0,5,40,73,13,27,78,98,176,28,17,16,17,96,93,PF
2015,26,61,976,144,301,0,0,144,301,50,64,101,237,338,75,37,65,59,122,338,C
2015,29,71,2512,659,1415,37,105,622,1310,306,362,177,549,726,124,48,68,122,125,1661,PF
2015,25,63,1070,141,299,0,0,141,299,33,47,123,200,323,73,15,42,40,102,315,C
2015,33,63,1648,225,455,10,29,215,426,79,126,103,177,280,86,129,30,86,166,539,SG
2015,24,74,1366,147,357,34,124,113,233,84,118,114,228,342,59,70,62,55,137,412,SF
2015,32,53,937,109,255,0,1,109,254,41,87,94,174,268,70,22,52,62,126,259,PF
2015,32,12,79,4,12,0,0,4,12,3,5,5,15,20,5,1,0,5,11,11,PF
2015,32,41,858,105,243,0,1,105,242,38,82,89,159,248,65,21,52,57,115,248,PF
2015,36,60,1132,120,207,4,13,116,194,76,114,76,223,299,43,26,61,40,88,320,C
2015,32,74,1744,195,440,73,210,122,230,82,101,31,173,204,83,56,5,60,148,545,SG
2015,21,33,358,31,89,3,11,28,78,9,14,5,67,72,28,15,7,10,28,74,SF
2015,26,61,1675,291,729,122,359,169,370,129,151,108,187,295,55,33,20,62,113,833,PF
2015,20,81,2541,383,780,7,44,376,736,257,347,100,442,542,207,73,85,173,254,1030,SG
2015,30,40,1428,358,806,61,179,297,627,189,237,72,192,264,122,40,17,89,87,966,SF
2015,32,49,406,36,62,0,0,36,62,15,22,32,61,93,5,12,49,12,55,87,C
2015,32,63,1037,108,296,52,173,56,123,88,123,58,131,189,49,18,14,49,132,356,C
2015,29,82,2930,366,910,194,555,172,355,122,143,77,382,459,209,152,17,141,186,1048,SF
2015,26,58,988,155,384,26,110,129,274,46,59,53,118,171,57,48,26,47,146,382,PF
2015,28,76,1982,213,412,0,0,213,412,131,225,244,504,748,72,29,54,95,144,557,C
2015,27,82,1964,258,647,83,246,175,401,178,205,20,141,161,353,49,3,145,93,777,PG
2015,27,54,1287,189,461,49,150,140,311,147,169,13,87,100,265,33,2,110,61,574,PG
2015,27,28,677,69,186,34,96,35,90,31,36,7,54,61,88,16,1,35,32,203,PG
2015,27,51,383,55,95,0,0,55,95,27,36,37,80,117,14,8,8,26,60,137,PF
2015,25,63,830,92,192,59,115,33,77,13,19,12,99,111,24,17,11,26,63,256,SF
2015,24,18,64,3,14,0,0,3,14,4,5,6,2,8,1,2,1,3,8,10,PF
2015,32,66,982,183,386,43,112,140,274,58,74,23,68,91,99,41,8,44,87,467,SG
2015,30,77,1362,225,536,54,167,171,369,76,94,23,111,134,263,33,1,70,104,580,PG
2015,29,29,785,164,361,15,41,149,320,87,107,32,95,127,46,2,27,42,53,430,C
2015,22,82,2318,316,656,87,215,229,441,108,150,117,336,453,116,61,19,71,146,827,SF
2015,34,76,2271,277,624,136,376,141,248,74,95,51,251,302,114,67,50,87,240,764,SF
2015,33,16,143,12,39,2,4,10,35,6,12,14,14,28,5,4,2,5,26,32,C
2015,24,58,983,150,353,23,85,127,268,74,94,26,136,162,81,48,19,61,70,397,SG
2015,24,30,300,38,100,4,18,34,82,10,15,3,31,34,27,14,4,17,20,90,SG
2015,24,28,683,112,253,19,67,93,186,64,79,23,105,128,54,34,15,44,50,307,SG
2015,29,82,1929,344,683,9,32,335,651,169,214,139,259,398,104,41,32,83,140,866,PF
2015,26,71,2380,240,600,100,309,140,291,84,98,62,354,416,341,78,40,132,106,664,SF
2015,26,77,1717,220,516,37,120,183,396,121,137,22,189,211,233,59,12,133,163,598,PG
2015,28,70,1122,185,327,1,4,184,323,90,104,109,209,318,35,16,22,65,162,461,C
2015,25,75,1324,141,331,48,132,93,199,60,100,21,201,222,78,52,33,73,127,390,SG
2015,21,63,2107,363,851,106,259,257,592,130,166,57,184,241,194,76,18,123,136,962,SG
2015,26,24,505,92,212,8,34,84,178,20,26,12,77,89,32,15,13,37,66,212,PF
2015,28,62,1388,199,470,86,230,113,240,84,99,26,131,157,94,31,3,61,85,568,SG
2015,21,57,894,125,297,7,23,118,274,41,64,52,164,216,48,27,16,36,87,298,PF
2015,26,56,1727,204,532,115,323,89,209,45,60,67,170,237,192,59,23,83,182,568,PG
2015,22,3,3,1,2,0,0,1,2,0,0,0,1,1,1,0,1,0,0,2,C
2015,22,64,1243,101,186,0,0,101,186,102,175,159,248,407,16,18,99,52,140,304,C
2015,23,63,1196,157,273,0,1,157,272,65,118,142,226,368,42,19,24,48,158,379,C
2015,23,25,393,45,83,0,1,45,82,15,29,58,69,127,8,6,2,19,56,105,C
2015,23,38,803,112,190,0,0,112,190,50,89,84,157,241,34,13,22,29,102,274,C
2015,25,29,180,26,57,0,0,26,57,4,6,16,40,56,3,7,1,13,41,56,PF
2015,34,81,1529,122,327,77,219,45,108,29,41,16,121,137,288,41,5,104,118,350,PG
2015,25,81,2800,468,1046,88,272,380,774,353,441,72,351,423,493,127,45,274,189,1377,PG
2015,22,2,74,9,30,2,10,7,20,2,5,2,7,9,8,3,0,6,4,22,SG
2015,25,78,1854,261,576,91,256,170,320,87,106,50,163,213,68,34,9,78,104,700,SF
2015,30,67,1583,200,355,0,0,200,355,22,42,141,402,543,180,39,113,106,188,422,C
2015,34,72,935,94,230,46,126,48,104,30,37,29,86,115,47,10,12,11,65,264,PF
2015,27,79,1564,226,464,29,84,197,380,86,148,139,258,397,83,43,41,88,144,567,PF
2015,33,71,1692,371,743,0,0,371,743,94,150,111,371,482,95,41,12,92,184,836,PF
2015,30,44,1556,343,745,63,168,280,577,179,232,46,264,310,95,41,25,95,69,928,C
2015,24,77,2428,434,1012,124,352,310,660,79,100,46,195,241,135,82,15,109,177,1071,SG
2015,35,36,486,42,95,0,1,42,94,12,23,28,72,100,22,17,25,18,54,96,C
2015,28,80,2087,343,805,63,235,280,570,168,226,80,217,297,173,114,19,131,173,917,SF
2015,28,24,680,94,225,8,41,86,184,55,78,32,62,94,78,54,4,50,62,251,SF
2015,28,56,1407,249,580,55,194,194,386,113,148,48,155,203,95,60,15,81,111,666,SF
2015,30,82,1885,344,817,121,313,223,504,145,174,32,134,166,261,54,15,157,189,954,PG
2015,22,19,568,70,170,23,62,47,108,64,85,3,33,36,40,12,2,32,33,227,SG
2015,24,29,549,52,122,6,28,46,94,12,19,14,56,70,90,28,6,30,49,122,PG
2015,23,47,781,76,210,17,64,59,146,47,57,16,91,107,39,31,12,27,57,216,SG
2015,29,5,89,7,19,3,7,4,12,3,4,0,1,1,3,4,0,4,8,20,SG
2015,36,35,1207,266,713,54,184,212,529,196,241,26,173,199,197,47,7,128,65,782,SG
2015,26,67,1286,169,390,52,143,117,247,67,81,33,165,198,64,44,10,49,72,457,SF
2015,23,36,338,24,70,15,46,9,24,6,9,1,49,50,8,10,4,8,19,69,SF
2015,23,25,263,23,54,15,39,8,15,4,5,0,40,40,6,9,2,6,17,65,SF
2015,23,11,75,1,16,0,7,1,9,2,4,1,9,10,2,1,2,2,2,4,SF
2015,22,76,2288,370,1005,124,390,246,615,109,145,31,173,204,328,65,15,124,119,973,PG
2015,23,27,899,121,300,26,68,95,232,106,129,19,95,114,82,17,5,52,64,374,SG
2015,34,78,1623,161,396,83,219,78,177,55,61,21,175,196,79,43,4,49,120,460,SF
2015,25,65,2513,421,912,73,193,348,719,386,463,114,265,379,212,114,36,93,108,1301,SG
2015,35,75,1505,218,517,91,235,127,282,53,67,27,170,197,63,29,22,48,98,580,SF
2015,25,6,123,18,40,7,11,11,29,9,10,2,10,12,14,3,0,12,3,52,PG
2015,32,7,67,10,31,0,9,10,22,2,4,2,4,6,18,1,1,8,9,22,SG
2015,19,8,23,4,12,2,3,2,9,0,0,1,1,2,0,0,1,4,3,10,SF
2015,25,58,838,104,247,11,43,93,204,24,45,19,87,106,146,63,5,61,100,243,SG
2015,33,42,1270,147,354,59,142,88,212,29,32,19,105,124,198,31,0,75,76,382,PG
2015,21,82,2587,390,972,153,444,237,528,110,158,46,209,255,109,93,18,94,161,1043,SG
2015,23,47,938,146,378,91,246,55,132,49,60,18,69,87,98,29,3,62,83,432,PG
2015,23,25,369,53,131,32,84,21,47,16,21,11,22,33,29,14,0,23,28,154,PG
2015,23,22,569,93,247,59,162,34,85,33,39,7,47,54,69,15,3,39,55,278,PG
2015,20,12,90,14,29,0,0,14,29,4,23,10,26,36,2,1,9,5,14,32,C
2015,28,70,2189,318,653,120,304,198,349,127,181,99,273,372,118,94,17,75,154,883,SF
2015,38,66,1091,135,406,69,232,66,174,45,57,27,106,133,79,43,14,43,102,384,SG
2015,23,66,2149,364,919,36,153,328,766,202,291,64,289,353,442,111,30,253,167,966,PG
2015,23,41,1391,232,611,32,125,200,486,117,182,43,211,254,302,60,18,174,103,613,PG
2015,23,25,758,132,308,4,28,128,280,85,109,21,78,99,140,51,12,79,64,353,PG
2015,26,67,1416,209,427,35,87,174,340,140,191,54,206,260,102,31,9,88,107,593,SF
2015,28,80,2368,267,663,73,248,194,415,206,266,24,182,206,307,122,10,173,251,813,PG
2015,32,75,2286,293,440,0,0,293,440,185,257,294,570,864,84,42,91,105,169,771,C
2015,27,78,2471,418,975,139,406,279,569,110,142,96,379,475,134,58,29,110,231,1085,SF
2015,23,8,69,5,19,2,9,3,10,3,6,1,4,5,8,6,1,4,10,15,PG
2015,26,4,29,3,12,0,4,3,8,0,0,2,4,6,0,1,0,1,6,6,SG
2015,27,10,93,11,30,4,14,7,16,1,4,1,22,23,3,3,4,6,12,27,PF
2015,23,30,192,19,55,10,30,9,25,9,9,4,12,16,12,9,3,9,20,57,SG
2015,23,23,161,15,44,9,25,6,19,5,5,4,9,13,10,6,2,7,12,44,SG
2015,23,7,31,4,11,1,5,3,6,4,4,0,3,3,2,3,1,2,8,13,SG
2015,22,59,1476,267,596,38,121,229,475,131,158,56,135,191,206,51,12,96,109,703,PG
2015,26,10,76,9,20,6,11,3,9,0,0,3,17,20,1,1,1,4,12,24,SF
2015,26,75,1831,230,558,55,176,175,382,58,81,13,146,159,255,57,15,99,124,573,PG
2015,26,47,1148,118,306,27,102,91,204,32,46,12,96,108,165,42,8,58,75,295,PG
2015,26,28,683,112,252,28,74,84,178,26,35,1,50,51,90,15,7,41,49,278,PG
2015,27,45,1565,260,550,60,161,200,389,145,184,19,124,143,252,67,14,112,95,725,PG
2015,34,66,1101,106,253,16,60,90,193,45,65,90,160,250,90,35,25,45,156,273,PF
2015,27,70,2225,393,882,107,277,286,605,214,249,29,180,209,375,89,14,156,139,1107,PG
2015,23,16,87,9,22,0,0,9,22,9,21,10,15,25,1,6,3,3,23,27,PF
2015,30,50,828,112,310,52,167,60,143,33,45,23,88,111,51,11,11,59,78,309,SF
2015,22,15,159,29,69,7,20,22,49,15,18,3,15,18,15,4,0,12,6,80,PG
2015,24,59,2013,498,1066,2,8,496,1058,423,541,185,562,747,210,90,103,254,241,1421,C
2015,24,70,1956,299,756,167,446,132,310,178,217,65,251,316,105,97,31,128,189,943,SF
2015,22,51,683,63,153,30,85,33,68,12,16,7,66,73,39,19,15,15,74,168,SG
2015,34,64,1703,332,839,119,364,213,475,227,252,18,106,124,158,59,14,92,108,1010,SG
2015,24,82,1647,229,545,61,208,168,337,109,141,72,221,293,94,72,25,49,137,628,SF
2015,24,25,265,33,76,13,38,20,38,10,11,12,17,29,12,15,5,10,26,89,SF
2015,24,57,1382,196,469,48,170,148,299,99,130,60,204,264,82,57,20,39,111,539,SF
2015,27,66,1652,155,339,1,10,154,329,29,47,70,186,256,50,46,37,35,101,340,PF
2015,23,19,89,12,33,4,13,8,20,7,13,1,8,9,10,3,0,7,12,35,SG
2015,24,2,8,0,3,0,1,0,2,0,0,0,2,2,1,0,0,0,2,0,PG
2015,26,80,2613,653,1341,286,646,367,695,308,337,56,285,341,619,163,16,249,158,1900,PG
2015,33,32,544,57,130,0,0,57,130,14,20,53,115,168,29,14,41,39,70,128,C
2015,23,47,397,61,165,43,118,18,47,11,13,8,25,33,22,6,1,20,40,176,SG
2015,23,17,108,15,47,13,43,2,4,3,4,0,6,6,4,0,0,5,14,46,SG
2015,23,19,154,19,59,13,39,6,20,2,2,6,13,19,13,3,0,8,14,53,SG
2015,23,11,135,27,59,17,36,10,23,6,7,2,6,8,5,3,1,7,12,77,SG
2015,27,21,209,43,89,18,40,25,49,1,1,3,26,29,9,2,7,9,15,105,SF
2015,27,3,17,5,12,1,4,4,8,0,0,1,3,4,2,1,0,2,1,11,SF
2015,27,18,192,38,77,17,36,21,41,1,1,2,23,25,7,1,7,7,14,94,SF
2015,23,27,423,55,137,8,34,47,103,24,37,38,45,83,30,18,7,29,59,142,PF
2015,23,20,379,49,119,7,30,42,89,21,33,35,38,73,28,17,4,25,54,126,PF
2015,23,7,44,6,18,1,4,5,14,3,4,3,7,10,2,1,3,4,5,16,PF
2015,21,68,2455,642,1199,1,12,641,1187,371,461,173,523,696,149,100,200,95,141,1656,PF
2015,25,79,1840,282,469,0,0,282,469,92,189,230,370,600,94,49,98,58,202,656,PF
2015,29,74,904,117,255,0,4,117,251,60,95,43,126,169,39,41,21,39,132,294,PF
2015,26,34,344,50,141,24,71,26,70,5,6,10,65,75,17,12,5,23,39,129,SF
2015,26,26,268,40,115,19,57,21,58,4,4,6,55,61,9,8,3,18,30,103,SF
2015,26,8,76,10,26,5,14,5,12,1,2,4,10,14,8,4,2,5,9,26,SF
2015,25,59,845,91,162,0,1,91,161,34,64,118,177,295,9,16,50,51,141,216,C
2015,24,67,1380,111,307,68,167,43,140,29,38,37,89,126,204,24,2,61,152,319,SG
2015,29,72,2421,369,787,78,220,291,567,191,251,103,273,376,139,65,22,108,109,1007,SF
2015,25,60,2100,409,990,25,88,384,902,361,434,41,236,277,210,73,11,137,122,1204,SG
2015,32,81,1984,291,632,54,169,237,463,72,93,78,270,348,233,36,23,126,148,708,PF
2015,25,73,2193,259,512,1,6,258,506,191,244,223,386,609,146,71,126,126,188,710,C
2015,21,34,455,51,169,12,65,39,104,31,34,4,44,48,104,19,6,33,53,145,PG
2015,31,69,854,80,145,0,1,80,144,24,83,103,176,279,25,40,25,41,157,184,PF
2015,28,12,177,19,51,5,18,14,33,8,13,2,20,22,24,11,4,10,20,51,SG
2015,28,12,103,5,21,1,7,4,14,8,8,1,11,12,4,1,0,0,14,19,SG
2015,28,52,1735,340,679,66,186,274,493,97,130,51,134,185,211,50,9,114,120,843,SG
2015,28,26,905,162,323,24,73,138,250,84,104,30,59,89,139,28,6,59,75,432,PG
2015,25,16,75,11,30,3,14,8,16,3,5,5,3,8,5,2,0,5,6,28,SG
2015,25,6,13,2,8,0,5,2,3,2,3,2,1,3,1,0,0,0,1,6,SG
2015,25,10,62,9,22,3,9,6,13,1,2,3,2,5,4,2,0,5,5,22,SG
2015,24,12,219,20,58,4,26,16,32,2,3,1,14,15,45,6,0,25,13,46,PG
2015,21,82,2502,494,961,0,2,494,959,142,365,437,667,1104,55,73,153,120,285,1130,C
2015,29,72,1717,198,423,74,192,124,231,48,67,45,175,220,130,72,11,62,113,518,SG
2015,38,77,2227,419,819,2,7,417,812,230,311,170,534,704,230,63,151,131,165,1070,C
2015,34,63,1838,209,481,107,263,102,218,70,87,28,220,248,114,39,21,60,123,595,SF
2015,26,27,913,238,467,64,159,174,308,146,171,16,162,178,110,24,25,74,40,686,SF
2015,23,39,647,76,214,22,84,54,130,36,48,22,75,97,36,24,12,40,57,210,SF
2015,27,65,1675,254,617,90,243,164,374,52,64,31,179,210,105,33,2,50,77,650,SG
2015,29,80,2699,602,1354,81,284,521,1070,228,303,34,156,190,329,148,25,198,197,1513,SG
2015,24,62,1051,101,247,31,95,70,152,79,94,51,125,176,48,25,17,39,89,312,SF
2015,20,33,411,52,144,12,43,40,101,5,7,7,28,35,73,18,5,42,36,121,PG
2015,20,8,58,9,21,2,6,7,15,2,2,1,6,7,14,0,2,8,3,22,PG
2015,20,25,353,43,123,10,37,33,86,3,5,6,22,28,59,18,3,34,33,99,PG
2015,27,38,266,32,58,2,5,30,53,24,29,26,45,71,13,11,12,5,29,90,SF
2015,34,47,764,58,137,0,2,58,135,60,97,97,202,299,32,22,5,45,91,176,PF
2015,25,79,2690,521,1165,69,227,452,938,202,291,82,334,416,521,100,37,246,198,1313,SG
2015,19,82,1817,145,416,83,264,62,152,20,32,27,104,131,198,41,14,118,147,393,PG
2015,25,46,504,76,139,0,0,76,139,49,78,60,95,155,9,7,42,32,77,201,C
2015,25,75,2086,373,736,1,8,372,728,199,288,242,426,668,89,62,57,118,211,946,PF
2015,28,36,529,61,158,35,97,26,61,10,11,8,34,42,67,20,5,32,52,167,PG
2015,23,74,2280,482,918,1,6,481,912,222,332,196,411,607,112,60,123,121,210,1187,PF
2015,30,29,281,43,106,10,34,33,72,12,15,2,24,26,41,11,4,18,17,108,PG
2015,26,26,216,20,41,1,2,19,39,5,6,10,16,26,15,11,0,8,9,46,SF
2015,22,58,1661,253,575,85,225,168,350,107,147,28,125,153,120,40,2,82,116,698,SG
2015,31,50,1087,148,402,94,263,54,139,45,55,9,76,85,119,34,11,60,97,435,SG
2015,24,11,239,21,61,5,17,16,44,10,21,6,22,28,60,8,0,25,26,57,PG
2015,24,6,171,13,43,3,11,10,32,5,15,4,15,19,43,6,0,18,16,34,PG
2015,24,5,68,8,18,2,6,6,12,5,6,2,7,9,17,2,0,7,10,23,PG
2015,25,50,509,63,166,9,48,54,118,43,45,8,32,40,58,15,2,33,43,178,PG
2015,27,48,617,74,151,0,0,74,151,21,25,62,129,191,16,9,23,23,93,169,C
2015,31,75,1870,191,487,136,346,55,141,31,35,27,266,293,94,47,39,78,191,549,PF
2015,26,59,1426,228,568,107,301,121,267,171,191,31,187,218,83,47,20,57,94,734,SF
2015,23,45,1457,204,511,62,176,142,335,63,78,37,153,190,150,52,12,61,129,533,PG
2015,33,14,200,17,63,10,45,7,18,1,4,3,14,17,15,9,5,10,20,45,SF
2015,38,47,952,143,306,1,7,142,299,36,45,48,263,311,77,46,17,46,109,323,PF
2015,38,42,854,125,275,1,6,124,269,34,41,46,239,285,69,41,13,45,96,285,PF
2015,38,5,98,18,31,0,1,18,30,2,4,2,24,26,8,5,4,1,13,38,PF
2015,30,81,2687,530,1072,3,17,527,1055,350,440,115,515,630,307,70,131,176,208,1413,C
2015,34,78,2681,570,1153,12,26,558,1127,294,366,220,699,919,210,25,147,158,147,1446,PF
2015,28,68,2408,508,1116,79,220,429,896,337,393,98,301,399,250,71,41,183,157,1432,SF
2015,27,54,662,87,186,13,35,74,151,54,77,37,57,94,25,35,7,33,58,241,SF
2015,27,39,511,66,137,10,24,56,113,48,65,29,41,70,19,28,6,25,42,190,SF
2015,27,15,151,21,49,3,11,18,38,6,12,8,16,24,6,7,1,8,16,51,SF
2015,24,6,91,18,49,9,22,9,27,8,11,4,18,22,6,5,1,12,11,53,SF
2015,29,62,1692,254,506,0,0,254,506,132,184,162,234,396,71,36,75,77,162,640,PF
2015,37,70,1587,251,589,89,258,162,331,147,204,28,183,211,293,67,20,154,138,738,SG
2015,22,82,2158,258,427,0,2,258,425,170,273,265,510,775,109,64,189,111,175,686,C
2015,33,51,864,110,276,23,59,87,217,34,44,72,151,223,49,21,9,28,91,277,PF
2015,20,41,535,79,201,12,41,67,160,61,83,27,47,74,44,18,9,48,55,231,SG
2015,19,47,797,93,208,13,48,80,160,44,61,46,123,169,33,21,22,38,83,243,PF
2015,31,56,790,129,295,35,97,94,198,56,67,6,57,63,50,14,1,55,60,349,SG
2015,24,9,71,8,19,0,3,8,16,1,2,7,11,18,2,1,0,8,7,17,PF
2015,26,61,2018,285,694,141,315,144,379,107,133,28,131,159,229,50,14,122,145,818,SG
2015,30,82,2453,439,775,0,3,439,772,123,175,180,537,717,97,49,110,100,191,1001,C
2015,31,30,613,65,162,30,84,35,78,28,37,20,60,80,17,13,6,24,67,188,SF
2015,20,65,1377,124,352,49,156,75,196,114,193,49,149,198,79,40,68,85,144,411,SF
2015,27,81,2312,322,738,191,457,131,281,111,127,54,289,343,158,101,87,93,163,946,SG
2015,24,79,2490,339,765,111,329,228,436,132,200,114,533,647,291,123,99,133,253,921,PF
2015,23,43,410,61,162,14,47,47,115,10,12,7,24,31,39,12,0,14,26,146,PG
2015,29,74,1446,324,778,137,387,187,391,99,120,33,153,186,91,42,12,104,145,884,SG
2015,24,24,164,27,47,0,6,27,41,8,10,19,26,45,4,5,5,14,25,62,PF
2015,24,4,25,4,7,0,2,4,5,0,0,3,3,6,0,0,2,2,6,8,PF
2015,24,20,139,23,40,0,4,23,36,8,10,16,23,39,4,5,3,12,19,54,PF
2015,28,78,2454,416,967,97,292,319,675,239,287,64,264,328,134,53,34,108,147,1168,SF
2015,28,33,1093,206,475,47,154,159,321,121,144,21,120,141,53,27,13,56,66,580,SF
2015,28,45,1361,210,492,50,138,160,354,118,143,43,144,187,81,26,21,52,81,588,SF
2015,33,52,951,118,306,42,121,76,185,28,34,14,65,79,68,26,5,48,81,306,SG
2015,25,67,2356,574,1144,10,25,564,1119,311,427,126,382,508,354,63,35,152,196,1469,PF
2015,26,20,175,22,41,0,3,22,38,9,13,5,20,25,22,6,0,12,25,53,PG
2015,26,10,44,7,14,0,1,7,13,2,3,0,7,7,7,1,0,3,9,16,PG
2015,26,10,131,15,27,0,2,15,25,7,10,5,13,18,15,5,0,9,16,37,PG
2015,22,45,687,87,269,49,163,38,106,31,36,22,70,92,21,21,13,22,61,254,SG
2015,24,14,122,14,35,10,21,4,14,0,0,2,14,16,7,2,0,4,14,38,SF
2015,24,41,712,85,178,10,31,75,147,39,47,57,77,134,36,27,30,26,70,219,C
2015,24,24,289,27,65,6,19,21,46,6,7,24,24,48,12,8,5,8,33,66,C
2015,24,17,423,58,113,4,12,54,101,33,40,33,53,86,24,19,25,18,37,153,C
2015,29,74,1058,86,165,1,7,85,158,97,139,106,159,265,21,30,15,20,141,270,PF
2015,22,70,1681,279,717,121,354,158,363,125,156,12,144,156,127,20,14,82,119,804,SG
2015,25,81,2981,647,1470,208,555,439,915,715,824,75,384,459,565,154,60,321,208,2217,SG
2015,21,45,674,63,158,10,56,53,102,22,41,38,68,106,25,32,9,27,66,158,SF
2015,31,76,1685,219,524,95,266,124,258,132,162,13,122,135,237,78,14,85,147,665,PG
2015,20,55,719,66,217,21,103,45,114,35,47,21,43,64,29,39,7,38,71,188,SG
2015,23,51,493,48,120,31,84,17,36,9,15,7,34,41,26,7,2,27,62,136,SG
2015,22,68,2369,442,949,87,239,355,710,193,245,73,357,430,124,69,36,115,134,1164,SF
2015,34,62,995,107,239,2,10,105,229,45,64,71,187,258,46,21,13,41,113,261,PF
2015,26,73,1274,163,415,55,176,108,239,44,68,30,228,258,88,24,53,61,173,425,PF
2015,31,29,255,22,46,0,0,22,46,6,11,18,33,51,20,10,4,8,37,50,C
2015,24,76,2618,484,1087,120,330,364,757,375,462,54,319,373,313,108,30,206,131,1463,SF
2015,35,22,119,14,30,0,0,14,30,7,13,6,23,29,2,2,10,10,17,35,C
2015,27,80,2315,370,847,45,136,325,711,184,217,36,237,273,206,51,22,110,135,969,SG
2015,23,9,86,3,13,0,0,3,13,14,24,2,2,4,3,3,0,3,6,20,SF
2015,24,67,1228,196,346,0,0,196,346,78,137,124,188,312,59,28,135,87,152,470,C
2015,28,76,1926,317,710,0,2,317,708,168,204,156,384,540,84,18,125,107,216,802,C
2015,26,73,1411,218,459,0,2,218,457,116,201,150,302,452,57,36,35,96,136,552,C
2015,32,67,1693,307,601,1,5,306,596,122,202,84,261,345,123,66,22,124,180,737,PF
2015,28,43,1267,255,535,69,193,186,342,113,143,25,154,179,220,44,14,69,111,692,PG
2015,27,70,1874,357,777,3,11,354,766,124,168,174,382,556,103,34,52,106,164,841,C
2015,23,82,2381,251,634,68,208,183,426,159,193,70,244,314,184,66,18,115,177,729,SF
2015,34,66,1610,142,381,58,168,84,213,35,50,20,101,121,148,46,14,73,144,377,SG
2015,24,40,1303,238,534,51,135,187,399,65,76,32,103,135,274,63,23,91,110,592,PG
2015,25,59,657,91,235,35,109,56,126,37,45,12,61,73,48,40,12,29,54,254,SG
2015,30,46,441,53,82,0,0,53,82,31,54,36,67,103,14,6,19,25,65,137,C
2015,22,50,1064,155,374,62,170,93,204,61,80,9,108,117,83,30,12,45,119,433,SG
2015,28,76,2318,519,965,11,36,508,929,107,141,131,413,544,244,68,98,100,121,1156,C
2015,29,41,1223,251,423,1,2,250,421,143,271,110,321,431,50,28,53,115,137,646,C
2015,30,5,56,6,14,3,6,3,8,3,4,1,7,8,5,6,1,3,4,18,SG
2015,25,45,742,79,172,16,51,63,121,24,29,31,103,134,27,16,9,18,86,198,SF
2015,29,64,1345,211,446,0,7,211,439,87,117,118,298,416,57,34,25,46,130,509,PF
2015,25,64,2116,374,786,77,205,297,581,92,110,135,364,499,55,30,155,97,194,917,PF
2015,31,77,2069,231,496,74,212,157,284,68,114,44,213,257,228,89,25,88,100,604,SF
2015,27,58,1319,263,557,74,190,189,367,69,107,80,197,277,56,36,19,45,149,669,PF
2015,27,79,1673,147,354,72,202,75,152,30,40,22,153,175,182,72,10,98,124,396,SF
2015,22,75,2730,578,1235,157,378,421,857,315,365,55,182,237,389,114,20,186,146,1628,PG
2015,31,80,2241,359,817,39,146,320,671,200,227,19,226,245,373,75,13,191,143,957,PG
2015,24,77,2268,432,996,72,241,360,755,181,218,56,271,327,462,62,9,186,167,1117,PG
2015,24,50,1398,249,576,44,158,205,418,99,115,28,173,201,214,42,5,91,94,641,PG
2015,24,27,870,183,420,28,83,155,337,82,103,28,98,126,248,20,4,95,73,476,PG
2015,29,16,158,12,27,0,0,12,27,20,23,18,21,39,4,2,15,6,17,44,C
2015,30,69,2493,624,1279,120,339,504,940,375,528,51,365,416,511,109,49,272,135,1743,SF
2015,30,65,1992,486,1010,2,5,484,1005,108,165,99,449,548,113,47,84,68,139,1082,C
2015,24,50,531,75,167,2,15,73,152,31,54,47,98,145,16,10,21,20,61,183,PF
2015,34,74,1244,144,324,66,155,78,169,78,114,25,158,183,61,32,11,52,115,432,SF
2015,23,24,297,49,99,21,52,28,47,16,19,2,37,39,13,10,0,8,15,135,SG
2015,25,41,1173,218,543,76,211,142,332,120,143,21,83,104,272,44,4,90,64,632,PG
2015,27,75,1230,169,379,54,140,115,239,56,66,93,189,282,71,46,18,44,135,448,PF
2015,27,46,703,91,198,28,76,63,122,31,36,47,95,142,41,27,11,26,77,241,PF
2015,27,29,527,78,181,26,64,52,117,25,30,46,94,140,30,19,7,18,58,207,PF
2015,21,8,51,7,26,1,15,6,11,1,1,2,7,9,3,2,2,3,11,16,PF
2015,21,5,25,3,17,1,13,2,4,0,0,1,3,4,1,0,2,2,7,7,PF
2015,21,3,26,4,9,0,2,4,7,1,1,1,4,5,2,2,0,1,4,9,PF
2015,27,75,1979,298,519,19,46,279,473,79,129,159,297,456,117,44,59,110,225,694,PF
2015,24,29,526,62,154,28,95,34,59,14,16,8,47,55,15,26,7,15,44,166,SF
2015,24,9,187,19,60,10,39,9,21,6,8,3,23,26,3,9,5,9,19,54,SF
2015,24,12,211,31,64,13,38,18,26,6,6,3,15,18,7,12,0,6,18,81,SF
2015,24,8,128,12,30,5,18,7,12,2,2,2,9,11,5,5,2,0,7,31,SF
2015,27,70,1370,238,404,11,51,227,353,67,102,61,196,257,95,54,70,79,155,554,PF
2015,33,80,2791,446,1025,121,337,325,688,141,176,53,331,384,292,59,14,137,120,1154,SG
2015,22,28,262,26,75,5,21,21,54,17,25,13,26,39,11,7,3,19,34,74,SG
2015,22,32,603,70,167,18,48,52,119,32,47,14,67,81,42,33,9,30,42,190,SG
2015,27,76,2245,286,691,91,259,195,432,90,112,67,252,319,124,59,45,87,162,753,SF
2015,34,33,123,6,21,0,4,6,17,9,11,1,10,11,2,3,0,1,23,21,SF
2015,34,57,669,74,201,63,175,11,26,39,46,9,53,62,24,13,8,13,67,250,SF
2015,23,43,631,73,184,14,60,59,124,24,37,6,70,76,18,17,8,24,50,184,SF
2015,23,33,889,158,299,13,37,145,262,57,94,78,142,220,36,18,59,37,78,386,PF
2015,26,82,2820,379,534,1,4,378,530,187,471,397,829,1226,61,81,183,109,245,946,C
2015,28,44,383,50,94,0,0,50,94,38,44,52,53,105,13,8,15,22,58,138,C
2015,23,79,1444,207,411,16,44,191,367,105,143,44,148,192,188,46,17,67,105,535,PG
2015,32,74,1398,283,549,0,0,283,549,72,102,149,335,484,65,18,54,108,140,638,C
2015,22,75,2135,482,928,16,45,466,883,183,234,277,394,671,55,36,29,145,189,1163,C
2015,22,49,1326,286,582,13,41,273,541,93,118,147,237,384,26,23,16,93,114,678,C
2015,22,26,809,196,346,3,4,193,342,90,116,130,157,287,29,13,13,52,75,485,C
2015,21,33,555,54,134,16,54,38,80,29,38,22,44,66,46,23,1,24,45,153,SG
2015,23,52,1233,104,309,45,134,59,175,79,95,13,133,146,92,30,24,37,118,332,PF
2015,21,55,1587,224,482,0,0,224,482,150,214,109,307,416,77,30,38,63,115,598,SF
2015,25,4,72,7,20,4,13,3,7,4,4,1,5,6,4,3,0,2,3,22,SG
2015,33,7,36,0,5,0,0,0,5,3,4,2,6,8,1,1,0,1,1,3,SF
2015,23,5,14,1,4,0,0,1,4,2,2,1,0,1,1,0,0,0,1,4,C
2015,23,52,1688,324,745,104,254,220,491,171,194,26,195,221,281,84,9,166,93,923,PG
2015,23,11,347,51,143,21,67,30,76,24,29,2,21,23,49,6,1,23,21,147,SG
2015,33,75,2418,292,600,221,449,71,151,106,118,15,289,304,196,52,42,107,140,911,SG
2015,25,81,1348,182,358,0,0,182,358,55,85,121,305,426,37,29,63,69,148,419,C
2015,24,16,72,8,12,0,0,8,12,4,4,7,10,17,6,2,1,5,13,20,C
2015,22,47,633,104,250,38,111,66,139,49,55,8,99,107,44,21,6,27,52,295,SG
2015,31,70,1192,190,369,0,0,190,369,123,150,99,169,268,26,15,17,54,132,503,PF
2015,22,76,1865,187,432,35,116,152,316,61,78,29,147,176,226,93,9,83,150,470,PG
2015,23,24,268,36,89,3,16,33,73,18,28,27,50,77,13,8,10,22,43,93,C
2015,19,77,1902,286,677,57,167,229,510,149,177,27,187,214,276,54,10,193,158,778,PG
2015,27,75,2665,404,926,70,205,334,721,265,363,42,192,234,720,92,9,185,128,1143,PG
2015,22,17,244,32,96,10,27,22,69,16,22,16,20,36,19,6,1,26,21,90,SG
2015,22,5,11,0,6,0,3,0,3,1,2,1,1,2,1,0,0,2,1,1,SG
2015,22,12,233,32,90,10,24,22,66,15,20,15,19,34,18,6,1,24,20,89,SG
2015,29,77,2354,288,643,90,224,198,419,111,129,21,157,178,151,75,12,78,129,777,SG
2015,31,49,904,160,313,0,2,160,311,68,104,81,176,257,85,31,26,49,83,388,PF
2015,24,1,2,0,1,0,0,0,1,0,0,0,0,0,0,0,0,0,0,0,SG
2015,21,69,1518,179,353,1,3,178,350,73,104,142,312,454,32,34,105,74,213,432,C
2015,23,64,2033,394,822,67,192,327,630,202,252,85,376,461,161,148,48,97,128,1057,SF
2015,22,55,847,125,245,47,112,78,133,30,32,46,204,250,32,10,14,39,113,327,C
2015,25,63,824,121,273,7,29,114,244,37,59,50,157,207,46,17,9,35,86,286,PF
2015,24,82,2925,590,1360,196,572,394,788,344,398,49,329,378,507,97,21,222,164,1720,PG
2015,26,74,1907,277,654,65,176,212,478,213,268,26,170,196,339,82,32,166,189,832,PG
2015,29,78,1468,198,396,0,2,198,394,65,91,43,140,183,259,49,20,102,110,461,PG
2015,26,72,2100,506,987,1,10,505,977,223,274,214,321,535,50,43,126,104,206,1236,C
2015,26,59,1638,234,437,0,1,234,436,98,127,190,204,394,55,16,84,73,122,566,C
2015,26,75,2532,413,952,144,392,269,560,258,321,142,589,731,168,51,39,122,140,1228,PF
2015,28,70,2414,430,1043,132,391,298,652,252,312,54,274,328,473,109,13,173,212,1244,PG
2015,25,1,6,0,1,0,0,0,1,0,0,0,0,0,0,1,0,0,1,0,PG
2015,32,21,272,42,104,9,29,33,75,5,5,4,12,16,60,8,0,16,18,98,PG
2015,24,55,833,117,292,40,127,77,165,25,31,8,71,79,155,30,2,49,32,299,PG
2015,28,61,1146,117,212,0,0,117,212,31,102,105,251,356,33,30,46,59,172,265,C
2015,22,16,208,14,44,4,22,10,22,5,16,5,26,31,17,9,2,9,14,37,SG
2015,36,57,1101,119,267,12,46,107,221,26,34,64,138,202,51,27,27,33,58,276,SF
2015,23,28,417,46,101,18,46,28,55,8,9,2,26,28,86,21,0,35,26,118,PG
2015,30,23,198,15,53,6,33,9,20,0,0,0,20,20,11,3,1,5,20,36,SF
2015,37,11,104,9,22,0,0,9,22,2,2,6,13,19,5,5,6,3,13,20,PF
2015,31,39,1302,267,625,75,191,192,434,170,193,19,123,142,89,33,1,76,76,779,SG
2015,28,60,2024,337,752,173,445,164,307,109,145,38,184,222,139,77,10,81,132,956,SG
2015,31,61,878,81,192,0,0,81,192,41,71,86,117,203,19,18,44,29,96,203,PF
2015,27,71,1697,296,701,99,277,197,424,115,139,30,157,187,197,57,18,128,165,806,SG
2015,28,67,1916,251,636,62,202,189,434,96,163,82,246,328,106,81,21,99,104,660,PF
2015,22,15,137,24,44,0,0,24,44,14,25,15,22,37,2,5,9,6,21,62,PF
2015,23,68,1436,206,470,34,111,172,359,57,84,52,128,180,188,45,11,85,92,503,PG
2015,23,62,973,159,365,55,139,104,226,51,73,14,77,91,64,43,8,48,81,424,SG
2015,21,62,1352,172,434,43,150,129,284,100,133,65,135,200,72,44,70,105,126,487,SG
2015,21,52,1319,167,419,43,147,124,272,99,131,64,131,195,70,44,68,104,121,476,SG
2015,21,10,33,5,15,0,3,5,12,1,2,1,4,5,2,0,2,1,5,11,SG
2015,23,36,321,43,107,13,41,30,66,10,15,6,37,43,6,4,1,17,29,109,SF
2015,22,32,485,88,165,0,2,88,163,25,40,53,112,165,14,16,16,31,72,201,PF
2015,27,23,256,42,79,0,0,42,79,22,33,18,43,61,3,2,20,18,30,106,C
2015,27,17,195,34,61,0,0,34,61,20,29,14,34,48,1,2,19,13,28,88,C
2015,27,6,61,8,18,0,0,8,18,2,4,4,9,13,2,0,1,5,2,18,C
2015,21,82,2670,363,831,140,391,223,440,130,160,31,210,241,140,77,19,138,219,996,SG
2015,27,6,36,3,11,1,2,2,9,2,2,0,3,3,2,3,1,5,5,9,PG
2015,27,17,296,28,53,8,19,20,34,8,13,7,38,45,33,12,3,22,41,72,PF
2015,27,60,1462,222,534,74,212,148,322,145,160,12,92,104,79,59,6,57,76,663,SG
2015,26,4,43,3,20,0,3,3,17,0,0,0,1,1,13,2,0,2,1,6,PG
2015,23,79,2378,406,869,109,268,297,601,134,156,48,299,347,182,122,11,113,183,1055,SF
2015,27,70,1841,329,827,154,446,175,381,130,161,18,196,214,75,60,26,73,132,942,SG
2015,38,81,1253,145,290,7,34,138,256,58,77,37,116,153,284,32,6,104,103,355,PG
2015,38,51,631,77,142,1,8,76,134,28,39,21,56,77,143,14,2,46,56,183,PG
2015,38,30,622,68,148,6,26,62,122,30,38,16,60,76,141,18,4,58,47,172,PG
2015,24,5,43,1,7,0,1,1,6,0,0,0,1,1,2,1,0,1,8,2,SF
2015,34,52,701,37,114,32,98,5,16,3,4,4,87,91,46,14,4,23,74,109,SF
2015,22,10,119,9,38,3,18,6,20,8,11,4,16,20,8,7,5,5,9,29,PF
2015,22,6,61,4,18,1,7,3,11,8,11,2,10,12,3,6,3,3,4,17,PF
2015,22,4,58,5,20,2,11,3,9,0,0,2,6,8,5,1,2,2,5,12,PF
2015,26,51,801,128,336,62,182,66,154,33,40,21,54,75,87,28,2,35,58,351,PG
2015,27,47,924,81,238,28,90,53,148,58,86,28,122,150,58,56,16,67,124,248,SG
2015,29,73,2390,443,930,77,216,366,714,255,337,139,431,570,223,130,69,166,201,1218,PF
2015,23,82,1654,253,624,99,313,154,311,228,284,63,341,404,97,54,54,89,172,833,PF
2015,37,23,128,13,30,0,0,13,30,1,3,11,27,38,3,4,5,7,16,27,C
2015,24,69,2137,423,853,0,0,423,853,252,336,229,475,704,142,78,34,149,148,1098,PF
2015,25,56,504,62,139,13,38,49,101,12,20,12,34,46,33,20,6,14,45,149,SG
2015,23,3,2,1,1,0,0,1,1,0,0,0,1,1,0,0,0,0,1,2,PF
2015,24,38,299,36,106,7,33,29,73,4,9,7,20,27,48,9,0,21,20,83,PG
2015,25,81,2045,331,763,112,313,219,450,71,113,73,312,385,133,63,16,73,188,845,PF
2015,25,82,2581,512,1100,57,179,455,921,177,232,110,396,506,192,101,39,170,245,1258,PF
2015,29,74,1806,285,615,141,325,144,290,79,89,40,155,195,60,54,11,38,135,790,SG
2015,24,71,2037,353,700,49,133,304,567,100,166,137,284,421,130,56,34,123,203,855,PF
2015,28,81,2045,314,566,2,6,312,560,155,216,203,388,591,55,33,97,116,227,785,C
2015,28,35,897,117,232,2,6,115,226,63,86,91,181,272,16,15,41,47,114,299,C
2015,28,46,1148,197,334,0,0,197,334,92,130,112,207,319,39,18,56,69,113,486,C
2015,22,38,866,194,397,20,51,174,346,104,145,63,91,154,44,18,7,35,49,512,SG
2015,25,1,1,0,1,0,0,0,1,0,0,0,0,0,0,0,0,0,0,0,PG
2015,25,4,17,2,4,0,0,2,4,2,2,1,0,1,1,1,0,4,2,6,SG
2015,23,40,502,83,151,9,22,74,129,22,25,52,67,119,25,16,19,21,52,197,PF
2015,23,51,1012,87,228,43,118,44,110,44,56,17,96,113,130,40,4,81,76,261,PG
2015,30,54,1193,188,503,50,164,138,339,117,135,14,115,129,100,23,1,65,88,543,SG
2015,30,43,931,143,398,39,133,104,265,88,102,14,80,94,80,16,1,55,70,413,SG
2015,30,11,262,45,105,11,31,34,74,29,33,0,35,35,20,7,0,10,18,130,SG
2015,32,63,1407,205,504,89,258,116,246,24,36,33,113,146,253,47,6,109,136,523,PG
2015,32,23,584,61,163,38,103,23,60,7,8,14,49,63,95,15,2,39,53,167,PG
2015,32,6,121,9,41,5,25,4,16,6,9,3,14,17,33,7,0,9,13,29,PG
2015,32,34,702,135,300,46,130,89,170,11,19,16,50,66,125,25,4,61,70,327,PG
2015,25,40,492,83,190,13,41,70,149,15,25,17,65,82,22,6,12,24,51,194,PF
2015,29,67,2049,190,427,0,2,190,425,105,174,219,427,646,312,48,74,123,203,485,C
2015,20,75,2311,302,653,0,0,302,653,140,230,185,426,611,128,133,142,146,208,744,C
2015,22,6,23,2,8,0,0,2,8,2,4,2,9,11,1,2,0,2,6,6,C
2015,31,22,109,16,35,16,33,0,2,0,2,1,15,16,6,0,1,3,13,48,SF
2015,31,13,88,6,21,3,15,3,6,0,0,1,5,6,5,0,1,2,10,15,PF
2015,36,77,2282,487,1062,104,274,383,788,255,289,44,413,457,143,39,33,82,160,1333,PF
2015,20,62,1103,171,383,0,2,171,381,84,132,125,257,382,50,52,68,86,207,426,C
2015,21,34,368,44,120,0,0,44,120,12,27,26,38,64,17,5,4,25,44,100,PF
2015,24,51,824,119,242,12,43,107,199,44,57,46,153,199,59,31,39,55,110,294,PF
2015,22,72,2573,473,1086,84,248,389,838,262,320,51,251,302,295,120,19,204,187,1292,SG
2015,23,64,1423,251,528,61,175,190,353,93,136,92,211,303,109,64,39,98,213,656,C
2015,27,6,68,12,14,0,0,12,14,3,8,7,14,21,4,1,3,2,6,27,C
2015,30,73,1730,240,529,0,3,240,526,126,160,197,303,500,178,80,21,133,170,606,C
2015,24,43,795,69,197,31,106,38,91,13,18,39,79,118,85,29,13,55,71,182,SF
2015,35,9,73,15,35,9,22,6,13,2,2,0,3,3,8,0,0,3,8,41,PG
2015,19,25,738,129,263,4,16,125,247,46,66,50,88,138,42,31,5,47,42,308,PF
2015,32,68,1953,404,832,38,89,366,743,130,166,15,114,129,335,44,2,146,108,976,PG
2015,26,66,2186,383,829,132,347,251,482,139,193,64,259,323,161,69,19,96,140,1037,SF
2015,25,81,2156,240,535,105,283,135,252,63,80,127,306,433,155,60,44,54,149,648,PF
2015,29,82,2857,568,1170,139,349,429,821,289,321,52,324,376,838,156,15,190,203,1564,PG
2015,23,32,739,91,220,1,9,90,211,30,46,48,114,162,30,19,9,44,88,213,PF
2015,23,3,19,2,7,0,1,2,6,1,2,1,3,4,0,1,0,0,4,5,PF
2015,23,29,720,89,213,1,8,88,205,29,44,47,111,158,30,18,9,44,84,208,PF
2015,20,82,2489,301,708,11,42,290,666,118,214,107,242,349,533,142,20,203,193,731,PG
2015,29,31,815,139,328,0,0,139,328,108,129,89,145,234,27,19,12,42,59,386,C
2015,30,68,1148,102,227,0,1,102,226,42,83,91,229,320,51,16,42,95,162,246,C
2015,30,51,981,82,186,0,1,82,185,38,75,80,199,279,43,14,38,74,135,202,C
2015,30,17,167,20,41,0,0,20,41,4,8,11,30,41,8,2,4,21,27,44,C
2015,37,73,1914,293,656,118,303,175,353,164,210,45,249,294,144,46,24,92,160,868,SF
2015,24,82,1743,280,489,0,3,280,486,157,317,175,337,512,74,65,63,106,207,717,C
2015,26,73,1194,136,254,0,0,136,254,22,46,112,208,320,34,41,66,51,111,294,C
2015,26,54,1005,107,195,0,0,107,195,19,38,95,179,274,27,35,55,45,99,233,C
2015,26,19,189,29,59,0,0,29,59,3,8,17,29,46,7,6,11,6,12,61,C
2015,26,30,540,48,135,17,73,31,62,21,30,20,37,57,28,5,5,10,47,134,SG
2015,26,45,1253,140,312,74,171,66,141,50,66,33,105,138,66,14,19,41,103,404,SF
2015,21,74,1432,176,391,35,104,141,287,58,79,70,151,221,65,44,30,52,97,445,SF
2015,23,29,236,31,67,3,11,28,56,25,33,18,32,50,9,9,6,11,40,90,PF
2015,23,5,9,4,5,0,0,4,5,1,2,0,1,1,0,2,0,2,1,9,PF
2015,23,24,227,27,62,3,11,24,51,24,31,18,31,49,9,7,6,9,39,81,PF
2015,23,50,600,64,174,16,65,48,109,33,49,13,67,80,117,30,6,41,54,177,PG
2015,28,26,324,51,137,15,57,36,80,16,24,6,26,32,46,7,0,14,15,133,PG
2015,28,10,193,39,89,15,39,24,50,12,18,2,12,14,27,4,0,10,9,105,PG
2015,28,11,87,9,34,0,11,9,23,4,6,4,11,15,13,3,0,3,1,22,PG
2015,28,5,44,3,14,0,7,3,7,0,0,0,3,3,6,0,0,1,5,6,PG
2015,31,43,982,77,223,31,109,46,114,36,45,19,50,69,165,67,4,52,118,221,PG
2015,37,67,1197,91,228,57,166,34,62,35,41,30,89,119,171,79,1,62,88,274,PG
2015,37,43,795,68,161,43,115,25,46,22,26,18,62,80,104,52,1,47,53,201,PG
2015,37,24,402,23,67,14,51,9,16,13,15,12,27,39,67,27,0,15,35,73,PG
2015,34,58,1397,177,402,31,67,146,335,49,65,52,158,210,93,29,16,35,55,434,SF
2015,34,26,628,75,183,15,33,60,150,25,30,21,62,83,37,9,6,15,22,190,SF
2015,34,9,198,33,59,5,8,28,51,5,6,6,24,30,18,5,2,4,7,76,SF
2015,34,23,571,69,160,11,26,58,134,19,29,25,72,97,38,15,8,16,26,168,SF
2015,27,5,23,3,8,0,0,3,8,2,2,2,3,5,0,1,0,2,8,8,C
2015,20,1,14,1,3,0,0,1,3,0,2,0,0,0,0,0,0,1,1,2,PF
2015,31,21,126,9,35,0,5,9,30,6,12,16,22,38,4,5,3,3,16,24,PF
2015,31,16,101,6,25,0,4,6,21,5,10,12,14,26,3,4,2,2,13,17,PF
2015,31,5,25,3,10,0,1,3,9,1,2,4,8,12,1,1,1,1,3,7,PF
2015,33,71,2304,454,932,7,20,447,912,228,298,225,522,747,153,69,14,156,175,1143,PF
2015,30,78,2409,447,938,200,458,247,480,183,203,22,145,167,137,39,8,95,134,1277,SG
2015,24,5,43,3,15,1,7,2,8,4,6,2,2,4,2,0,0,2,11,11,SG
2015,34,19,416,62,178,31,96,31,82,17,22,13,53,66,38,13,3,16,28,172,SG
2015,33,47,683,75,176,20,63,55,113,18,21,8,60,68,96,20,4,38,67,188,PG
2015,22,35,772,86,222,14,50,72,172,53,71,12,56,68,87,18,7,30,65,239,SG
2015,22,41,791,117,274,25,81,92,193,32,55,15,69,84,68,30,7,35,81,291,PG
2015,23,67,1286,92,201,21,85,71,116,23,48,60,195,255,70,53,29,46,141,228,SG
2015,29,72,1330,176,452,62,193,114,259,66,74,13,96,109,162,33,6,57,75,480,PG
2015,21,25,108,8,24,1,6,7,18,12,16,4,10,14,3,3,0,3,5,29,SG
2015,21,10,153,18,43,4,13,14,30,4,8,11,14,25,8,3,1,8,10,44,SF
2015,30,42,591,88,255,31,112,57,143,31,46,17,33,50,97,20,3,30,76,238,PG
2015,30,33,465,71,204,24,92,47,112,26,40,14,25,39,77,14,3,22,68,192,PG
2015,30,9,126,17,51,7,20,10,31,5,6,3,8,11,20,6,0,8,8,46,PG
2015,23,54,798,126,260,0,2,126,258,56,106,95,208,303,33,32,20,59,104,308,PF
2015,23,32,391,47,91,0,0,47,91,21,48,33,100,133,9,16,11,33,54,115,PF
2015,23,22,407,79,169,0,2,79,167,35,58,62,108,170,24,16,9,26,50,193,PF
2015,28,68,2018,275,645,27,86,248,559,31,78,73,300,373,538,91,7,210,153,608,PG
2015,28,22,699,81,200,8,32,73,168,12,36,25,140,165,237,37,3,75,42,182,PG
2015,28,46,1319,194,445,19,54,175,391,19,42,48,160,208,301,54,4,135,111,426,PG
2015,26,51,1530,338,835,76,271,262,564,152,187,35,126,161,251,36,16,161,63,904,PG
2015,23,82,2092,309,753,145,390,164,363,44,56,32,194,226,86,53,25,69,136,807,SF
2015,24,22,692,78,219,13,51,65,168,57,71,19,106,125,193,38,1,64,59,226,PG
2015,28,68,1047,119,263,69,170,50,93,16,23,8,39,47,53,16,5,47,79,323,SF
2015,29,33,271,11,54,3,27,8,27,5,11,4,37,41,12,5,12,11,27,30,SG
2015,25,67,1133,126,306,0,1,126,305,55,82,89,144,233,55,28,43,36,121,307,C
2015,35,21,270,16,48,8,26,8,22,2,4,4,17,21,13,9,4,5,25,42,SF
2015,21,74,1131,146,346,31,127,115,219,63,94,35,128,163,77,38,26,76,135,386,SF
2015,26,27,586,86,172,0,0,86,172,24,48,67,99,166,23,26,39,28,104,196,C
2015,21,77,1516,284,665,52,148,232,517,148,179,29,135,164,317,49,4,150,127,768,PG
2015,34,81,1659,300,642,5,20,295,622,158,226,138,388,526,105,47,18,94,192,763,PF
2015,26,68,1123,201,453,66,192,135,261,61,77,45,154,199,75,25,3,39,83,529,PF
2015,30,52,976,104,249,25,78,79,171,45,58,53,170,223,75,53,21,38,67,278,SF
2015,25,79,1235,231,450,0,2,231,448,58,82,87,201,288,59,10,59,98,197,520,C
2015,28,64,1188,125,334,19,60,106,274,133,173,23,121,144,182,29,0,86,73,402,PG
2015,28,36,642,63,183,6,28,57,155,64,88,13,56,69,96,13,0,51,45,196,PG
2015,28,28,546,62,151,13,32,49,119,69,85,10,65,75,86,16,0,35,28,206,PG
2015,24,62,1545,193,471,67,196,126,275,43,64,55,169,224,135,81,16,91,138,496,SG
2015,24,24,625,88,215,23,66,65,149,25,37,22,59,81,78,30,3,42,67,224,SG
2015,24,38,920,105,256,44,130,61,126,18,27,33,110,143,57,51,13,49,71,272,SG
2015,26,42,767,133,335,47,139,86,196,121,150,23,76,99,106,30,6,48,48,434,SG
2015,26,17,285,52,130,17,57,35,73,48,57,8,14,22,46,14,1,18,21,169,SG
2015,26,9,59,8,24,4,12,4,12,9,11,1,3,4,3,1,0,5,2,29,SG
2015,26,16,423,73,181,26,70,47,111,64,82,14,59,73,57,15,5,25,25,236,SG
2015,24,73,1399,238,502,4,22,234,480,106,137,121,238,359,79,39,30,99,135,586,C
2015,26,80,1743,172,446,96,241,76,205,40,52,33,161,194,85,47,21,55,153,480,SF
2015,26,54,1287,140,350,76,187,64,163,29,36,23,116,139,67,33,14,42,98,385,SF
2015,26,26,456,32,96,20,54,12,42,11,16,10,45,55,18,14,7,13,55,95,SF
2015,27,53,1107,145,355,41,131,104,224,60,77,12,131,143,190,23,0,65,47,391,PG
2015,20,67,1808,175,477,91,272,84,205,82,127,61,161,222,208,99,18,90,176,523,PG
2015,24,42,363,30,49,0,0,30,49,20,39,26,53,79,9,7,11,11,53,80,PF
2015,26,55,832,143,367,18,60,125,307,34,57,15,85,100,180,36,6,78,50,338,PG
2015,26,30,155,15,45,1,5,14,40,6,9,5,22,27,28,4,1,9,12,37,PG
2015,26,25,677,128,322,17,55,111,267,28,48,10,63,73,152,32,5,69,38,301,PG
2015,29,70,2080,315,755,163,426,152,329,54,72,30,188,218,195,82,22,97,163,847,SG
2015,29,24,619,101,251,32,90,69,161,27,39,4,54,58,81,18,4,45,44,261,SG
2015,29,46,1461,214,504,131,336,83,168,27,33,26,134,160,114,64,18,52,119,586,SG
2015,28,82,1785,257,592,15,42,242,550,127,153,98,226,324,140,32,44,104,205,656,C
2015,29,83,2300,414,987,72,228,342,759,127,255,152,378,530,277,87,116,206,228,1027,PF
2015,29,28,896,153,391,9,37,144,354,52,111,52,150,202,132,37,48,72,82,367,PF
2015,29,55,1404,261,596,63,191,198,405,75,144,100,228,328,145,50,68,134,146,660,PF
2015,23,12,65,8,25,2,11,6,14,12,13,1,5,6,8,3,0,12,13,30,PG
2015,23,6,29,2,10,1,6,1,4,0,0,0,3,3,2,0,0,7,6,5,PG
2015,23,6,36,6,15,1,5,5,10,12,13,1,2,3,6,3,0,5,7,25,PG
2015,23,72,1412,159,371,73,197,86,174,44,55,31,145,176,62,32,11,48,86,435,SF
2015,27,76,1207,318,646,5,18,313,628,150,178,109,216,325,72,20,34,82,189,791,C
2015,30,52,1030,169,303,0,0,169,303,90,120,91,161,252,78,35,37,60,103,428,C
2015,21,73,1127,108,296,48,149,60,147,55,64,11,77,88,67,20,17,40,92,319,SG
2015,24,61,1573,207,550,18,105,189,445,69,110,39,238,277,240,38,8,128,134,501,SG
2015,29,17,66,6,8,0,0,6,8,2,4,9,6,15,3,2,0,7,15,14,C
2015,23,3,33,2,6,1,2,1,4,3,6,0,2,2,9,2,0,4,1,8,PG
2015,21,19,126,21,37,0,0,21,37,15,28,16,18,34,4,5,5,7,25,57,PF
2015,32,59,1245,273,490,0,4,273,486,134,186,110,219,329,45,29,38,78,161,680,PF
2015,32,36,865,169,311,0,3,169,308,94,127,83,162,245,37,20,34,63,111,432,PF
2015,32,23,380,104,179,0,1,104,178,40,59,27,57,84,8,9,4,15,50,248,PF
2015,28,71,1874,332,754,55,141,277,613,177,216,36,212,248,219,56,10,118,131,896,PG
2015,22,58,1566,311,708,52,184,259,524,96,129,147,294,441,134,44,42,78,153,770,PF
2015,25,29,430,45,114,11,36,34,78,26,41,14,39,53,22,12,1,19,36,127,SF
2015,26,73,2228,408,887,71,207,337,680,275,319,30,154,184,513,125,31,205,139,1162,PG
2015,29,40,892,122,319,62,193,60,126,33,46,27,167,194,46,14,16,53,74,339,PF
2015,29,16,327,46,125,18,60,28,65,24,34,2,28,30,45,10,0,18,29,134,PG
2015,28,52,735,68,170,33,88,35,82,35,48,24,66,90,56,42,9,34,76,204,SG
2015,37,77,1641,188,446,126,323,62,123,39,48,15,106,121,147,66,19,74,116,541,SG
2015,25,67,1726,335,797,129,346,206,451,302,348,33,120,153,284,57,5,143,150,1101,PG
2015,25,46,1181,218,512,81,207,137,305,184,211,26,83,109,171,45,5,89,105,701,PG
2015,25,21,545,117,285,48,139,69,146,118,137,7,37,44,113,12,0,54,45,400,PG
2015,26,22,450,45,126,0,1,45,125,23,33,28,47,75,20,11,0,17,38,113,SF
2015,26,40,1040,137,316,7,21,130,295,49,66,37,83,120,49,26,8,57,63,330,PF
2015,26,17,194,18,40,0,7,18,33,9,13,16,40,56,7,3,1,13,17,45,PF
2015,28,2,7,1,1,0,0,1,1,2,2,0,0,0,1,0,0,0,0,4,PF
2015,23,71,1776,224,543,115,287,109,256,63,89,53,145,198,85,57,26,66,141,626,SG
2015,28,81,1991,201,428,0,1,201,427,89,143,139,391,530,85,33,57,84,239,491,PF
2015,24,77,2455,602,1299,239,545,363,754,225,256,27,220,247,222,87,60,149,122,1668,SG
2015,23,82,2194,267,488,0,0,267,488,159,248,274,383,657,39,34,61,83,189,693,PF
2015,27,48,721,140,345,54,143,86,202,46,56,23,63,86,36,27,7,27,38,380,SG
2015,27,39,640,127,305,52,124,75,181,42,51,19,54,73,34,21,7,22,35,348,SG
2015,27,9,81,13,40,2,19,11,21,4,5,4,9,13,2,6,0,5,3,32,SG
2015,29,76,1432,161,393,106,290,55,103,54,69,51,185,236,59,24,16,51,137,482,PF
2015,29,24,272,26,74,24,62,2,12,4,6,6,38,44,10,4,1,11,20,80,PF
2015,29,52,1160,135,319,82,228,53,91,50,63,45,147,192,49,20,15,40,117,402,PF
2015,29,78,2383,261,596,87,252,174,344,104,143,114,388,502,122,107,23,96,179,713,SF
2015,35,62,705,83,188,60,139,23,49,6,11,5,94,99,37,19,7,29,66,232,SF
2015,26,82,2260,320,746,33,119,287,627,106,141,40,377,417,449,83,19,198,180,779,SG
2015,27,33,128,11,24,0,0,11,24,7,9,7,19,26,8,8,7,7,20,29,PF
2015,32,79,1494,246,505,26,97,220,408,87,102,20,123,143,220,46,8,89,88,605,PG
2015,22,80,2096,373,652,0,1,373,651,217,276,215,478,693,39,33,95,109,222,963,C
2015,32,26,636,111,200,0,2,111,198,33,45,57,113,170,35,19,16,35,58,255,C
2015,28,82,1991,296,725,133,351,163,374,50,66,22,194,216,302,46,10,119,177,775,PG
2015,30,64,678,150,362,83,221,67,141,20,35,30,119,149,19,15,22,28,64,403,PF
2015,19,25,259,30,76,5,13,25,63,18,26,28,58,86,4,4,9,11,20,83,PF
2015,24,74,2529,631,1206,2,6,629,1200,164,218,238,572,810,147,54,54,148,220,1428,C
2015,33,62,1971,509,1084,29,102,480,982,284,370,58,161,219,299,73,21,209,105,1331,SG
2015,23,80,2208,375,946,73,246,302,700,117,172,41,151,192,163,90,21,113,155,940,SG
2015,23,33,786,138,342,22,86,116,256,47,60,12,45,57,74,44,10,50,59,345,SG
2015,23,47,1422,237,604,51,160,186,444,70,112,29,106,135,89,46,11,63,96,595,SG
2015,27,24,628,58,168,45,132,13,36,14,18,7,75,82,29,24,9,24,76,175,SF
2015,24,62,2119,378,981,85,280,293,701,234,283,35,185,220,318,89,31,100,92,1075,PG
2015,24,79,2837,519,1166,65,217,454,949,284,362,36,330,366,792,138,45,304,180,1387,PG
2015,32,32,286,14,34,1,3,13,31,6,15,17,40,57,11,15,4,18,19,35,SF
2015,21,40,614,113,214,5,21,108,193,14,19,41,44,85,25,18,9,27,51,245,SF
2015,30,57,1422,181,417,70,175,111,242,138,167,18,145,163,208,57,9,100,107,570,PG
2015,24,2,7,0,2,0,1,0,1,0,0,2,0,2,1,0,0,0,1,0,PF
2015,24,51,672,84,209,11,30,73,179,20,26,31,75,106,40,15,11,35,55,199,SF
2015,28,32,352,24,91,10,43,14,48,48,64,10,36,46,17,7,1,22,24,106,SF
2015,34,66,1895,323,686,4,20,319,666,119,161,108,341,449,223,48,48,120,160,769,PF
2015,26,67,2302,627,1471,86,288,541,1183,546,654,124,364,488,574,140,14,293,184,1886,PG
2015,25,48,1142,243,387,0,0,243,387,78,156,145,337,482,6,27,123,58,129,564,C
2015,23,20,108,19,42,1,6,18,36,18,23,10,19,29,6,5,2,5,18,57,PF
2015,19,82,2969,497,1137,39,126,458,1011,354,466,134,240,374,170,86,50,177,190,1387,SF
2015,24,21,101,16,38,7,19,9,19,2,2,1,6,7,8,3,1,10,7,41,SG
2015,30,68,2114,298,771,87,237,211,534,201,241,29,208,237,448,64,17,154,157,884,PG
2015,23,74,1462,217,485,49,156,168,329,134,196,41,161,202,50,34,4,56,67,617,PF
2015,25,13,119,14,37,8,18,6,19,1,4,0,8,8,12,4,0,4,12,37,SG
2015,25,5,42,6,13,5,7,1,6,1,2,0,3,3,4,2,0,4,1,18,SG
2015,25,8,77,8,24,3,11,5,13,0,2,0,5,5,8,2,0,0,11,19,SG
2015,28,80,2016,375,928,152,447,223,481,340,395,24,127,151,164,88,10,101,103,1242,SG
2015,28,78,2035,210,495,95,265,115,230,62,87,58,328,386,100,69,36,60,146,577,PF
2015,32,68,1980,341,860,119,348,222,512,163,187,22,152,174,424,46,14,172,162,964,PG
2015,32,41,1149,180,447,59,170,121,277,80,94,13,85,98,261,30,8,102,103,499,PG
2015,32,27,831,161,413,60,178,101,235,83,93,9,67,76,163,16,6,70,59,465,PG
2015,28,20,105,15,39,3,19,12,20,4,4,5,12,17,10,1,0,2,12,37,SF
2015,28,63,1087,121,300,64,178,57,122,35,40,36,130,166,44,25,21,30,135,341,SF
2015,28,44,924,102,240,60,152,42,88,28,33,27,112,139,36,21,17,23,116,292,SF
2015,28,19,163,19,60,4,26,15,34,7,7,9,18,27,8,4,4,7,19,49,SF
2015,24,37,259,32,64,0,0,32,64,34,50,23,41,64,11,4,18,12,26,98,C
2015,23,21,247,20,57,0,7,20,50,2,6,8,26,34,21,8,2,13,18,42,PG
2015,23,11,142,12,31,0,5,12,26,1,4,2,14,16,10,5,0,3,11,25,PG
2015,23,10,105,8,26,0,2,8,24,1,2,6,12,18,11,3,2,10,7,17,PG
2015,27,75,1449,233,363,0,3,233,360,78,112,128,193,321,41,50,94,34,102,544,PF
2015,27,27,505,101,135,0,0,101,135,36,48,51,59,110,10,17,42,13,44,238,PF
2015,27,8,86,12,21,0,0,12,21,2,4,7,10,17,8,1,5,5,4,26,PF
2015,27,40,858,120,207,0,3,120,204,40,60,70,124,194,23,32,47,16,54,280,PF
2015,29,48,592,72,190,41,108,31,82,34,42,14,97,111,41,20,11,18,55,219,SF
2015,21,30,895,175,434,37,142,138,292,120,180,22,64,86,157,48,8,113,72,507,PG
2015,19,31,332,36,102,17,66,19,36,16,29,9,33,42,13,8,2,5,22,105,SG
2015,29,42,1000,174,476,83,225,91,251,132,148,17,79,96,41,23,11,44,83,563,SG
2015,26,76,2434,451,968,38,115,413,853,131,200,127,284,411,173,124,25,117,171,1071,PF
2015,26,48,1605,289,641,19,65,270,576,88,129,75,170,245,135,86,17,75,115,685,PF
2015,26,28,829,162,327,19,50,143,277,43,71,52,114,166,38,38,8,42,56,386,PF
2015,22,62,1487,172,373,1,1,171,372,127,164,97,265,362,100,34,49,62,156,472,C
2015,25,82,1731,340,619,0,0,340,619,153,186,146,319,465,113,18,52,76,205,833,C
2016,25,59,876,119,214,19,49,100,165,50,68,65,123,188,27,29,24,27,103,307,PF
2016,21,2,15,2,6,0,1,2,5,3,5,0,2,2,3,3,0,2,2,7,SG
2016,22,80,2014,261,426,0,0,261,426,114,196,219,314,533,62,42,89,84,223,636,C
2016,30,71,2371,354,799,91,238,263,561,110,131,23,243,266,144,25,10,82,142,909,SG
2016,27,59,861,150,315,0,1,150,314,52,62,75,194,269,31,19,36,54,134,352,C
2016,27,60,800,134,225,0,0,134,225,60,84,86,202,288,50,47,68,64,139,328,C
2016,30,74,2261,536,1045,0,16,536,1029,259,302,176,456,632,110,38,81,99,151,1331,PF
2016,20,8,36,5,10,0,0,5,10,0,0,2,4,6,0,1,2,1,1,10,PF
2016,26,79,1599,191,370,0,0,191,370,46,73,162,262,424,76,26,42,69,147,428,PF
2016,34,64,1620,215,469,15,42,200,427,90,138,104,192,296,70,110,18,78,175,535,SG
2016,25,82,2341,299,719,126,349,173,370,115,156,98,401,499,138,72,53,120,171,839,SF
2016,33,29,204,19,53,0,0,19,53,14,27,23,26,49,12,6,7,15,44,52,PF
2016,37,27,402,38,72,4,14,34,58,25,36,36,62,98,12,15,13,9,29,105,C
2016,37,7,36,4,10,2,5,2,5,3,4,3,6,9,3,1,3,2,4,13,C
2016,37,20,366,34,62,2,9,32,53,22,32,33,56,89,9,14,10,7,25,92,C
2016,33,13,192,21,59,12,37,9,22,11,15,1,26,27,14,4,1,2,25,65,SG
2016,26,51,721,67,178,23,86,44,92,22,29,13,73,86,41,21,14,42,54,179,SG
2016,22,55,647,71,175,22,83,49,92,44,55,18,114,132,29,19,25,24,45,208,SF
2016,22,78,1245,138,295,12,37,126,258,62,83,25,219,244,123,60,29,59,97,350,SF
2016,27,66,2008,397,929,131,358,266,571,199,228,131,265,396,73,38,25,90,109,1124,PF
2016,21,80,2823,513,1013,28,109,485,904,296,409,113,499,612,345,94,113,208,258,1350,PG
2016,23,2,6,3,4,0,1,3,3,0,0,0,1,1,0,0,0,0,2,6,SF
2016,31,72,2530,567,1307,105,310,462,997,334,403,98,458,556,299,62,38,176,180,1573,SF
2016,33,19,96,6,10,0,0,6,10,6,8,8,13,21,1,2,12,2,15,18,C
2016,23,5,27,2,8,0,3,2,5,2,2,0,1,1,1,1,0,3,5,6,PG
2016,30,81,2859,357,859,185,499,172,360,126,161,67,299,366,188,160,26,113,177,1025,SF
2016,27,70,1516,221,489,45,117,176,372,40,53,86,207,293,96,53,48,66,185,527,PF
2016,29,68,1178,104,195,0,0,104,195,61,112,120,294,414,26,21,23,60,124,269,C
2016,28,62,1178,148,350,68,168,80,182,103,128,8,87,95,198,38,4,84,85,467,PG
2016,28,34,519,46,121,24,61,22,60,26,34,5,38,43,66,13,2,30,41,142,PG
2016,28,28,659,102,229,44,107,58,122,77,94,3,49,52,132,25,2,54,44,325,PG
2016,28,17,107,12,23,0,1,12,22,6,6,4,18,22,5,0,3,6,18,30,C
2016,26,47,845,122,289,44,109,78,180,39,50,25,123,148,53,11,7,23,90,327,SF
2016,25,18,103,13,40,1,5,12,35,7,8,4,24,28,6,2,3,4,19,34,C
2016,33,68,1079,171,370,39,110,132,260,52,62,28,89,117,82,44,10,53,107,433,SG
2016,31,74,1667,317,711,100,260,217,451,74,96,26,126,152,302,26,2,113,110,808,PG
2016,30,46,634,127,279,3,16,124,263,47,57,28,69,97,18,4,9,26,61,304,C
2016,23,66,2042,295,633,82,214,213,419,102,134,77,248,325,117,41,10,57,136,774,SF
2016,35,76,2190,264,693,119,370,145,323,111,138,84,336,420,163,78,57,121,234,758,SF
2016,25,82,2353,425,983,112,325,313,658,216,268,59,417,476,203,71,39,139,147,1178,SG
2016,30,66,1342,174,317,0,2,174,315,125,148,104,181,285,74,33,55,42,125,473,PF
2016,27,70,2448,372,873,139,399,233,474,163,192,55,373,428,403,65,43,205,114,1046,SF
2016,27,52,1505,185,437,101,231,84,206,70,90,21,120,141,163,47,11,73,111,541,SG
2016,29,81,1233,194,384,0,2,194,382,126,165,140,244,384,51,21,52,67,151,514,C
2016,26,75,2083,320,725,109,305,211,420,123,151,28,351,379,171,98,38,138,176,872,SF
2016,22,55,1708,359,799,105,271,254,528,135,176,41,147,188,162,54,11,112,117,958,SG
2016,27,20,363,107,205,3,9,104,196,38,49,29,69,98,16,11,9,24,39,255,PF
2016,29,68,1672,245,635,91,297,154,338,115,138,10,107,117,127,37,2,80,91,696,SG
2016,22,19,84,8,27,3,14,5,13,9,10,6,17,23,0,5,0,4,8,28,PF
2016,27,71,2041,258,594,124,310,134,284,60,88,73,177,250,239,94,26,91,234,700,PG
2016,23,82,1808,156,288,0,1,156,287,142,226,182,473,655,29,19,133,71,225,454,C
2016,27,60,1075,110,235,48,125,62,110,40,55,49,161,210,83,26,21,47,154,308,PF
2016,24,39,496,57,104,0,0,57,104,19,45,44,113,157,16,14,18,22,78,133,C
2016,26,29,218,28,68,0,1,28,67,5,13,20,37,57,11,8,2,15,53,61,C
2016,35,58,986,93,240,52,151,41,89,16,20,9,80,89,200,24,5,81,70,254,PG
2016,26,31,1059,223,492,48,129,175,363,138,172,18,107,125,190,63,19,110,75,632,PG
2016,26,79,2115,324,749,129,338,195,411,110,132,36,219,255,99,29,5,115,119,887,SF
2016,31,70,1451,175,279,1,1,174,278,24,50,121,371,492,162,33,114,83,221,375,C
2016,35,30,206,29,57,15,34,14,23,3,4,3,24,27,9,6,1,3,16,76,C
2016,19,76,2108,367,867,99,289,268,578,215,256,27,160,187,200,44,20,160,225,1048,SG
2016,28,79,1632,190,388,12,41,178,347,71,106,166,286,452,84,59,41,81,169,463,PF
2016,31,53,1778,358,767,81,222,277,545,213,268,48,342,390,128,36,34,78,101,1010,PF
2016,25,76,2536,456,1019,147,407,309,612,96,123,48,172,220,158,117,19,109,164,1155,SG
2016,36,17,225,31,72,0,1,31,71,8,9,9,54,63,18,9,8,11,32,70,C
2016,29,82,1669,212,552,61,224,151,328,105,140,42,157,199,109,84,19,78,168,590,SF
2016,31,69,1108,188,469,66,185,122,284,49,64,21,80,101,180,30,10,82,132,491,PG
2016,23,29,599,39,126,20,70,19,56,17,20,9,61,70,19,14,5,15,34,115,SF
2016,25,8,61,8,25,1,8,7,17,3,4,0,7,7,11,3,1,9,4,20,PG
2016,24,62,982,127,322,38,121,89,201,71,94,23,99,122,91,38,15,54,94,363,SG
2016,37,66,1863,398,1113,133,467,265,646,232,281,41,206,247,184,62,13,129,115,1161,SF
2016,27,66,929,104,239,24,86,80,153,39,56,43,107,150,64,32,10,44,62,271,SF
2016,27,49,729,81,194,20,69,61,125,34,48,31,90,121,49,29,9,31,46,216,SF
2016,27,17,200,23,45,4,17,19,28,5,8,12,17,29,15,3,1,13,16,55,SF
2016,24,37,429,43,98,22,53,21,45,14,15,14,54,68,27,10,2,8,29,122,SF
2016,23,64,1366,262,634,88,256,174,378,67,82,18,94,112,148,35,6,80,86,679,PG
2016,24,31,797,137,334,32,79,105,255,106,141,16,93,109,63,18,4,51,71,412,SG
2016,35,17,176,25,59,3,18,22,41,10,12,5,17,22,10,9,1,3,19,63,SF
2016,26,67,2474,470,1035,64,205,406,830,395,475,79,279,358,321,110,43,132,124,1399,SG
2016,36,46,432,49,104,15,49,34,55,11,16,3,53,56,24,13,23,8,11,124,SF
2016,20,6,43,1,12,1,7,0,5,0,0,1,1,2,1,2,1,4,2,3,SF
2016,34,72,2024,209,455,84,203,125,252,42,48,22,207,229,298,63,7,87,135,544,PG
2016,22,76,2789,403,960,114,369,289,591,185,228,70,212,282,138,110,17,105,167,1105,SG
2016,24,77,1966,260,722,176,485,84,237,150,180,20,154,174,137,56,12,91,133,846,SG
2016,21,77,1471,231,397,0,1,231,396,80,211,194,300,494,47,59,92,60,190,542,C
2016,29,26,786,105,270,46,118,59,152,30,50,31,91,122,27,44,6,28,63,286,SF
2016,39,60,1005,133,343,59,169,74,174,70,84,31,115,146,56,38,16,35,101,395,SG
2016,24,54,1649,251,555,15,55,236,500,106,162,48,228,276,281,80,41,153,162,623,PG
2016,27,69,1880,299,622,112,274,187,348,103,159,58,352,410,95,56,17,94,154,813,SF
2016,22,66,1412,191,339,0,2,191,337,81,125,134,218,352,37,48,66,46,146,463,C
2016,29,61,1373,182,444,46,149,136,295,218,262,24,133,157,230,88,13,110,181,628,PG
2016,29,6,120,10,32,1,11,9,21,12,13,1,13,14,19,8,1,9,16,33,PG
2016,29,55,1253,172,412,45,138,127,274,206,249,23,120,143,211,80,12,101,165,595,PG
2016,33,66,1618,183,314,0,1,183,313,106,171,175,401,576,64,36,44,93,145,472,C
2016,24,1,6,2,2,0,0,2,2,0,0,1,0,1,0,0,0,0,1,4,PF
2016,24,66,578,89,202,30,84,59,118,28,34,13,55,68,64,17,13,43,58,236,SG
2016,23,3,6,2,4,2,2,0,2,0,0,0,1,1,0,0,0,1,0,6,SF
2016,23,79,2552,475,1098,111,320,364,778,164,204,93,220,313,192,88,7,135,168,1225,SG
2016,27,45,1198,196,484,33,102,163,382,52,65,10,141,151,167,37,5,75,102,477,PG
2016,28,74,2219,377,776,87,217,290,559,194,226,28,141,169,318,76,4,130,142,1035,PG
2016,35,59,699,50,109,0,2,50,107,23,33,68,103,171,52,15,16,50,107,123,PF
2016,28,56,1761,294,696,78,215,216,481,191,229,26,138,164,342,67,16,84,100,857,PG
2016,23,34,143,13,49,5,21,8,28,5,5,11,21,32,10,2,0,10,6,36,SG
2016,31,24,156,17,51,10,36,7,15,6,7,1,9,10,11,2,0,6,17,50,PF
2016,23,8,39,4,10,0,3,4,7,0,0,0,0,0,3,3,0,5,2,8,PG
2016,23,3,33,2,8,0,3,2,5,0,0,0,0,0,3,3,0,5,2,4,PG
2016,23,5,6,2,2,0,0,2,2,0,0,0,0,0,0,0,0,0,0,4,PG
2016,25,65,2246,601,1332,70,210,531,1122,476,663,158,589,747,214,101,92,249,236,1748,C
2016,25,67,1903,274,712,170,482,104,230,140,177,65,354,419,97,105,40,143,232,858,SF
2016,23,81,2105,311,678,112,285,199,393,98,113,27,189,216,99,63,16,64,192,832,SG
2016,35,79,2126,379,939,117,344,262,595,245,271,20,125,145,183,52,12,113,122,1120,SG
2016,25,73,2308,360,813,122,363,238,450,196,239,70,303,373,135,126,35,83,198,1038,SF
2016,28,80,1971,186,412,55,174,131,238,57,82,57,179,236,77,42,33,41,173,484,SF
2016,24,44,410,36,105,12,39,24,66,36,55,3,35,38,20,14,2,21,41,120,SG
2016,24,40,355,32,91,10,32,22,59,30,48,3,26,29,19,12,2,18,37,104,SG
2016,24,4,55,4,14,2,7,2,7,6,7,0,9,9,1,2,0,3,4,16,SG
2016,25,44,692,102,224,50,111,52,113,45,54,9,51,60,67,22,3,36,41,299,PG
2016,27,79,2700,805,1598,402,886,403,712,363,400,68,362,430,527,169,15,262,161,2375,PG
2016,24,43,476,89,187,59,122,30,65,5,9,7,50,57,21,11,3,24,40,242,SG
2016,22,61,2164,560,1136,35,108,525,1028,326,430,130,497,627,116,78,125,121,148,1481,C
2016,26,81,1684,206,337,0,0,206,337,114,204,224,375,599,88,57,72,64,202,526,PF
2016,22,6,29,2,5,0,0,2,5,1,1,2,2,4,0,0,1,0,2,5,PF
2016,26,58,705,99,177,0,0,99,177,57,76,67,161,228,13,22,46,32,109,255,C
2016,23,14,279,28,69,12,32,16,37,11,21,8,40,48,15,10,2,11,17,79,SG
2016,25,76,1867,207,511,98,239,109,272,57,66,33,129,162,337,44,9,116,178,569,PG
2016,30,74,2394,339,745,88,256,251,489,145,192,108,335,443,140,74,29,81,122,911,PF
2016,26,78,2804,614,1377,47,139,567,1238,555,653,64,285,349,315,81,21,175,167,1830,SG
2016,33,76,1386,202,383,25,69,177,314,56,76,58,175,233,176,26,21,97,102,485,PF
2016,26,82,2220,308,579,6,20,302,559,205,248,157,428,585,143,94,96,140,219,827,C
2016,22,12,159,19,54,1,10,18,44,19,33,4,13,17,22,3,0,7,20,58,PG
2016,29,61,1262,183,445,81,203,102,242,84,99,25,118,143,157,70,5,64,131,531,PG
2016,29,72,2363,417,875,64,205,353,670,120,165,54,223,277,419,71,17,185,188,1018,PG
2016,22,81,2666,552,1060,2,6,550,1054,208,586,395,803,1198,67,119,112,155,245,1314,C
2016,30,81,2098,233,487,100,238,133,249,72,98,54,232,286,170,75,18,80,190,638,PF
2016,24,1,24,2,10,2,5,0,5,0,0,2,2,4,1,1,0,0,2,6,SF
2016,39,61,1536,215,441,0,2,215,439,92,131,115,332,447,163,47,78,90,125,522,C
2016,35,31,703,77,188,39,99,38,89,29,37,8,75,83,39,14,10,26,66,222,SF
2016,27,72,2578,698,1381,186,481,512,900,447,498,45,544,589,361,69,85,250,137,2029,SF
2016,24,17,154,12,40,4,15,8,25,3,4,4,22,26,6,2,3,9,16,31,SF
2016,24,26,147,20,65,15,47,5,18,8,8,2,21,23,5,5,1,1,5,63,SF
2016,28,76,1615,218,561,96,268,122,293,54,63,20,154,174,83,48,5,45,82,586,SG
2016,30,81,2734,436,1021,87,282,349,739,162,206,42,229,271,383,150,37,203,174,1121,SG
2016,25,22,329,54,113,26,58,28,55,25,34,21,21,42,21,16,5,19,28,159,SF
2016,25,10,40,4,13,2,8,2,5,6,10,4,3,7,2,4,2,2,1,16,SF
2016,25,9,282,50,100,24,50,26,50,19,24,17,18,35,18,12,3,17,26,143,SF
2016,21,46,654,84,187,13,39,71,148,25,34,13,62,75,95,25,1,46,64,206,PG
2016,28,30,251,26,48,4,16,22,32,15,21,11,43,54,2,6,9,7,19,71,SF
2016,26,25,765,136,314,33,85,103,229,74,93,20,109,129,164,32,8,73,66,379,SG
2016,26,46,770,125,228,0,0,125,228,70,132,91,166,257,32,18,50,38,94,320,C
2016,26,67,1694,349,626,1,2,348,624,136,222,235,346,581,79,32,60,91,169,835,PF
2016,29,12,291,42,100,16,45,26,55,10,10,4,21,25,37,15,2,18,22,110,PG
2016,24,62,1983,418,811,0,4,418,807,180,254,169,334,503,94,74,91,104,150,1016,PF
2016,23,31,321,40,72,0,4,40,68,25,35,30,72,102,26,6,13,13,31,105,C
2016,31,80,2192,277,682,60,213,217,469,149,176,36,222,258,284,68,15,121,141,763,PG
2016,23,79,2566,429,929,156,390,273,539,199,238,33,192,225,213,96,2,133,214,1213,SF
2016,32,81,1642,169,482,75,250,94,232,61,74,24,132,156,161,39,29,86,131,474,SG
2016,32,54,1070,117,333,50,169,67,164,39,47,16,89,105,112,26,16,58,83,323,SG
2016,32,27,572,52,149,25,81,27,68,22,27,8,43,51,49,13,13,28,48,151,SG
2016,25,51,741,96,229,16,48,80,181,53,74,26,84,110,162,33,2,65,73,261,PG
2016,25,35,272,20,60,3,17,17,43,8,15,11,28,39,42,10,1,27,31,51,PG
2016,25,16,469,76,169,13,31,63,138,45,59,15,56,71,120,23,1,38,42,210,PG
2016,26,6,18,2,5,1,2,1,3,4,5,0,0,0,1,1,0,2,2,9,SG
2016,26,4,13,1,4,0,1,1,3,0,0,0,0,0,1,1,0,1,1,2,SG
2016,32,44,754,81,186,48,121,33,65,19,21,23,118,141,45,21,20,30,71,229,PF
2016,32,26,446,71,161,43,114,28,47,11,14,12,81,93,26,8,8,13,56,196,C
2016,27,53,1839,287,700,87,239,200,461,375,432,52,229,281,135,42,19,77,87,1036,SF
2016,24,82,2033,231,588,77,224,154,364,86,114,43,245,288,207,77,22,61,177,625,PG
2016,39,38,556,54,115,0,1,54,114,14,21,15,135,150,62,28,10,16,70,122,PF
2016,31,52,1791,328,707,2,3,326,704,203,245,58,304,362,196,50,70,118,141,861,C
2016,35,72,2291,467,995,24,69,443,926,229,289,155,638,793,294,42,146,164,148,1187,C
2016,29,70,2379,466,1007,74,215,392,792,198,254,103,353,456,120,100,51,139,184,1204,SF
2016,28,73,1632,132,255,17,60,115,195,44,66,60,185,245,72,63,13,55,169,325,SF
2016,25,81,2819,605,1449,210,566,395,883,454,528,79,484,563,329,152,29,265,230,1874,SF
2016,30,73,1936,263,500,0,3,263,497,101,146,206,298,504,106,47,77,78,180,627,PF
2016,38,58,1134,197,435,70,179,127,256,91,112,26,120,146,177,66,11,99,99,555,SG
2016,23,61,1932,198,354,0,0,198,354,161,283,208,460,668,91,45,135,114,163,557,C
2016,34,30,305,33,103,7,41,26,62,9,14,28,57,85,13,8,11,13,40,82,PF
2016,21,57,1114,176,422,23,99,153,323,130,193,27,115,142,118,27,13,100,84,505,PG
2016,20,78,1863,274,579,42,142,232,437,129,193,154,353,507,128,59,55,66,153,719,PF
2016,27,45,1481,231,552,113,294,118,258,111,125,10,89,99,121,43,14,73,98,686,SG
2016,31,75,2256,433,764,0,1,433,763,146,207,222,519,741,106,47,96,121,193,1012,C
2016,27,8,50,9,20,1,9,8,11,3,4,1,1,2,4,6,2,7,4,22,PG
2016,21,77,2066,251,599,35,146,216,453,212,322,99,262,361,135,54,127,110,215,749,SF
2016,23,76,1265,154,391,22,100,132,291,96,123,23,120,143,177,50,10,87,97,426,PG
2016,28,79,2062,211,561,116,349,95,212,34,46,48,255,303,141,79,64,75,141,572,SG
2016,25,81,2808,401,819,100,258,301,561,229,329,134,635,769,598,119,113,259,240,1131,PF
2016,24,9,42,5,13,1,5,4,8,2,2,3,3,6,3,1,0,0,4,13,PG
2016,24,6,35,5,12,1,4,4,8,2,2,3,2,5,2,1,0,0,4,13,PG
2016,30,69,1557,230,587,84,260,146,327,72,92,25,138,163,56,38,19,46,123,616,SG
2016,25,78,1446,230,495,15,45,215,450,103,137,139,234,373,67,46,33,83,189,578,PF
2016,29,80,2253,354,824,67,213,287,611,164,220,74,258,332,138,58,40,93,164,939,SF
2016,29,53,1544,240,557,42,136,198,421,124,155,55,186,241,98,40,19,69,102,646,SF
2016,29,27,709,114,267,25,77,89,190,40,65,19,72,91,40,18,21,24,62,293,SF
2016,26,35,1170,301,603,6,18,295,585,141,194,51,243,294,170,28,17,83,95,749,PF
2016,27,12,63,6,11,0,2,6,9,10,11,0,7,7,17,3,0,6,3,22,PG
2016,23,66,1313,145,408,70,241,75,167,50,64,25,149,174,38,32,11,41,137,410,SF
2016,23,48,938,99,276,54,172,45,104,34,42,18,110,128,29,24,7,24,106,286,SF
2016,23,18,375,46,132,16,69,30,63,16,22,7,39,46,9,8,4,17,31,124,SF
2016,25,11,304,49,116,13,45,36,71,14,21,12,50,62,25,8,3,17,24,125,SF
2016,30,44,343,32,71,2,3,30,68,38,65,40,49,89,8,12,7,12,55,104,PF
2016,23,51,864,114,265,48,142,66,123,50,56,7,79,86,51,21,7,23,48,326,SG
2016,26,82,3125,710,1617,236,657,474,960,720,837,63,438,501,612,139,51,374,229,2376,SG
2016,22,78,1457,195,411,39,140,156,271,69,111,101,179,280,67,49,35,62,124,498,SF
2016,26,5,35,4,10,4,9,0,1,1,2,0,1,1,0,1,0,2,3,13,PF
2016,22,39,379,58,90,0,1,58,89,24,46,25,40,65,17,11,11,17,48,140,PF
2016,32,64,1280,167,374,52,158,115,216,101,140,18,120,138,118,60,13,66,124,487,PG
2016,21,76,2439,359,765,105,297,254,468,109,133,54,166,220,147,97,18,98,143,932,SG
2016,23,76,2513,417,889,80,239,337,650,202,243,96,414,510,169,65,40,108,153,1116,PF
2016,23,49,1610,251,541,47,151,204,390,120,153,71,271,342,99,47,28,78,91,669,PF
2016,23,27,903,166,348,33,88,133,260,82,90,25,143,168,70,18,12,30,62,447,PF
2016,21,21,93,5,19,3,10,2,9,5,12,4,11,15,2,6,0,4,10,18,SG
2016,35,37,260,23,61,1,9,22,52,12,16,10,65,75,14,5,2,5,25,59,PF
2016,27,57,1035,124,306,38,102,86,204,54,65,51,193,244,109,22,27,58,111,340,PF
2016,32,2,24,1,2,0,0,1,2,2,2,0,8,8,2,0,0,3,6,4,C
2016,25,80,2893,521,1202,143,410,378,792,393,477,61,336,397,296,95,27,202,183,1578,SF
2016,28,72,1431,232,529,48,136,184,393,112,146,30,181,211,75,39,19,68,87,624,SG
2016,25,57,960,164,291,0,1,164,290,69,117,87,134,221,54,18,109,64,131,397,C
2016,20,79,1413,181,418,67,192,114,226,49,54,28,148,176,109,39,17,97,124,478,SF
2016,29,81,1878,182,411,0,2,182,409,117,145,132,266,398,95,32,110,76,252,481,C
2016,27,35,436,80,155,0,1,80,154,46,103,39,93,132,23,15,14,25,47,206,C
2016,27,20,305,55,109,0,0,55,109,27,59,22,65,87,16,10,12,16,35,137,C
2016,27,15,131,25,46,0,1,25,45,19,44,17,28,45,7,5,2,9,12,69,C
2016,33,57,1094,209,384,0,3,209,381,107,185,52,207,259,97,54,26,76,156,525,PF
2016,29,74,2524,326,739,128,314,198,425,114,150,58,240,298,259,83,17,101,149,894,PG
2016,28,73,1513,278,549,0,1,278,548,89,125,156,295,451,87,36,37,92,155,645,C
2016,24,59,866,93,208,24,74,69,134,36,42,39,127,166,57,37,11,33,68,246,SF
2016,22,38,383,52,131,19,50,33,81,29,40,5,40,45,27,9,1,19,28,152,SG
2016,35,46,631,49,129,24,62,25,67,15,16,8,62,70,73,15,2,30,64,137,PG
2016,35,35,555,47,118,23,56,24,62,15,16,7,51,58,59,13,1,27,63,132,PG
2016,35,11,76,2,11,1,6,1,5,0,0,1,11,12,14,2,1,3,1,5,PG
2016,25,65,1831,410,935,87,259,323,676,182,216,27,168,195,391,88,22,167,148,1089,PG
2016,26,53,773,88,228,36,105,52,123,27,37,12,78,90,56,32,19,39,61,239,SG
2016,26,26,263,24,73,10,45,14,28,5,10,4,23,27,11,13,4,13,21,63,SG
2016,26,27,510,64,155,26,60,38,95,22,27,8,55,63,45,19,15,26,40,176,SG
2016,31,37,460,49,79,0,0,49,79,26,42,47,51,98,10,6,21,24,62,124,C
2016,31,5,48,4,7,0,0,4,7,0,0,7,4,11,0,0,1,3,4,8,C
2016,31,32,412,45,72,0,0,45,72,26,42,40,47,87,10,6,20,21,58,116,C
2016,21,29,615,63,138,4,14,59,124,37,52,39,115,154,43,39,16,26,61,167,SF
2016,22,51,702,114,222,8,44,106,178,51,74,62,73,135,33,19,40,32,92,287,PF
2016,23,79,2541,408,972,161,449,247,523,172,200,38,229,267,213,73,16,125,202,1149,SG
2016,29,82,2631,529,1048,88,256,441,792,103,129,148,448,596,263,68,121,107,163,1249,C
2016,30,71,2280,372,600,0,6,372,594,232,474,238,597,835,98,69,113,166,219,976,C
2016,32,53,869,97,230,16,61,81,169,27,29,18,72,90,182,26,7,80,76,237,PG
2016,24,5,55,5,12,4,6,1,6,0,4,2,8,10,0,1,2,3,3,14,PF
2016,30,53,835,121,295,34,108,87,187,67,84,57,161,218,36,16,23,38,94,343,PF
2016,30,28,466,64,158,23,67,41,91,29,31,26,89,115,16,3,14,20,42,180,PF
2016,30,4,74,10,36,3,10,7,26,6,8,11,21,32,7,3,2,4,8,29,PF
2016,30,21,295,47,101,8,31,39,70,32,45,20,51,71,13,10,7,14,44,134,PF
2016,22,36,315,36,98,19,63,17,35,6,7,2,35,37,13,14,4,11,29,97,SG
2016,26,78,2500,416,869,60,184,356,685,91,121,141,392,533,66,38,148,108,211,983,PF
2016,32,65,1732,176,368,54,154,122,214,51,83,52,211,263,219,73,19,79,102,457,SF
2016,28,74,1881,280,661,96,259,184,402,111,154,144,259,403,67,52,33,71,171,767,PF
2016,28,52,1434,216,508,78,215,138,293,79,109,99,183,282,55,38,27,59,120,589,PF
2016,28,22,447,64,153,18,44,46,109,32,45,45,76,121,12,14,6,12,51,178,PF
2016,28,81,1241,124,291,81,210,43,81,13,18,19,132,151,96,55,4,65,98,342,SF
2016,20,20,156,13,37,3,13,10,24,7,8,2,29,31,10,6,3,11,11,36,SF
2016,23,53,1667,394,879,84,262,310,617,169,191,44,113,157,249,56,18,124,107,1041,PG
2016,32,32,1027,140,358,31,102,109,256,100,112,9,127,136,236,34,7,94,77,411,PG
2016,25,79,2424,540,1244,118,334,422,910,291,337,58,195,253,492,59,11,223,187,1489,PG
2016,31,76,2709,737,1416,87,282,650,1134,359,491,111,454,565,514,104,49,249,143,1920,SF
2016,31,47,1096,245,505,0,0,245,505,72,111,57,244,301,70,30,41,34,117,562,C
2016,25,8,50,9,22,0,1,9,21,4,6,6,10,16,0,0,1,0,8,22,PF
2016,35,74,1326,143,312,66,173,77,139,58,87,15,113,128,59,33,14,43,129,410,SF
2016,24,43,480,71,160,16,51,55,109,20,24,8,49,57,35,8,1,27,22,178,SG
2016,24,21,193,29,70,3,19,26,51,8,9,4,18,22,9,3,0,11,11,69,SG
2016,24,22,287,42,90,13,32,29,58,12,15,4,31,35,26,5,1,16,11,109,SG
2016,26,48,868,112,304,51,155,61,149,57,78,16,80,96,170,29,7,57,57,332,PG
2016,26,23,416,53,143,24,77,29,66,27,38,5,41,46,70,11,2,22,24,157,PG
2016,26,25,452,59,161,27,78,32,83,30,40,11,39,50,100,18,5,35,33,175,PG
2016,28,78,1176,118,286,43,108,75,178,61,78,77,211,288,62,20,24,52,137,340,PF
2016,28,79,1800,249,426,10,43,239,383,69,121,178,327,505,138,52,83,94,214,577,PF
2016,25,70,857,72,194,27,99,45,95,34,42,27,105,132,45,32,20,40,100,205,SF
2016,28,57,926,114,240,20,66,94,174,39,68,28,98,126,67,29,33,54,84,287,PF
2016,34,81,2703,377,859,120,313,257,546,118,142,49,243,292,318,61,4,159,146,992,SF
2016,34,57,1934,247,608,85,229,162,379,92,108,34,190,224,232,40,2,116,100,671,SF
2016,34,24,769,130,251,35,84,95,167,26,34,15,53,68,86,21,2,43,46,321,SF
2016,26,7,101,9,34,2,10,7,24,6,8,4,11,15,2,3,3,4,9,26,SG
2016,26,2,47,5,17,1,5,4,12,5,6,3,6,9,0,2,3,1,5,16,SG
2016,26,5,54,4,17,1,5,3,12,1,2,1,5,6,2,1,0,3,4,10,SG
2016,19,73,1687,225,600,63,205,162,395,80,102,58,248,306,118,55,12,114,178,593,SF
2016,23,36,863,118,243,27,71,91,172,51,64,28,81,109,79,24,14,47,66,314,SG
2016,28,80,1666,208,515,103,309,105,206,30,46,37,211,248,49,89,56,54,173,549,SF
2016,20,80,1733,307,600,28,84,279,516,154,190,181,379,560,189,79,50,104,208,796,C
2016,35,1,42,6,14,1,2,5,12,0,0,1,4,5,2,1,2,0,6,13,SF
2016,35,48,463,58,142,41,104,17,38,21,26,8,42,50,14,11,10,13,50,178,SF
2016,24,50,1044,166,367,25,79,141,288,77,116,62,149,211,41,23,39,49,86,434,PF
2016,19,37,573,56,156,16,53,40,103,28,39,7,40,47,108,31,3,33,33,156,PG
2016,27,77,2598,357,508,0,1,357,507,266,619,267,792,1059,90,51,177,107,207,980,C
2016,24,80,2046,257,585,30,110,227,475,133,174,39,171,210,250,63,20,102,131,677,SG
2016,33,16,112,20,43,1,4,19,39,3,3,7,17,24,11,1,1,8,15,44,C
2016,22,81,1708,215,525,68,202,147,323,108,148,69,266,335,98,38,43,58,126,606,C
2016,23,82,1721,414,719,10,21,404,698,200,251,249,415,664,33,26,33,115,166,1038,C
2016,22,40,399,30,74,11,37,19,37,26,28,8,50,58,35,6,2,22,27,97,SF
2016,30,25,95,9,17,0,0,9,17,5,11,12,14,26,3,4,5,7,11,23,C
2016,24,36,470,55,149,5,37,50,112,37,54,21,100,121,20,13,10,18,39,152,PF
2016,22,7,205,33,61,3,7,30,54,20,29,12,33,45,9,3,3,8,9,89,SF
2016,26,31,616,123,270,39,114,84,156,60,67,12,44,56,29,12,2,31,37,345,SG
2016,26,8,82,8,21,4,17,4,4,7,8,2,4,6,3,2,0,4,7,27,SG
2016,26,23,534,115,249,35,97,80,152,53,59,10,40,50,26,10,2,27,30,318,SG
2016,24,52,1870,371,895,120,351,251,544,156,183,36,166,202,263,61,20,177,124,1018,SG
2016,34,80,2401,268,616,158,397,110,219,45,54,14,246,260,164,60,35,98,161,739,SG
2016,26,78,1482,236,444,0,0,236,444,57,104,169,254,423,33,40,70,48,185,529,C
2016,23,66,1227,230,510,56,181,174,329,64,88,44,208,252,77,42,30,50,105,580,SG
2016,32,36,569,139,250,6,13,133,237,67,91,49,97,146,32,12,9,22,69,351,PF
2016,23,78,1751,222,502,39,108,183,394,83,107,28,152,180,342,95,12,146,121,566,PG
2016,24,59,1041,195,380,13,53,182,327,62,69,77,213,290,56,13,15,54,115,465,C
2016,20,82,2294,433,959,123,316,310,643,161,203,27,201,228,251,69,17,155,193,1150,SG
2016,28,66,1411,139,354,36,108,103,246,59,86,26,94,120,237,53,7,95,87,373,PG
2016,28,53,1176,111,287,31,94,80,193,56,80,20,69,89,180,43,6,82,71,309,PG
2016,28,13,235,28,67,5,14,23,53,3,6,6,25,31,57,10,1,13,16,64,PG
2016,30,79,2334,290,639,82,217,208,422,99,118,29,176,205,136,85,28,72,134,761,SG
2016,30,51,1489,192,419,51,138,141,281,76,92,19,99,118,76,52,16,49,79,511,SG
2016,30,28,845,98,220,31,79,67,141,23,26,10,77,87,60,33,12,23,55,250,SG
2016,32,55,903,178,335,0,1,178,334,71,93,101,204,305,84,22,28,66,114,427,PF
2016,32,30,470,87,192,0,1,87,191,40,51,41,89,130,54,12,13,38,51,214,PF
2016,32,25,433,91,143,0,0,91,143,31,42,60,115,175,30,10,15,28,63,213,PF
2016,22,78,1821,264,624,1,7,263,617,174,239,178,416,594,97,38,62,145,230,703,C
2016,24,72,2380,551,1090,129,291,422,799,292,334,95,398,493,186,128,71,105,133,1523,SF
2016,23,61,1333,195,435,86,228,109,207,35,46,51,263,314,92,8,18,77,183,511,PF
2016,26,67,1255,224,466,42,110,182,356,77,101,76,297,373,72,38,30,75,125,567,PF
2016,25,75,2676,618,1474,229,610,389,864,414,464,45,257,302,512,65,28,242,165,1879,PG
2016,27,78,2048,300,728,76,226,224,502,238,292,42,211,253,235,58,42,150,165,914,SG
2016,30,78,1520,203,379,2,12,201,367,80,93,42,127,169,237,57,27,78,140,488,PG
2016,19,5,21,4,7,1,2,3,5,0,0,4,6,10,0,0,0,1,2,9,PF
2016,27,73,2457,591,1157,2,14,589,1143,317,403,204,369,573,147,58,124,175,215,1501,C
2016,27,82,2219,357,662,0,1,357,661,128,161,268,334,602,114,16,129,133,182,842,C
2016,27,77,2424,409,977,158,439,251,538,258,314,149,613,762,186,58,41,142,159,1234,PF
2016,29,77,2851,512,1198,212,547,300,651,398,491,55,310,365,494,158,34,225,211,1634,PG
2016,20,80,1382,191,436,49,128,142,308,57,82,59,240,299,59,26,18,65,114,488,PF
2016,25,52,1058,182,415,39,125,143,290,45,61,13,115,128,187,34,3,95,72,448,PG
2016,25,24,179,40,95,4,27,36,68,9,12,2,20,22,38,8,0,14,7,93,PG
2016,25,28,879,142,320,35,98,107,222,36,49,11,95,106,149,26,3,81,65,355,PG
2016,29,71,1816,264,448,0,0,264,448,132,225,138,369,507,104,65,75,100,220,660,C
2016,23,28,249,21,71,8,32,13,39,10,24,6,32,38,12,13,1,7,25,60,SG
2016,27,54,508,105,174,0,0,105,174,87,114,73,121,194,21,12,23,29,54,297,C
2016,24,30,400,43,118,16,49,27,69,9,13,2,26,28,73,16,2,43,30,111,PG
2016,21,27,380,54,116,0,2,54,114,45,62,39,47,86,15,8,7,19,58,153,PF
2016,32,55,1095,156,419,49,136,107,283,153,172,14,96,110,58,26,3,54,83,514,SG
2016,32,39,834,126,334,38,103,88,231,125,142,10,71,81,46,17,1,41,68,415,SG
2016,32,16,261,30,85,11,33,19,52,28,30,4,25,29,12,9,2,13,15,99,SG
2016,29,78,2644,331,854,189,525,142,329,126,146,27,211,238,151,78,17,78,179,977,SF
2016,28,41,1090,119,321,52,162,67,159,31,40,13,92,105,118,48,8,72,126,321,SG
2016,29,75,1274,94,207,13,40,81,167,30,57,60,111,171,30,44,19,34,100,231,PF
2016,23,41,262,45,84,1,2,44,82,26,49,30,28,58,17,10,8,16,39,117,PF
2016,24,41,475,55,146,15,42,40,104,12,15,8,39,47,60,12,7,24,29,137,PG
2016,24,31,256,27,67,5,16,22,51,9,10,6,25,31,33,5,4,11,14,68,PG
2016,24,10,219,28,79,10,26,18,53,3,5,2,14,16,27,7,3,13,15,69,PG
2016,24,80,2780,641,1431,197,472,444,959,187,226,47,212,259,341,97,23,196,187,1666,SG
2016,23,81,1606,218,464,31,89,187,375,26,41,43,207,250,367,95,10,140,114,493,PG
2016,20,24,362,44,109,13,34,31,75,11,23,25,43,68,9,28,12,15,39,112,PF
2016,22,37,235,29,72,7,25,22,47,24,30,16,26,42,10,7,6,17,30,89,SF
2016,24,81,1861,291,644,110,259,181,385,72,84,37,158,195,59,14,6,53,127,764,SF
2016,23,20,72,11,23,0,4,11,19,4,10,4,14,18,3,1,2,7,10,26,PF
2016,28,34,370,77,134,0,1,77,133,18,36,53,80,133,3,5,26,21,49,172,C
2016,22,68,1443,195,455,67,185,128,270,74,103,34,114,148,79,52,10,99,140,531,SG
2016,24,22,195,34,78,10,22,24,56,21,28,4,16,20,25,3,1,15,17,99,PG
2016,24,7,82,11,26,3,11,8,15,12,15,2,6,8,10,3,0,6,7,37,PG
2016,24,15,113,23,52,7,11,16,41,9,13,2,10,12,15,0,1,9,10,62,PG
2016,28,42,595,55,148,12,49,43,99,28,40,22,83,105,81,18,7,30,68,150,PF
2016,28,3,43,7,20,4,9,3,11,4,4,1,4,5,3,0,0,1,2,22,SG
2016,29,34,397,49,78,0,1,49,77,27,46,41,82,123,10,8,36,23,54,125,C
2016,21,16,57,8,22,0,0,8,22,5,10,6,7,13,1,0,11,1,5,21,PF
2016,24,79,2852,507,1142,143,361,364,781,277,312,44,258,302,331,131,19,180,204,1434,SG
2016,28,64,1464,259,634,142,387,117,247,93,124,25,150,175,63,53,29,70,142,753,SF
2016,39,39,461,59,106,2,8,57,98,24,32,12,39,51,87,16,0,37,46,144,PG
2016,39,26,280,36,58,1,4,35,54,15,19,6,18,24,58,9,0,25,32,88,PG
2016,39,13,181,23,48,1,4,22,44,9,13,6,21,27,29,7,0,12,14,56,PG
2016,35,47,373,22,62,19,52,3,10,0,0,6,47,53,40,13,4,17,53,63,SF
2016,27,81,1662,260,612,123,320,137,292,47,58,27,131,158,226,59,6,76,102,690,PG
2016,28,20,173,11,39,1,12,10,27,13,18,6,29,35,19,7,3,9,33,36,SG
2016,30,81,2647,501,1066,74,232,427,834,309,408,198,534,732,265,147,139,191,237,1385,PF
2016,24,66,1646,248,609,135,346,113,263,146,181,58,304,362,100,58,46,102,151,777,PF
2016,38,5,19,3,5,0,0,3,5,2,2,1,3,4,0,0,0,3,4,8,C
2016,25,79,2314,491,941,0,1,491,940,228,308,218,478,696,178,72,67,129,163,1210,C
2016,22,12,42,5,19,1,9,4,10,3,4,0,4,4,1,0,0,4,1,14,SG
2016,26,59,1263,187,389,47,104,140,285,22,35,19,114,133,99,37,18,53,103,443,SG
2016,24,8,48,3,6,0,0,3,6,2,4,3,8,11,1,0,4,3,4,8,PF
2016,26,80,2856,410,945,108,298,302,647,203,271,91,313,404,201,67,23,140,170,1131,SF
2016,26,64,1629,305,718,47,155,258,563,108,147,73,279,352,124,58,34,135,184,765,PF
2016,26,37,917,171,431,22,76,149,355,66,92,43,151,194,87,33,17,90,104,430,PF
2016,26,27,712,134,287,25,79,109,208,42,55,30,128,158,37,25,17,45,80,335,PF
2016,30,68,926,136,333,79,204,57,129,29,39,10,52,62,24,22,5,17,64,380,SG
2016,25,37,547,90,205,16,57,74,148,34,53,37,72,109,41,17,5,44,69,230,PF
2016,29,76,1326,203,359,1,7,202,352,68,95,110,227,337,33,22,57,71,159,475,C
2016,19,68,2068,329,905,74,232,255,673,140,209,32,200,232,372,65,35,217,141,872,PG
2016,23,82,1682,317,681,44,152,273,529,185,242,100,167,267,52,24,7,70,94,863,SF
2016,23,14,244,32,77,9,23,23,54,7,14,3,28,31,22,13,3,15,25,80,SG
2016,24,60,565,76,152,12,39,64,113,31,39,38,79,117,34,13,27,27,72,195,C
2016,23,63,1266,158,300,1,10,157,290,32,47,101,211,312,44,54,23,41,124,349,PF
2016,24,55,600,68,201,34,104,34,97,33,45,9,46,55,97,23,1,46,38,203,PG
2016,31,40,807,151,325,41,100,110,225,47,55,11,72,83,47,20,1,29,55,390,SG
2016,33,39,1036,113,307,43,144,70,163,30,35,19,96,115,190,25,5,66,100,299,PG
2016,23,81,1499,180,418,64,162,116,256,52,70,17,103,120,174,62,2,109,122,476,PG
2016,26,56,823,146,310,41,114,105,196,51,65,34,167,201,25,10,22,41,69,384,PF
2016,30,29,635,51,133,0,1,51,132,22,45,87,168,255,110,18,29,52,77,124,C
2016,21,67,1965,306,587,1,2,305,585,134,227,154,388,542,122,118,100,158,192,747,C
2016,23,29,225,28,44,1,3,27,41,8,15,18,28,46,7,12,12,11,29,65,C
2016,32,10,44,8,18,7,15,1,3,1,1,0,5,5,0,0,0,1,3,24,PF
2016,32,7,24,6,12,5,9,1,3,0,0,0,4,4,0,0,0,1,1,17,PF
2016,37,75,2364,498,1112,126,342,372,770,250,280,52,437,489,132,52,52,84,161,1372,PF
2016,21,32,547,101,242,0,3,101,239,61,99,65,110,175,40,24,44,55,91,263,C
2016,23,2,6,0,1,0,0,0,1,0,0,0,1,1,0,1,0,0,1,0,SF
2016,22,66,857,86,209,1,1,85,208,27,40,65,111,176,32,18,8,31,100,200,PF
2016,25,65,764,129,271,5,22,124,249,46,60,76,174,250,72,20,49,61,107,309,PF
2016,20,53,1591,397,781,1,6,396,775,133,194,122,251,373,65,22,61,124,140,928,C
2016,23,72,2379,425,970,98,282,327,688,205,247,48,297,345,282,116,54,153,174,1153,SG
2016,24,69,1395,253,556,85,210,168,346,96,128,72,209,281,105,52,33,74,163,687,C
2016,20,63,671,90,211,25,79,65,132,31,49,25,108,133,13,22,7,34,100,236,SF
2016,31,76,2004,219,470,0,3,219,467,212,276,249,469,718,128,64,22,119,181,650,C
2016,25,26,294,24,66,10,32,14,34,9,14,8,32,40,16,13,5,21,24,67,SF
2016,20,76,2408,443,899,9,35,434,864,175,228,123,272,395,130,69,29,116,154,1070,PF
2016,33,72,1980,350,710,27,65,323,645,130,171,17,159,176,379,54,11,131,114,857,PG
2016,27,61,1799,320,651,104,251,216,400,93,136,29,256,285,169,46,21,95,114,837,SF
2016,24,35,395,28,80,12,49,16,31,16,22,4,46,50,39,9,2,23,45,84,SG
2016,26,79,2020,204,493,106,293,98,200,29,34,77,265,342,94,53,32,65,128,543,PF
2016,30,74,2420,515,1114,122,329,393,785,294,328,39,271,310,738,152,13,194,185,1446,PG
2016,24,52,486,53,145,9,32,44,113,17,26,20,91,111,29,16,11,36,77,132,PF
2016,21,57,698,114,278,36,111,78,167,19,24,9,76,85,108,36,6,44,80,283,PG
2016,21,73,2145,318,730,30,92,288,638,112,190,77,184,261,468,89,20,177,159,778,PG
2016,30,12,156,19,50,0,0,19,50,16,20,7,14,21,11,1,0,9,22,54,C
2016,31,37,542,40,75,0,0,40,75,11,25,25,103,128,31,11,11,41,64,91,C
2016,38,68,1231,144,397,75,242,69,155,54,66,12,174,186,71,33,17,58,129,417,SF
2016,26,12,82,11,25,0,2,11,23,2,2,6,9,15,2,1,2,8,19,24,C
2016,25,82,2084,267,517,0,4,267,513,215,335,201,427,628,226,68,85,154,253,749,C
2016,27,61,870,140,233,0,0,140,233,34,59,94,138,232,16,21,50,40,73,314,C
2016,22,75,2276,339,717,98,267,241,450,95,126,97,294,391,120,105,32,70,163,871,SF
2016,20,62,1102,186,436,16,52,170,384,48,66,123,214,337,52,25,22,54,100,436,PF
2016,20,72,2047,373,886,81,243,292,643,201,240,132,394,526,94,53,134,121,205,1028,PF
2016,24,69,992,146,296,2,16,144,280,105,142,84,189,273,44,36,24,40,118,399,PF
2016,22,49,725,97,229,36,89,61,140,43,53,16,95,111,47,29,10,32,59,273,SG
2016,24,23,283,30,78,4,18,26,60,13,25,3,28,31,75,18,4,33,28,77,PG
2016,24,14,170,21,55,4,13,17,42,9,18,0,23,23,46,11,1,19,14,55,PG
2016,24,9,113,9,23,0,5,9,18,4,7,3,5,8,29,7,3,14,14,22,PG
2016,32,62,1211,116,302,68,196,48,106,31,41,25,74,99,147,74,13,70,161,331,PG
2016,38,59,823,55,147,28,95,27,52,7,8,38,76,114,130,53,1,49,82,145,PG
2016,35,77,1462,102,229,4,23,98,206,13,19,32,115,147,73,36,13,27,62,221,SF
2016,21,81,2286,358,835,10,36,348,799,193,270,172,657,829,144,53,29,149,242,919,PF
2016,34,68,2016,431,907,6,26,425,881,172,216,179,350,529,142,43,13,105,146,1040,PF
2016,31,75,2097,422,880,200,421,222,459,182,205,10,129,139,106,42,5,78,135,1226,SG
2016,25,39,426,76,133,0,0,76,133,30,55,49,73,122,10,6,30,16,47,182,C
2016,22,52,1107,123,272,53,115,70,157,42,63,21,86,107,73,36,25,35,107,341,SG
2016,23,67,1464,226,516,62,185,164,331,79,116,22,108,130,99,48,9,61,137,593,SG
2016,24,70,1553,136,274,32,103,104,171,33,54,79,172,251,47,53,42,35,133,337,SG
2016,30,51,470,74,165,15,42,59,123,42,47,6,35,41,54,10,2,23,35,205,PG
2016,30,30,333,51,115,9,27,42,88,34,37,4,25,29,38,7,1,16,23,145,PG
2016,30,21,137,23,50,6,15,17,35,8,10,2,10,12,16,3,1,7,12,60,PG
2016,22,45,508,65,151,14,37,51,114,27,39,12,56,68,26,17,9,18,21,171,SF
2016,24,71,917,130,291,0,1,130,290,47,109,136,223,359,46,39,36,69,111,307,PF
2016,29,72,2537,355,782,62,170,293,612,87,150,77,358,435,839,141,10,278,175,859,PG
2016,27,66,2097,447,1048,44,150,403,898,142,179,46,179,225,311,44,14,175,84,1080,PG
2016,24,73,1747,270,626,131,339,139,287,49,62,21,164,185,56,54,25,46,120,720,SF
2016,21,39,311,29,106,6,27,23,79,8,10,24,39,63,37,6,1,19,23,72,PG
2016,25,76,2323,219,586,62,190,157,396,266,314,40,286,326,658,162,10,193,201,766,PG
2016,29,33,277,25,62,17,50,8,12,8,8,5,15,20,11,3,1,13,33,75,SF
2016,30,72,1055,111,260,65,157,46,103,18,28,21,160,181,57,20,23,33,57,305,SG
2016,19,80,2259,392,956,130,370,262,586,140,190,47,227,274,266,93,13,196,142,1054,PG
2016,26,25,320,31,75,0,0,31,75,25,38,32,40,72,14,4,10,12,43,87,C
2016,22,73,1160,140,317,14,63,126,254,80,122,46,144,190,46,23,33,70,142,374,SF
2016,22,47,691,86,202,6,34,80,168,62,97,30,99,129,30,11,16,51,91,240,SF
2016,22,26,469,54,115,8,29,46,86,18,25,16,45,61,16,12,17,19,51,134,SF
2016,22,80,1621,329,781,77,239,252,542,144,182,25,179,204,349,70,9,183,138,879,PG
2016,35,76,1636,269,598,65,161,204,437,61,84,84,276,360,66,46,27,68,178,664,PF
2016,27,75,1146,176,376,62,158,114,218,50,63,53,153,206,78,25,17,42,102,464,PF
2016,31,75,1758,188,372,42,124,146,248,62,99,52,282,334,107,85,37,68,109,480,SF
2016,26,48,526,84,205,0,2,84,203,19,23,31,95,126,47,8,36,43,67,187,C
2016,29,82,1667,280,592,36,111,244,481,214,283,25,178,203,239,46,5,115,102,810,PG
2016,25,54,1316,114,305,43,146,71,159,40,51,32,171,203,92,54,19,57,119,311,SG
2016,26,55,813,122,242,18,47,104,195,69,92,16,80,96,58,24,5,53,103,331,SG
2016,25,14,263,33,77,0,0,33,77,25,30,21,51,72,9,9,14,12,37,91,C
2016,27,68,977,86,221,30,97,56,124,29,44,50,91,141,24,30,9,32,120,231,SF
2016,28,61,1318,154,350,38,99,116,251,78,104,17,156,173,268,32,4,80,73,424,PG
2016,21,61,1667,184,529,61,241,123,288,129,166,76,179,255,185,91,18,80,183,558,PG
2016,25,18,192,18,32,0,0,18,32,7,17,12,30,42,6,4,1,7,28,43,PF
2016,27,77,2239,397,967,56,170,341,797,122,176,43,262,305,502,88,24,175,133,972,PG
2016,27,27,617,98,228,10,33,88,195,33,43,14,78,92,154,24,6,45,38,239,PG
2016,27,50,1622,299,739,46,137,253,602,89,133,29,184,213,348,64,18,130,95,733,PG
2016,30,77,2362,353,850,204,510,149,340,45,71,43,174,217,130,81,21,59,204,955,SG
2016,29,76,1181,244,503,4,16,240,487,54,67,53,166,219,62,33,65,57,163,546,C
2016,30,55,880,127,349,41,143,86,206,37,67,51,141,192,90,34,47,77,118,332,PF
2016,30,32,459,69,180,18,58,51,122,25,42,33,92,125,42,18,34,41,62,181,PF
2016,30,23,421,58,169,23,85,35,84,12,25,18,49,67,48,16,13,36,56,151,PF
2016,24,15,66,7,22,1,5,6,17,8,13,1,8,9,11,5,1,7,5,23,PG
2016,24,64,1301,126,339,56,155,70,184,30,33,19,180,199,63,16,17,52,100,338,SF
2016,28,72,832,197,456,24,62,173,394,94,114,77,162,239,61,19,34,66,117,512,C
2016,31,36,579,81,155,0,2,81,153,39,48,45,75,120,30,20,12,24,71,201,C
2016,22,73,1809,210,545,106,325,104,220,91,118,23,160,183,138,44,20,94,115,617,SG
2016,25,69,1372,228,474,30,78,198,396,87,111,40,183,223,133,43,9,94,135,573,SF
2016,25,43,680,82,166,19,47,63,119,21,30,19,89,108,60,24,3,48,79,204,SF
2016,25,26,692,146,308,11,31,135,277,66,81,21,94,115,73,19,6,46,56,369,SF
2016,28,8,73,9,27,0,0,9,27,4,12,19,9,28,2,1,5,0,12,22,PF
2016,28,4,12,1,1,0,0,1,1,0,2,1,1,2,0,0,2,0,4,2,PF
2016,28,4,61,8,26,0,0,8,26,4,10,18,8,26,2,1,3,0,8,20,PF
2016,22,7,18,3,5,0,0,3,5,1,2,1,3,4,1,1,0,0,1,7,C
2016,22,5,14,3,5,0,0,3,5,1,2,0,2,2,1,1,0,0,1,7,C
2016,33,52,762,125,221,0,0,125,221,50,67,65,157,222,27,18,41,47,92,300,C
2016,29,58,1275,183,443,20,83,163,360,131,158,19,137,156,142,43,8,76,77,517,PG
2016,23,81,1915,351,806,29,103,322,703,103,161,194,479,673,187,75,47,102,209,834,PF
2016,23,11,73,11,19,0,0,11,19,3,8,7,14,21,3,1,6,5,8,25,C
2016,27,79,2255,434,988,110,275,324,713,261,312,33,181,214,470,97,24,218,167,1239,PG
2016,30,79,1686,332,777,181,460,151,317,120,155,55,247,302,89,32,21,84,159,965,PF
2016,29,80,1951,201,505,89,258,112,247,91,125,36,176,212,140,69,18,64,195,582,SF
2016,38,72,1258,151,376,93,261,58,115,27,33,14,65,79,103,47,9,49,91,422,SG
2016,26,82,2644,591,1382,167,465,424,917,474,544,46,197,243,509,91,9,220,167,1823,PG
2016,27,59,1313,169,382,44,109,125,273,102,119,34,97,131,53,22,7,57,109,484,PF
2016,24,77,2154,270,680,149,392,121,288,69,96,54,218,272,99,36,24,76,187,758,SG
2016,29,47,471,52,108,5,15,47,93,38,54,32,102,134,29,12,20,15,80,147,C
2016,29,28,179,20,42,0,0,20,42,20,32,10,44,54,19,4,8,7,40,60,C
2016,29,19,292,32,66,5,15,27,51,18,22,22,58,80,10,8,12,8,40,87,C
2016,25,80,2666,651,1386,276,650,375,736,193,221,35,271,306,166,60,49,138,152,1771,SG
2016,24,82,2269,247,420,0,0,247,420,149,242,268,470,738,62,38,51,61,202,643,PF
2016,28,61,1109,216,542,91,270,125,272,67,79,38,112,150,85,47,4,51,90,590,SG
2016,28,47,885,174,435,73,216,101,219,51,58,31,84,115,66,34,3,40,73,472,SG
2016,28,14,224,42,107,18,54,24,53,16,21,7,28,35,19,13,1,11,17,118,SG
2016,30,72,1341,128,332,98,272,30,60,29,47,39,190,229,52,26,16,28,86,383,PF
2016,23,21,305,25,70,13,40,12,30,13,17,8,23,31,15,7,6,6,40,76,SF
2016,20,82,2627,625,1153,30,88,595,1065,223,275,229,629,858,161,58,138,183,245,1503,C
2016,30,82,2540,239,582,68,206,171,376,106,142,165,347,512,177,106,20,111,202,652,SF
2016,27,81,2271,343,753,20,83,323,670,148,179,50,347,397,359,80,28,169,139,854,SG
2016,19,60,1367,264,530,3,14,261,516,88,121,68,264,332,41,25,86,67,158,619,C
2016,33,44,707,86,198,15,44,71,154,18,20,8,64,72,116,14,1,53,51,205,PG
2016,33,8,120,20,46,4,11,16,35,3,3,2,7,9,26,3,1,11,11,47,PG
2016,33,36,587,66,152,11,33,55,119,15,17,6,57,63,90,11,0,42,40,158,PG
2016,23,60,1557,303,536,0,0,303,536,162,213,184,363,547,42,25,80,85,158,768,C
2016,33,53,496,53,124,0,1,53,123,32,50,37,104,141,35,16,10,22,70,138,C
2016,33,31,310,32,76,0,1,32,75,16,21,24,67,91,20,11,5,16,35,80,C
2016,33,22,186,21,48,0,0,21,48,16,29,13,37,50,15,5,5,6,35,58,C
2016,29,23,460,45,138,18,73,27,65,22,26,5,42,47,91,10,0,40,42,130,PG
2016,19,70,1001,81,266,43,147,38,119,12,15,11,77,88,39,29,16,28,73,217,SG
2016,31,62,665,125,327,47,172,78,155,22,24,24,128,152,24,18,15,31,71,319,PF
2016,20,78,1174,117,278,11,46,106,232,38,51,91,214,305,30,27,26,50,152,283,PF
2016,25,65,2037,533,1046,2,9,531,1037,113,150,174,402,576,179,53,70,123,173,1181,C
2016,31,61,908,106,277,52,143,54,134,32,39,26,123,149,84,34,5,44,83,296,SG
2016,34,74,2258,540,1183,7,44,533,1139,322,406,82,220,302,344,79,42,203,116,1409,SG
2016,24,78,2152,282,706,86,240,196,466,112,157,36,166,202,154,81,15,120,143,762,SG
2016,25,81,2885,568,1331,182,490,386,841,371,438,56,301,357,421,126,39,171,111,1689,PG
2016,25,77,2784,572,1349,115,328,457,1021,272,344,42,337,379,789,145,59,318,159,1531,PG
2016,22,47,1070,221,441,28,70,193,371,45,64,57,90,147,44,37,16,32,94,515,SF
2016,31,33,656,47,137,14,48,33,89,34,39,10,56,66,88,19,5,25,49,142,PG
2016,23,7,169,14,39,0,5,14,34,3,4,8,17,25,21,9,3,9,12,31,PG
2016,23,6,166,13,38,0,5,13,33,3,4,8,16,24,20,9,3,9,11,29,PG
2016,23,1,3,1,1,0,0,1,1,0,0,0,1,1,1,0,0,0,1,2,PG
2016,29,36,421,35,89,13,32,22,57,7,13,6,35,41,47,10,1,37,40,90,SG
2016,29,7,78,7,21,2,9,5,12,1,2,1,11,12,2,0,0,4,7,17,SF
2016,35,78,1404,244,448,3,7,241,441,63,80,72,237,309,143,44,55,68,142,554,PF
2016,27,80,2750,656,1444,101,341,555,1103,465,573,145,481,626,834,163,20,342,200,1878,PG
2016,26,73,2125,413,682,0,0,413,682,214,329,238,627,865,30,44,269,137,201,1040,C
2016,24,7,41,5,11,0,2,5,9,1,2,5,7,12,3,1,1,5,7,11,PF
2016,20,81,2845,594,1294,57,190,537,1104,430,565,105,186,291,164,78,46,182,165,1675,SF
2016,25,23,167,26,66,9,23,17,43,9,12,1,11,12,10,10,2,2,15,70,SG
2016,23,10,68,10,24,0,0,10,24,9,14,14,24,38,5,4,5,6,15,29,PF
2016,31,65,2106,321,775,97,282,224,493,179,206,19,171,190,378,61,14,150,155,918,PG
2016,24,80,1435,254,565,44,150,210,415,194,256,47,249,296,75,29,9,61,69,746,SF
2016,26,5,45,2,10,1,4,1,6,3,4,1,3,4,4,0,0,1,2,8,PG
2016,29,67,1907,283,693,110,320,173,373,352,424,31,138,169,167,62,19,107,107,1028,SG
2016,29,81,2338,338,747,152,378,186,369,120,144,127,394,521,110,58,77,62,133,948,PF
2016,33,41,748,132,302,36,102,96,200,38,42,6,66,72,98,14,5,57,60,338,PG
2016,19,78,2232,195,462,32,116,163,346,80,117,81,322,403,117,68,26,95,184,502,SF
2016,25,51,658,87,162,0,2,87,160,43,59,56,117,173,20,21,53,28,75,217,C
2016,20,17,145,22,53,4,11,18,42,13,21,13,25,38,3,5,7,2,11,61,PF
2016,36,35,590,55,177,26,84,29,93,40,57,19,70,89,27,22,11,15,67,176,SF
2016,28,12,212,35,52,0,0,35,52,13,24,14,29,43,6,5,15,10,21,83,PF
2016,23,27,229,36,80,5,13,31,67,26,35,8,29,37,31,8,3,16,7,103,PG
2016,22,8,144,22,65,3,17,19,48,20,37,2,19,21,20,3,0,29,11,67,PG
2016,20,29,199,11,36,6,26,5,10,1,4,4,22,26,9,6,1,5,17,29,SG
2016,23,41,384,62,169,10,46,52,123,20,25,6,44,50,65,15,0,33,30,154,PG
2016,30,54,1033,126,372,77,237,49,135,63,76,14,83,97,34,23,7,30,50,392,SG
2016,27,73,2407,495,963,7,30,488,933,105,163,176,484,660,135,112,37,136,182,1102,PF
2016,23,73,1774,231,437,1,10,230,427,175,232,138,317,455,71,57,63,68,204,638,C
2016,26,60,710,138,290,0,0,138,290,88,108,62,116,178,29,10,22,46,97,364,C
2017,23,68,1055,134,341,94,247,40,94,44,49,18,68,86,40,37,8,33,114,406,SG
2017,26,38,558,70,170,37,90,33,80,45,60,20,95,115,18,14,15,21,67,222,PF
2017,26,6,48,5,17,1,7,4,10,2,3,2,6,8,0,0,0,2,9,13,PF
2017,26,32,510,65,153,36,83,29,70,43,57,18,89,107,18,14,15,19,58,209,PF
2017,23,80,2389,374,655,0,1,374,654,157,257,282,333,615,86,88,78,146,195,905,C
2017,31,61,1580,185,420,62,151,123,269,83,93,9,116,125,78,21,7,42,104,515,SG
2017,28,39,584,89,178,0,4,89,174,29,40,46,131,177,12,20,22,31,77,207,C
2017,28,62,531,45,86,0,0,45,86,15,22,51,107,158,25,25,23,17,85,105,C
2017,31,72,2335,500,1049,23,56,477,993,220,271,174,350,524,139,46,89,98,158,1243,PF
2017,27,61,871,77,168,0,1,77,167,23,33,105,115,220,57,18,24,29,78,177,PF
2017,35,71,1914,274,595,15,54,259,541,80,130,166,225,391,98,115,29,100,178,643,SG
2017,26,61,1773,183,466,70,212,113,254,96,136,77,374,451,99,60,44,94,102,532,SF
2017,38,12,114,9,22,0,3,9,19,10,14,9,22,31,5,5,7,5,20,28,C
2017,34,30,308,30,80,14,44,16,36,12,16,3,21,24,11,3,0,7,35,86,SF
2017,23,75,1228,186,439,58,194,128,245,102,129,69,176,245,66,41,23,66,109,532,SF
2017,23,51,710,111,277,37,122,74,155,70,88,39,110,149,32,28,16,40,64,329,SF
2017,23,24,518,75,162,21,72,54,90,32,41,30,66,96,34,13,7,26,45,203,SF
2017,23,72,1020,93,209,15,40,78,169,45,57,33,175,208,91,51,26,39,63,246,SG
2017,28,72,2116,323,773,204,506,119,267,129,150,112,218,330,68,32,14,55,142,979,PF
2017,22,80,2845,656,1259,49,180,607,1079,471,612,142,558,700,434,131,151,234,246,1832,SF
2017,32,74,2538,602,1389,151,421,451,968,304,365,62,374,436,213,60,34,153,198,1659,SF
2017,34,19,122,10,16,0,0,10,16,5,8,8,23,31,3,2,6,4,11,25,C
2017,31,80,2773,326,798,191,555,135,243,93,126,54,405,459,175,147,20,74,133,936,SF
2017,28,41,639,95,215,53,117,42,98,19,22,25,87,112,42,19,21,36,76,262,PF
2017,30,31,482,31,65,0,0,31,65,23,39,48,115,163,15,5,10,14,51,85,C
2017,29,78,1538,195,517,95,274,100,243,131,161,15,102,117,209,31,1,90,101,616,PG
2017,27,68,1065,113,281,87,210,26,71,11,15,13,129,142,36,21,11,25,118,324,SF
2017,23,52,857,82,217,23,86,59,131,28,43,12,86,98,107,34,8,56,74,215,SG
2017,20,33,405,36,115,3,22,33,93,31,37,11,35,46,61,18,7,40,40,106,PG
2017,34,67,963,172,392,35,98,137,294,40,45,15,89,104,81,31,8,48,82,419,SG
2017,32,35,771,142,343,53,148,89,195,44,51,9,75,84,193,14,1,63,30,381,PG
2017,24,79,2803,599,1280,78,222,521,1058,242,281,94,303,397,117,66,15,102,128,1518,PF
2017,36,74,1777,185,473,87,263,98,210,70,89,70,317,387,194,48,26,107,185,527,SF
2017,36,54,1367,147,383,69,211,78,172,50,66,55,241,296,149,36,17,83,138,413,SF
2017,36,20,410,38,90,18,52,20,38,20,23,15,76,91,45,12,9,24,47,114,SF
2017,26,60,1705,295,666,87,235,208,431,143,190,58,200,258,206,48,28,97,110,820,SG
2017,31,52,577,107,186,1,3,106,183,77,88,43,86,129,21,14,11,29,45,292,PF
2017,28,77,2617,393,975,135,405,258,570,243,284,46,435,481,455,86,29,194,109,1164,SG
2017,28,3,71,11,32,2,5,9,27,9,10,3,9,12,13,0,0,9,4,33,PG
2017,30,75,1163,143,279,0,0,143,279,79,94,111,222,333,32,17,39,50,166,365,C
2017,27,73,1963,295,721,92,266,203,455,119,168,45,186,231,177,91,52,125,165,801,SF
2017,23,77,2684,637,1322,223,552,414,770,282,342,53,186,239,267,83,21,157,169,1779,SG
2017,20,22,165,33,73,9,28,24,45,8,10,5,12,17,11,7,0,8,10,83,SG
2017,28,56,935,216,406,18,43,198,363,78,105,40,153,193,53,28,27,66,92,528,PF
2017,30,74,1778,264,615,102,283,162,332,150,168,14,164,178,147,44,9,70,90,780,SG
2017,22,38,371,47,98,1,18,46,80,6,16,14,45,59,28,8,5,16,21,101,SF
2017,19,43,574,57,161,28,101,29,60,4,11,23,80,103,23,10,22,32,74,146,PF
2017,23,23,264,38,92,13,48,25,44,26,36,25,53,78,12,5,3,12,18,115,PF
2017,21,3,10,0,3,0,1,0,2,0,0,0,2,2,0,0,0,1,1,0,PF
2017,24,67,808,103,234,69,173,34,61,28,34,22,77,99,46,20,28,32,75,303,PF
2017,28,67,2058,228,543,110,288,118,255,73,95,95,299,394,281,99,25,100,222,639,SG
2017,24,81,1793,179,339,0,0,179,339,125,234,157,410,567,74,25,91,95,202,483,C
2017,28,65,1190,151,356,56,177,95,179,45,61,57,187,244,79,40,20,59,154,403,PF
2017,25,67,1091,150,294,1,2,149,292,82,109,143,199,342,39,30,44,58,173,383,C
2017,27,66,2176,449,1034,104,310,345,724,388,458,52,268,320,418,92,31,223,164,1390,PG
2017,27,81,2083,376,845,144,392,232,453,217,243,37,240,277,111,34,7,130,146,1113,SF
2017,27,55,1482,269,611,99,277,170,334,146,167,23,174,197,90,24,3,92,99,783,SF
2017,27,26,601,107,234,45,115,62,119,71,76,14,66,80,21,10,4,38,47,330,SF
2017,32,27,583,38,81,0,1,38,80,3,11,56,162,218,49,13,25,43,86,79,C
2017,32,26,582,38,81,0,1,38,80,3,11,56,162,218,49,13,25,43,84,79,C
2017,23,12,53,9,16,1,4,8,12,3,6,4,13,17,2,1,2,2,1,22,PF
2017,20,78,2730,606,1431,147,405,459,1026,367,441,46,203,249,268,72,21,241,242,1726,SG
2017,29,71,1754,305,591,25,78,280,513,74,110,142,428,570,138,76,28,127,152,709,PF
2017,26,55,1835,359,775,108,277,251,498,68,93,65,269,334,121,68,11,88,141,894,SG
2017,30,82,1281,147,348,27,118,120,230,50,68,32,134,166,97,61,19,55,133,371,SF
2017,30,58,923,94,227,22,94,72,133,32,44,21,93,114,61,37,11,36,104,242,SF
2017,30,24,358,53,121,5,24,48,97,18,24,11,41,52,36,24,8,19,29,129,SF
2017,24,75,1982,290,635,78,193,212,442,109,126,47,166,213,317,84,12,113,140,767,SG
2017,32,65,894,121,300,48,128,73,172,32,40,18,51,69,125,25,9,66,93,322,PG
2017,24,11,159,18,50,7,27,11,23,0,0,8,25,33,8,5,1,6,15,43,SF
2017,24,9,143,14,41,6,24,8,17,0,0,6,20,26,6,5,1,5,13,34,SF
2017,24,2,16,4,9,1,3,3,6,0,0,2,5,7,2,0,0,1,2,9,SF
2017,32,25,123,23,60,14,35,9,25,2,2,0,6,6,14,1,0,5,5,62,PG
2017,20,78,1341,192,423,46,135,146,288,85,124,45,175,220,64,35,18,68,142,515,SF
2017,23,54,521,52,141,29,95,23,46,17,22,26,69,95,47,17,8,26,43,150,SF
2017,25,31,467,54,128,28,73,26,55,5,7,13,51,64,29,18,3,10,22,141,SF
2017,24,57,703,116,255,31,70,85,185,22,29,7,40,47,100,11,5,48,54,285,PG
2017,25,42,653,99,248,25,76,74,172,60,78,17,103,120,30,18,5,35,50,283,SG
2017,27,76,2809,570,1252,91,248,479,1004,585,676,129,341,470,417,143,32,159,112,1816,SF
2017,21,9,40,6,16,2,6,4,10,0,0,5,5,10,4,2,1,2,4,14,SF
2017,35,41,539,55,134,20,64,35,70,11,12,15,59,74,88,11,1,41,36,141,PG
2017,35,24,292,32,77,12,34,20,43,4,4,8,34,42,51,7,1,26,22,80,PG
2017,35,17,247,23,57,8,30,15,27,7,8,7,25,32,37,4,0,15,14,61,PG
2017,23,76,2529,370,928,153,437,217,491,154,185,55,193,248,193,89,12,86,118,1047,SG
2017,25,39,592,63,173,25,94,38,79,30,33,6,43,49,37,22,1,20,35,181,SG
2017,22,65,1551,362,563,0,0,362,563,94,177,178,348,526,64,34,80,87,179,818,C
2017,30,72,1882,220,549,109,320,111,229,89,117,63,212,275,74,81,27,54,143,638,SF
2017,40,73,1799,193,490,112,296,81,194,88,115,36,191,227,133,60,36,50,163,586,SF
2017,25,45,846,112,306,15,64,97,242,58,77,24,128,152,113,38,23,66,102,297,PG
2017,28,36,643,77,165,15,43,62,122,17,29,27,85,112,37,23,3,29,50,186,SF
2017,28,22,397,53,117,11,29,42,88,12,21,20,70,90,26,10,1,17,23,129,SF
2017,28,1,24,5,9,2,4,3,5,0,0,1,1,2,0,0,0,2,3,12,SF
2017,28,13,222,19,39,2,10,17,29,5,8,6,14,20,11,13,2,10,24,45,SF
2017,23,75,1421,255,481,0,2,255,479,101,151,85,255,340,80,53,45,69,147,611,C
2017,34,47,1298,153,228,0,0,153,228,91,124,154,385,539,30,33,24,67,126,397,C
2017,29,71,2197,433,939,110,326,323,613,141,194,103,356,459,141,52,30,114,172,1117,SF
2017,19,82,1743,284,632,72,224,212,408,113,181,96,252,348,60,67,70,108,263,753,PF
2017,25,29,219,19,43,0,0,19,43,21,29,26,30,56,4,3,6,8,37,59,PF
2017,24,64,973,77,223,12,63,65,160,17,31,19,69,88,130,28,6,43,79,183,PG
2017,25,77,1137,211,433,61,163,150,270,44,58,22,100,122,90,39,8,55,77,527,SG
2017,24,82,2397,477,1071,117,356,360,715,134,168,49,197,246,213,88,8,164,150,1205,SG
2017,28,13,125,16,52,3,13,13,39,8,10,0,11,11,14,8,0,7,18,43,PG
2017,29,68,2063,340,714,73,175,267,539,147,171,23,130,153,312,67,9,114,119,900,PG
2017,36,20,128,14,23,0,1,14,22,5,8,9,21,30,12,2,2,4,17,33,PF
2017,29,69,2292,464,1009,171,419,293,590,316,368,31,211,242,433,92,19,156,126,1415,PG
2017,24,39,316,37,72,17,33,20,39,7,9,10,42,52,28,6,2,17,23,98,SG
2017,23,14,188,33,66,11,26,22,40,2,5,1,6,7,26,4,0,13,13,79,PG
2017,23,5,77,11,25,5,14,6,11,0,2,0,3,3,12,1,0,8,6,27,PG
2017,23,9,111,22,41,6,12,16,29,2,3,1,3,4,14,3,0,5,7,52,PG
2017,26,72,2465,647,1433,131,364,516,1069,517,670,153,644,797,332,100,92,269,278,1942,C
2017,26,55,1891,505,1119,95,268,410,851,423,549,115,470,585,266,75,73,207,203,1528,C
2017,26,17,574,142,314,36,96,106,218,94,121,38,174,212,66,25,19,62,75,414,C
2017,26,67,2119,292,732,137,412,155,320,143,174,92,344,436,102,127,69,131,203,864,SF
2017,24,79,2254,303,647,134,302,169,345,105,124,19,206,225,93,54,20,62,171,845,SG
2017,36,82,2157,359,869,116,322,243,547,174,203,17,112,129,213,59,14,134,115,1008,SG
2017,28,19,442,105,218,37,95,68,123,20,26,4,30,34,57,11,2,25,30,267,SG
2017,26,72,2335,333,720,157,394,176,326,176,217,48,367,415,155,72,23,79,161,999,SF
2017,29,66,1649,174,359,71,181,103,178,16,27,56,221,277,36,39,28,28,100,435,SF
2017,26,70,2029,338,703,137,322,201,381,85,100,25,153,178,188,79,7,92,126,898,PG
2017,28,79,2638,675,1443,324,789,351,654,325,362,61,292,353,523,143,17,239,183,1999,PG
2017,25,67,1183,185,495,138,355,47,140,43,54,21,79,100,46,21,4,45,90,551,SG
2017,23,75,2708,770,1527,40,134,730,1393,519,647,174,712,886,157,94,167,181,168,2099,C
2017,20,36,238,24,47,0,0,24,47,10,18,20,40,60,2,3,17,8,40,58,C
2017,27,46,789,75,142,0,0,75,142,50,81,96,147,243,27,15,22,37,137,200,PF
2017,27,76,1330,161,259,0,0,161,259,65,93,129,366,495,44,37,61,61,180,387,C
2017,22,77,1419,203,429,60,187,143,242,38,68,94,190,284,76,38,21,41,83,504,SF
2017,27,73,1248,145,388,26,110,119,278,75,93,11,113,124,193,39,1,95,112,391,PG
2017,26,76,1986,208,534,79,215,129,319,82,96,24,123,147,357,53,0,133,153,577,PG
2017,31,56,1486,164,424,51,165,113,259,46,63,63,232,295,74,48,20,43,61,425,SF
2017,27,74,2620,721,1545,33,124,688,1421,545,647,70,316,386,290,78,13,180,134,2020,SG
2017,20,17,199,36,76,0,0,36,76,15,21,23,50,73,4,4,7,7,17,87,PF
2017,34,73,1283,146,327,20,81,126,246,26,35,46,112,158,170,18,9,87,83,338,PF
2017,27,82,2653,332,661,16,43,316,618,136,167,188,459,647,158,88,95,107,254,816,PF
2017,23,59,1334,134,302,38,101,96,201,126,159,27,137,164,185,44,23,66,119,432,PG
2017,30,24,394,43,117,7,42,36,75,24,29,13,48,61,56,18,5,21,50,117,PG
2017,30,73,2459,534,1124,117,289,417,835,298,377,61,217,278,423,89,13,212,199,1483,PG
2017,23,81,2409,483,911,2,7,481,904,137,355,345,771,1116,89,124,89,152,237,1105,C
2017,31,64,1362,157,346,77,203,80,143,43,65,31,194,225,121,42,16,72,154,434,PF
2017,36,53,841,93,220,53,134,40,86,36,45,18,97,115,50,15,7,28,67,275,SF
2017,36,23,366,36,90,20,57,16,33,14,19,5,42,47,20,6,2,14,32,106,SF
2017,36,30,475,57,130,33,77,24,53,22,26,13,55,68,30,9,5,14,35,169,SF
2017,22,78,1333,118,313,21,73,97,240,36,59,24,142,166,188,78,36,89,178,293,PG
2017,28,62,2070,551,1026,117,312,434,714,336,384,39,474,513,300,66,99,138,117,1555,SF
2017,25,5,62,6,19,4,16,2,3,8,9,1,6,7,0,1,0,1,1,24,SF
2017,20,19,146,23,64,10,35,13,29,4,8,8,33,41,7,1,1,14,6,60,PF
2017,29,62,1500,231,555,149,394,82,161,37,43,18,115,133,70,35,4,30,70,648,SG
2017,31,74,1998,247,557,43,135,204,422,93,128,19,185,204,236,79,27,135,149,630,SG
2017,22,31,786,200,429,36,98,164,331,191,244,61,182,243,66,27,76,117,112,627,C
2017,26,64,1501,146,321,51,137,95,184,86,110,69,190,259,64,46,19,59,165,429,SF
2017,22,53,588,90,208,27,70,63,138,21,25,10,36,46,86,26,2,45,58,228,PG
2017,22,31,196,25,64,6,16,19,48,2,3,4,15,19,34,6,0,24,29,58,PG
2017,22,22,392,65,144,21,54,44,90,19,22,6,21,27,52,20,2,21,29,170,PG
2017,27,40,788,150,370,42,118,108,252,69,92,13,124,137,124,35,9,61,60,411,SF
2017,27,26,474,91,227,21,70,70,157,45,58,6,80,86,91,23,4,39,41,248,SF
2017,27,14,314,59,143,21,48,38,95,24,34,7,44,51,33,12,5,22,19,163,SF
2017,21,66,1228,155,363,44,149,111,214,58,73,30,102,132,112,21,12,80,146,412,PG
2017,27,61,1296,228,416,0,6,228,410,131,189,182,279,461,55,43,40,58,124,587,PF
2017,30,2,35,4,12,4,9,0,3,0,0,1,2,3,9,2,0,3,1,12,PG
2017,25,50,1186,203,417,3,10,200,407,67,109,92,213,305,56,45,40,60,103,476,PF
2017,21,42,386,62,158,7,22,55,136,35,49,3,38,41,58,18,7,31,38,166,PG
2017,24,66,1040,128,222,0,0,128,222,60,93,124,187,311,40,25,16,33,110,316,C
2017,32,80,1700,221,514,46,144,175,370,50,64,33,184,217,191,67,22,83,125,538,PG
2017,23,46,1197,160,394,68,176,92,218,74,89,20,91,111,172,42,9,70,90,462,PG
2017,23,10,151,18,49,8,27,10,22,10,16,4,8,12,17,2,2,14,11,54,PG
2017,23,36,1046,142,345,60,149,82,196,64,73,16,83,99,155,40,7,56,79,408,PG
2017,23,81,1642,124,333,56,191,68,142,46,61,55,166,221,67,52,25,45,125,350,PF
2017,23,36,285,36,99,17,53,19,46,5,6,2,21,23,23,1,0,11,20,94,SG
2017,24,68,2234,408,930,128,360,280,570,223,277,44,165,209,202,66,4,141,180,1167,SG
2017,33,69,1284,118,325,67,203,51,122,54,63,9,146,155,135,35,9,80,99,357,SG
2017,26,65,1525,163,404,40,128,123,276,98,129,34,139,173,335,56,6,101,133,464,PG
2017,33,74,1398,238,520,137,335,101,185,63,74,37,253,290,45,33,37,53,138,676,C
2017,28,63,2134,335,750,126,324,209,426,349,387,39,287,326,135,40,15,81,93,1145,SF
2017,25,74,1495,207,545,120,308,87,237,51,64,27,129,156,93,46,6,46,96,585,PG
2017,25,55,1120,165,441,101,268,64,173,40,52,20,101,121,65,40,5,28,76,471,PG
2017,25,19,375,42,104,19,40,23,64,11,12,7,28,35,28,6,1,18,20,114,PG
2017,23,5,43,0,7,0,5,0,2,0,0,1,6,7,0,0,0,3,4,0,SG
2017,32,74,2531,532,1160,104,268,428,892,278,332,60,402,462,338,67,99,166,171,1446,C
2017,36,64,1627,303,604,56,104,247,500,130,184,107,394,501,150,24,70,81,110,792,C
2017,30,30,1013,201,442,42,113,159,329,118,138,35,155,190,82,44,26,74,79,562,SF
2017,24,9,32,1,10,0,4,1,6,2,2,2,1,3,2,0,0,0,2,4,SG
2017,29,13,89,3,14,0,3,3,11,5,9,4,11,15,6,5,1,4,14,11,SF
2017,26,75,2689,622,1349,195,496,427,853,336,374,58,434,492,251,117,27,218,206,1775,SF
2017,22,5,48,2,7,1,2,1,5,9,10,1,8,9,3,1,0,2,5,14,SG
2017,29,17,231,35,95,15,45,20,50,21,29,1,21,22,26,8,0,21,21,106,PG
2017,31,78,1989,365,709,3,13,362,696,113,158,158,328,486,73,42,66,105,163,846,PF
2017,31,55,1502,276,530,2,12,274,518,85,119,120,263,383,60,28,51,77,123,639,PF
2017,31,23,487,89,179,1,1,88,178,28,39,38,65,103,13,14,15,28,40,207,PF
2017,39,69,1291,171,439,89,227,82,212,86,107,28,129,157,183,82,16,96,119,517,SG
2017,24,81,2744,413,624,0,1,413,623,311,476,314,721,1035,97,49,214,148,246,1137,C
2017,22,15,214,36,66,5,15,31,51,33,42,7,21,28,24,4,5,14,8,110,SG
2017,22,3,30,2,5,1,2,1,3,10,10,0,0,0,1,0,1,0,1,15,SG
2017,22,12,184,34,61,4,13,30,48,23,32,7,21,28,23,4,4,14,7,95,SG
2017,21,80,2298,393,865,77,267,316,598,156,217,116,289,405,150,64,40,89,172,1019,SF
2017,28,75,2323,412,1016,246,661,166,355,147,175,29,172,201,188,48,40,121,150,1217,SG
2017,32,82,2556,390,674,0,2,390,672,103,159,238,611,849,121,40,65,118,213,883,C
2017,23,27,189,19,40,9,15,10,25,10,15,5,17,22,6,6,1,3,18,57,SG
2017,22,80,1531,152,328,43,116,109,212,90,147,38,168,206,46,33,79,44,149,437,SF
2017,22,2,41,6,17,0,2,6,15,4,8,0,7,7,0,0,4,3,5,16,SF
2017,22,78,1490,146,311,43,114,103,197,86,139,38,161,199,46,33,75,41,144,421,SF
2017,24,63,1028,128,301,49,134,79,167,65,73,17,94,111,120,47,8,44,93,370,PG
2017,29,68,1807,176,449,118,311,58,138,27,32,31,193,224,124,71,58,76,120,497,SG
2017,26,76,2471,272,650,81,263,191,387,151,213,98,501,599,533,154,106,184,217,776,PF
2017,31,47,538,95,232,39,111,56,121,33,41,17,68,85,33,9,7,25,48,262,SF
2017,26,77,2101,250,500,55,145,195,355,134,167,167,377,544,84,46,34,94,248,689,PF
2017,30,69,1534,220,558,53,193,167,365,145,168,39,175,214,81,37,13,75,103,638,PF
2017,27,61,2076,479,971,38,113,441,858,320,421,111,385,496,300,58,23,142,157,1316,PF
2017,26,64,1177,174,379,55,181,119,198,39,52,71,191,262,55,29,43,43,91,442,C
2017,24,22,163,17,42,5,10,12,32,9,20,8,28,36,4,1,13,10,21,48,C
2017,24,79,2154,415,912,149,417,266,495,164,214,35,189,224,182,55,15,106,103,1143,SG
2017,27,81,2947,674,1533,262,756,412,777,746,881,95,564,659,906,120,37,464,215,2356,PG
2017,23,77,2223,314,624,68,194,246,430,77,124,125,216,341,89,85,70,85,214,773,SF
2017,27,3,31,5,12,2,7,3,5,0,0,2,3,5,2,0,0,4,2,12,PF
2017,23,58,1064,225,345,1,7,224,338,76,121,81,138,219,64,20,42,44,126,527,C
2017,33,65,1087,136,341,58,177,78,164,107,129,11,116,127,136,43,7,57,101,437,PG
2017,22,57,1782,320,637,107,255,213,382,104,134,48,130,178,164,71,8,76,92,851,SG
2017,25,52,1138,154,362,85,221,69,141,35,49,16,131,147,54,30,8,55,121,428,SG
2017,27,4,25,3,15,0,2,3,13,2,4,3,6,9,2,0,0,2,1,8,SG
2017,24,82,2567,511,1063,109,314,402,749,190,226,63,353,416,142,60,39,95,133,1321,PF
2017,22,5,17,0,4,0,2,0,2,1,2,0,3,3,3,0,0,0,2,1,SG
2017,22,72,1474,117,360,43,156,74,204,148,194,23,113,136,198,54,20,85,194,425,PG
2017,36,17,130,11,23,0,3,11,20,9,15,8,28,36,6,5,1,8,22,31,C
2017,28,54,797,134,277,25,81,109,196,44,52,38,153,191,81,15,30,49,77,337,PF
2017,28,35,626,104,218,16,55,88,163,30,34,32,114,146,62,13,26,40,61,254,PF
2017,28,19,171,30,59,9,26,21,33,14,18,6,39,45,19,2,4,9,16,83,PF
2017,26,73,2516,545,1156,149,374,396,782,362,429,49,344,393,252,73,20,140,117,1601,SF
2017,29,72,1667,234,553,61,173,173,380,133,165,34,151,185,112,41,15,62,129,662,SG
2017,26,58,1123,159,309,0,1,159,308,74,107,92,203,295,57,29,78,53,151,392,C
2017,21,62,842,101,224,46,113,55,111,57,76,43,144,187,29,29,12,31,62,305,PF
2017,22,72,1324,246,465,4,15,242,450,91,125,170,332,502,96,41,36,100,150,587,C
2017,21,65,960,117,330,43,144,74,186,40,50,20,126,146,62,30,14,58,74,317,SF
2017,30,48,682,80,147,0,0,80,147,61,75,54,100,154,21,8,46,32,100,221,C
2017,30,42,671,78,144,0,0,78,144,61,75,53,99,152,20,8,44,31,97,217,C
2017,30,6,11,2,3,0,0,2,3,0,0,1,1,2,1,0,2,1,3,4,C
2017,23,82,1888,327,768,148,379,179,389,64,76,35,234,269,121,38,9,101,115,866,SG
2017,23,57,1161,185,472,89,241,96,231,29,33,19,147,166,77,18,7,48,81,488,SG
2017,23,25,727,142,296,59,138,83,158,35,43,16,87,103,44,20,2,53,34,378,SG
2017,34,67,1198,245,397,3,9,242,388,116,197,95,186,281,65,56,40,73,163,609,C
2017,30,49,1544,289,606,94,233,195,373,157,196,23,144,167,203,50,11,85,114,829,PG
2017,29,7,47,5,13,0,0,5,13,2,2,8,6,14,0,1,0,4,9,12,C
2017,25,80,2374,183,477,94,270,89,207,103,128,51,256,307,141,71,32,82,182,563,SF
2017,23,39,381,47,126,12,46,35,80,21,28,2,31,33,33,11,2,28,39,127,SG
2017,26,67,2190,405,894,100,281,305,613,119,168,46,218,264,488,100,43,194,133,1029,PG
2017,27,82,1639,233,538,97,273,136,265,66,80,27,198,225,102,65,31,66,109,629,SG
2017,22,78,1761,235,542,15,67,220,475,190,253,96,356,452,154,82,44,116,177,675,SF
2017,23,57,1193,230,412,27,77,203,335,72,103,94,217,311,58,42,55,55,136,559,C
2017,24,59,1593,272,666,114,307,158,359,90,115,16,186,202,96,38,11,65,132,748,SG
2017,30,68,2193,379,801,86,242,293,559,108,135,95,369,464,337,52,87,116,138,952,C
2017,31,74,2199,388,613,0,2,388,611,226,424,296,644,940,104,64,92,170,203,1002,C
2017,33,23,237,25,68,4,19,21,49,9,17,2,22,24,52,10,2,19,16,63,PG
2017,25,2,31,6,11,2,4,4,7,0,1,4,5,9,3,0,3,0,0,14,PF
2017,31,56,689,87,214,19,54,68,160,64,82,60,146,206,29,15,21,28,69,257,PF
2017,27,79,2422,471,982,124,317,347,665,107,125,129,409,538,75,41,124,105,215,1173,PF
2017,27,56,1710,343,703,83,214,260,489,77,91,100,282,382,60,34,91,66,139,846,PF
2017,27,23,712,128,279,41,103,87,176,30,34,29,127,156,15,7,33,39,76,327,PF
2017,33,76,1998,219,415,64,177,155,238,72,102,51,253,304,262,76,39,58,97,574,SF
2017,29,82,2142,384,890,142,402,242,488,161,207,115,366,481,141,58,23,116,211,1071,PF
2017,29,3,62,6,16,3,12,3,4,0,0,2,14,16,1,3,1,4,5,15,PF
2017,29,53,1447,285,648,107,298,178,350,109,142,71,243,314,97,33,14,78,133,786,PF
2017,29,26,633,93,226,32,92,61,134,52,65,42,109,151,43,22,8,34,73,270,PF
2017,29,82,1972,204,451,123,279,81,172,50,68,23,237,260,224,96,8,107,163,581,SF
2017,19,79,2279,276,686,55,187,221,499,133,214,60,257,317,166,50,36,116,158,740,SF
2017,24,72,2525,671,1420,177,441,494,979,297,328,52,178,230,418,83,25,180,157,1816,PG
2017,33,2,33,2,3,0,1,2,2,2,2,0,0,0,5,2,0,3,4,6,PG
2017,22,5,17,3,4,1,1,2,3,3,6,2,2,4,3,0,0,0,0,10,PG
2017,25,8,84,13,39,3,11,10,28,6,7,1,8,9,19,2,0,3,5,35,PG
2017,26,52,1424,284,677,66,184,218,493,118,136,21,92,113,270,35,5,114,129,752,PG
2017,32,74,2794,736,1344,124,342,612,1002,358,531,97,543,640,646,92,44,303,134,1954,SF
2017,32,66,931,235,471,0,1,235,470,65,85,75,203,278,57,19,16,33,125,535,C
2017,36,79,1614,153,343,62,186,91,157,80,108,28,174,202,78,26,10,52,153,448,SF
2017,25,4,13,2,5,1,2,1,3,2,2,0,1,1,1,0,0,0,0,7,SG
2017,27,81,1802,192,535,79,252,113,283,114,152,29,167,196,395,70,5,128,116,577,PG
2017,27,58,1428,163,429,68,200,95,229,102,135,21,131,152,287,55,5,106,84,496,PG
2017,27,23,374,29,106,11,52,18,54,12,17,8,36,44,108,15,0,22,32,81,PG
2017,29,78,1232,114,262,45,130,69,132,26,37,60,213,273,71,26,17,39,122,299,PF
2017,29,80,1608,213,370,27,66,186,304,67,100,117,248,365,140,52,62,77,211,520,PF
2017,22,3,9,2,7,0,0,2,7,0,0,1,2,3,1,2,1,1,0,4,PF
2017,29,76,2085,368,769,87,256,281,513,152,215,66,309,375,276,76,86,171,197,975,PF
2017,35,78,1843,273,626,106,258,167,368,63,77,33,209,242,144,36,18,69,93,715,SF
2017,20,77,1371,129,365,45,154,84,211,36,53,36,153,189,105,56,24,71,121,339,SF
2017,24,73,2178,357,824,93,250,264,574,195,254,50,243,293,233,84,44,90,176,1002,PG
2017,29,68,810,73,200,29,118,44,82,11,17,26,155,181,23,29,30,18,83,186,SF
2017,21,73,2038,494,854,45,139,449,715,188,228,212,506,718,359,61,56,171,214,1221,C
2017,36,1,12,3,8,0,2,3,6,3,4,1,1,2,1,0,0,1,1,9,SF
2017,21,10,85,8,16,0,0,8,16,3,10,9,14,23,0,1,4,6,15,19,C
2017,19,32,545,68,121,3,11,65,110,29,41,39,40,79,12,14,13,13,63,168,SF
2017,36,48,381,44,92,31,66,13,26,13,20,3,35,38,14,7,10,10,37,132,SF
2017,25,54,1270,231,491,19,75,212,416,103,170,65,241,306,58,40,54,48,67,584,PF
2017,25,51,1264,231,488,19,75,212,413,103,170,65,238,303,58,39,53,48,67,584,PF
2017,25,3,6,0,3,0,0,0,3,0,0,0,3,3,0,1,1,0,0,0,PF
2017,20,60,774,75,181,26,73,49,108,33,43,10,57,67,156,47,5,38,50,209,PG
2017,28,81,2570,412,577,0,2,412,575,205,425,297,817,1114,96,52,135,116,212,1029,C
2017,25,80,2003,299,661,48,135,251,526,94,122,51,184,235,265,66,13,108,140,740,SG
2017,23,75,1954,320,802,116,354,204,448,118,156,57,279,336,162,47,34,76,139,874,C
2017,24,72,1533,402,737,5,38,397,699,224,285,195,287,482,67,32,38,123,154,1033,C
2017,25,16,110,8,28,4,10,4,18,5,6,1,17,18,8,4,5,4,5,25,PF
2017,23,81,2349,295,618,1,9,294,609,152,194,156,409,565,114,81,77,56,187,743,SF
2017,27,70,1754,305,735,105,308,200,427,204,242,22,258,280,157,46,6,136,118,919,SG
2017,25,54,1140,209,525,45,139,164,386,132,154,25,93,118,130,27,5,89,87,595,SG
2017,35,67,1753,239,515,162,359,77,156,38,42,8,179,187,110,34,21,69,107,678,SG
2017,35,32,894,108,246,65,159,43,87,24,27,1,89,90,75,23,13,40,47,305,SG
2017,35,35,859,131,269,97,200,34,69,14,15,7,90,97,35,11,8,29,60,373,SG
2017,27,71,1419,216,392,0,1,216,391,38,62,118,285,403,47,36,48,61,172,470,C
2017,27,68,1016,158,369,54,168,104,201,55,68,47,79,126,69,29,11,51,79,425,SF
2017,20,33,612,117,218,3,8,114,210,52,74,51,111,162,27,16,13,37,64,289,PF
2017,24,62,1143,226,491,41,146,185,345,110,129,30,234,264,75,27,23,40,98,603,SG
2017,27,18,174,20,47,10,27,10,20,9,9,1,9,10,28,4,1,19,19,59,PG
2017,25,50,739,111,244,27,78,84,166,37,58,51,132,183,51,18,6,40,71,286,PF
2017,25,20,241,37,92,6,20,31,72,9,15,21,47,68,19,7,0,16,12,89,C
2017,21,47,1749,326,710,120,310,206,400,117,140,18,141,159,139,41,10,85,104,889,SG
2017,29,69,1732,237,522,34,118,203,404,173,217,44,135,179,335,74,6,129,119,681,PG
2017,22,35,249,26,89,13,51,13,38,13,17,6,18,24,11,9,3,11,22,78,SF
2017,31,77,2459,321,704,108,269,213,435,85,98,53,207,260,179,81,23,69,141,835,SG
2017,33,79,1477,248,420,0,0,248,420,80,113,148,292,440,124,31,40,82,125,576,PF
2017,23,77,1560,230,463,3,12,227,451,150,208,156,354,510,44,37,98,102,242,613,C
2017,25,74,2474,636,1311,147,386,489,925,469,533,80,350,430,260,132,55,154,122,1888,SF
2017,24,74,1222,146,378,74,213,72,165,35,40,27,209,236,71,13,28,35,172,401,PF
2017,27,75,1944,310,646,49,167,261,479,98,113,102,300,402,111,31,26,66,145,767,PF
2017,22,57,1237,171,380,59,184,112,196,67,93,23,165,188,110,49,8,59,91,468,SF
2017,28,62,777,55,142,17,46,38,96,25,40,20,88,108,54,47,14,42,81,152,SG
2017,28,61,752,52,136,17,45,35,91,23,37,17,84,101,54,45,14,42,78,144,SG
2017,28,1,25,3,6,0,1,3,5,2,3,3,4,7,0,2,0,0,3,8,SG
2017,26,75,2694,661,1488,214,578,447,910,488,545,46,322,368,439,68,20,197,152,2024,PG
2017,28,36,883,175,400,58,156,117,244,115,141,11,124,135,184,41,14,86,79,523,PG
2017,31,76,1345,173,316,1,3,172,313,42,60,28,123,151,139,38,20,61,120,389,PG
2017,24,18,234,61,109,7,19,54,90,19,35,41,44,85,13,9,9,13,49,148,C
2017,20,53,447,56,107,2,9,54,98,21,34,44,80,124,29,14,17,17,64,135,C
2017,28,75,2222,555,1172,134,387,421,785,295,364,121,282,403,176,38,124,184,192,1539,C
2017,28,81,2271,382,775,0,2,382,773,75,104,243,276,519,80,18,117,90,151,839,C
2017,28,60,1885,370,867,145,389,225,478,257,295,148,518,666,116,53,22,122,125,1142,PF
2017,30,60,2244,426,918,193,468,233,450,299,365,48,240,288,417,88,19,173,170,1344,PG
2017,34,5,11,1,4,0,1,1,3,0,0,0,0,0,1,2,0,0,0,2,PG
2017,21,69,1190,145,361,50,161,95,200,105,123,25,124,149,75,32,10,73,154,445,SF
2017,21,71,1158,159,439,65,204,94,235,57,79,48,187,235,70,26,20,64,97,440,PF
2017,26,55,1205,170,381,37,120,133,261,53,77,20,108,128,154,42,3,90,100,430,PG
2017,30,31,555,65,111,0,0,65,111,43,75,47,103,150,19,33,24,34,90,173,C
2017,19,57,562,83,181,28,74,55,107,32,49,40,74,114,23,10,26,17,84,226,C
2017,28,35,293,72,132,0,0,72,132,47,58,46,84,130,9,6,12,10,25,191,C
2017,22,42,558,58,151,9,25,49,126,40,50,42,120,162,8,17,9,28,91,165,PF
2017,30,73,2495,333,847,174,479,159,368,146,179,18,241,259,210,77,16,102,161,986,SG
2017,30,80,1787,191,378,43,110,148,268,59,87,47,127,174,39,81,35,47,122,484,SF
2017,24,52,457,62,117,2,8,60,109,21,42,34,56,90,17,18,29,19,47,147,PF
2017,21,71,1074,106,245,41,123,65,122,29,37,22,79,101,77,32,15,36,62,282,SG
2017,24,30,287,30,75,7,30,23,45,23,27,4,30,34,15,8,2,5,17,90,SG
2017,25,80,2796,692,1441,185,440,507,1001,268,294,60,231,291,285,72,42,172,202,1837,SG
2017,24,81,2133,236,512,11,55,225,457,73,90,39,212,251,534,134,10,159,139,556,PG
2017,21,16,80,16,32,1,7,15,25,3,5,9,10,19,2,2,2,3,7,36,PF
2017,21,14,72,16,31,1,6,15,25,2,3,9,8,17,2,1,2,2,7,35,PF
2017,23,49,505,77,169,20,66,57,103,32,38,15,67,82,13,19,18,29,49,206,SF
2017,23,29,212,31,68,9,27,22,41,9,10,6,24,30,4,7,8,10,24,80,SF
2017,23,20,293,46,101,11,39,35,62,23,28,9,43,52,9,12,10,19,25,126,SF
2017,25,66,1508,222,497,77,207,145,290,71,84,20,159,179,58,13,5,38,79,592,SF
2017,25,44,1078,166,373,56,149,110,224,59,67,14,116,130,45,11,4,32,57,447,SF
2017,25,22,430,56,124,21,58,35,66,12,17,6,43,49,13,2,1,6,22,145,SF
2017,29,77,739,208,319,0,4,208,315,56,111,100,144,244,17,19,67,40,109,472,C
2017,25,78,1966,190,460,73,220,117,240,44,71,95,162,257,124,45,18,56,140,497,SG
2017,23,61,1176,180,419,65,170,115,249,70,93,19,111,130,51,29,6,62,108,495,SG
2017,25,37,384,58,150,18,51,40,99,27,34,6,34,40,19,8,6,14,31,161,SG
2017,29,22,381,44,118,13,31,31,87,6,9,23,51,74,50,10,4,23,31,107,PF
2017,29,36,738,103,256,56,137,47,119,65,74,5,72,77,45,34,4,36,41,327,SG
2017,30,73,905,88,137,1,3,87,134,36,61,97,211,308,14,32,61,40,152,213,C
2017,22,25,141,15,34,0,1,15,33,8,14,13,21,34,7,3,6,9,12,38,PF
2017,25,29,889,150,333,45,104,105,229,81,92,11,112,123,99,41,7,65,79,426,SF
2017,29,76,1776,281,647,169,409,112,238,84,93,30,199,229,48,46,25,40,151,815,SF
2017,36,20,151,9,23,8,20,1,3,2,2,3,36,39,22,2,0,13,9,28,SF
2017,28,80,1754,273,622,147,356,126,266,66,80,24,118,142,280,65,3,101,109,759,PG
2017,29,2,23,1,7,0,2,1,5,1,2,3,3,6,1,0,0,2,2,3,SG
2017,31,69,2343,430,972,75,241,355,731,311,405,111,422,533,252,90,62,158,186,1246,PF
2017,25,70,1679,258,625,129,377,129,248,99,128,61,323,384,75,53,56,79,128,744,PF
2017,26,81,1823,387,726,0,4,387,722,177,239,167,365,532,187,92,38,140,168,951,C
2017,27,73,1820,283,619,77,208,206,411,57,74,33,119,152,164,50,32,62,131,700,SG
2017,27,79,2565,421,1007,118,357,303,650,145,185,77,289,366,160,52,25,87,168,1105,SF
2017,27,76,2374,406,889,71,196,335,693,180,215,107,385,492,126,82,42,129,254,1063,PF
2017,31,49,714,98,252,41,133,57,119,34,37,12,19,31,25,24,2,6,44,271,SG
2017,31,40,627,86,223,35,119,51,104,23,26,11,18,29,19,22,2,6,40,230,SG
2017,31,9,87,12,29,6,14,6,15,11,11,1,1,2,6,2,0,0,4,41,SG
2017,26,34,479,57,138,11,47,46,91,25,49,26,75,101,34,18,11,31,55,150,PF
2017,30,54,1104,169,328,0,1,169,327,63,78,104,160,264,43,16,31,72,133,401,C
2017,20,55,1406,208,551,56,178,152,373,131,167,29,149,178,217,41,13,123,95,603,PG
2017,24,78,1516,288,598,49,146,239,452,147,190,84,136,220,35,22,6,56,86,772,SF
2017,20,38,322,50,116,9,23,41,93,21,30,6,36,42,48,8,6,38,29,130,PG
2017,19,82,1764,295,730,115,344,180,386,106,120,41,173,214,170,52,24,113,124,811,SG
2017,25,70,1237,170,337,46,110,124,227,49,64,76,164,240,95,30,41,55,97,435,C
2017,24,63,1442,190,361,10,36,180,325,59,80,120,249,369,96,82,40,56,149,449,PF
2017,25,53,512,73,183,34,92,39,91,38,49,8,53,61,67,32,2,41,38,218,PG
2017,24,32,331,39,86,1,7,38,79,19,26,22,42,64,8,15,8,12,30,98,PF
2017,32,2,18,0,7,0,2,0,5,4,4,0,1,1,1,0,0,0,1,4,SG
2017,34,75,2045,268,604,106,273,162,331,45,63,28,164,192,385,53,8,129,197,687,PG
2017,24,40,346,41,91,10,31,31,60,8,9,4,26,30,34,21,5,15,48,100,PG
2017,23,23,93,9,36,1,12,8,24,2,2,2,15,17,5,3,0,5,6,21,PF
2017,27,38,342,43,111,5,27,38,84,9,14,15,46,61,10,16,6,17,55,100,PF
2017,27,28,231,30,77,3,16,27,61,7,12,11,23,34,7,11,6,11,37,70,PF
2017,27,10,111,13,34,2,11,11,23,2,2,4,23,27,3,5,0,6,18,30,PF
2017,31,46,1015,99,201,0,1,99,200,34,78,161,241,402,103,30,37,58,127,232,C
2017,22,51,1047,184,309,0,1,184,308,77,111,93,201,294,50,65,51,51,126,445,C
2017,22,29,564,107,175,0,1,107,174,43,63,46,98,144,30,43,26,29,71,257,C
2017,22,22,483,77,134,0,0,77,134,34,48,47,103,150,20,22,25,22,55,188,C
2017,24,57,1088,103,156,3,12,100,144,44,67,82,161,243,42,52,90,46,137,253,C
2017,33,8,22,2,7,1,6,1,1,0,0,0,3,3,0,0,0,0,1,5,PF
2017,38,54,1424,296,678,79,209,217,469,98,112,23,330,353,82,30,38,51,113,769,PF
2017,22,65,1391,271,534,0,1,271,533,120,210,154,313,467,123,50,74,143,161,662,C
2017,22,45,807,151,298,0,0,151,298,56,113,89,171,260,60,25,36,81,88,358,C
2017,22,20,584,120,236,0,1,120,235,64,97,65,142,207,63,25,38,62,73,304,C
2017,24,20,397,47,81,1,5,46,76,25,39,16,46,62,14,13,7,11,36,120,SG
2017,23,11,80,15,30,3,6,12,24,5,6,9,10,19,6,0,1,6,10,38,PF
2017,23,7,46,7,15,2,3,5,12,4,4,5,6,11,2,0,1,3,4,20,PF
2017,23,4,34,8,15,1,3,7,12,1,2,4,4,8,4,0,0,3,6,18,PF
2017,26,79,1229,215,413,2,17,213,396,64,83,157,282,439,117,36,104,76,174,496,C
2017,23,19,75,12,27,0,0,12,27,0,2,5,17,22,3,2,0,3,17,24,C
2017,21,50,1134,242,471,0,0,242,471,106,158,81,159,240,58,20,49,91,122,590,C
2017,24,67,2222,412,932,127,352,285,580,116,154,39,252,291,176,78,21,119,155,1067,SG
2017,25,75,1538,260,508,68,192,192,316,90,123,72,288,360,148,43,29,96,207,678,C
2017,29,8,28,2,4,0,0,2,4,0,0,2,4,6,2,0,1,2,3,4,C
2017,20,5,52,5,7,0,0,5,7,4,4,2,8,10,3,3,1,4,6,14,C
2017,21,79,1605,186,442,54,188,132,254,75,99,61,199,260,47,58,17,49,195,501,SF
2017,32,70,1268,164,307,0,2,164,305,98,126,140,270,410,132,59,33,88,166,426,C
2017,19,22,355,56,102,0,2,56,100,12,14,24,62,86,20,3,17,24,44,124,C
2017,21,51,1728,399,814,65,178,334,636,162,218,79,235,314,142,51,22,92,111,1025,PF
2017,34,63,1587,265,569,23,69,242,500,85,117,9,104,113,285,33,2,89,92,638,PG
2017,28,34,675,75,222,25,93,50,129,35,43,6,78,84,55,20,5,24,52,210,SF
2017,25,5,40,3,15,1,6,2,9,2,3,1,6,7,6,1,0,4,6,9,SG
2017,27,65,1599,154,384,94,253,60,131,43,60,62,229,291,76,40,23,38,120,445,PF
2017,31,61,1921,374,785,124,302,250,483,232,260,41,263,304,563,118,8,147,146,1104,PG
2017,25,18,135,23,54,3,15,20,39,14,19,9,24,33,7,8,7,8,32,63,PF
2017,22,31,462,64,193,27,86,37,107,5,8,3,45,48,55,14,5,29,52,160,PG
2017,22,20,320,43,130,16,52,27,78,4,4,2,29,31,40,10,5,16,38,106,PG
2017,22,11,142,21,63,11,34,10,29,1,4,1,16,17,15,4,0,13,14,54,PG
2017,22,82,2412,430,912,40,146,390,766,146,211,89,298,387,529,88,40,178,177,1046,PG
2017,24,6,99,8,22,1,9,7,13,3,5,0,12,12,13,3,4,10,9,20,PG
2017,39,25,277,28,70,15,43,13,27,10,13,1,47,48,10,4,5,16,40,81,SF
2017,24,21,170,16,30,0,0,16,30,8,19,23,28,51,10,4,4,12,23,40,C
2017,26,81,2148,334,623,0,6,334,617,174,300,170,436,606,284,69,92,135,226,842,C
2017,26,54,1516,235,442,0,5,235,437,127,224,120,313,433,214,50,63,89,149,597,C
2017,26,27,632,99,181,0,1,99,180,47,76,50,123,173,70,19,29,46,77,245,C
2017,28,45,484,44,92,0,0,44,92,25,39,38,57,95,21,18,13,30,73,113,C
2017,28,32,310,30,68,0,0,30,68,22,35,23,30,53,18,11,9,22,48,82,C
2017,28,13,174,14,24,0,0,14,24,3,4,15,27,42,3,7,4,8,25,31,C
2017,21,54,626,67,115,0,0,67,115,31,57,78,87,165,12,17,20,29,113,165,C
2017,23,80,2605,414,803,148,341,266,462,99,119,118,397,515,121,116,41,43,193,1075,SF
2017,21,64,1000,183,375,32,96,151,279,39,59,75,221,296,35,16,11,37,94,437,PF
2017,21,66,2164,443,985,112,314,331,671,198,252,111,364,475,97,47,130,118,244,1196,PF
2017,25,77,1333,194,377,21,74,173,303,107,141,93,213,306,49,61,39,34,135,516,C
2017,23,76,1368,227,506,56,173,171,333,126,159,26,142,168,82,51,14,70,127,636,SG
2017,23,6,157,25,54,6,19,19,35,8,10,11,18,29,5,3,2,3,14,64,PF
2017,33,14,134,4,24,3,17,1,7,3,4,3,8,11,18,11,1,3,14,14,PG
2017,22,16,80,13,29,5,13,8,16,0,3,4,10,14,11,2,3,11,6,31,SG
2017,23,26,299,40,98,16,47,24,51,41,43,6,26,32,34,9,2,19,39,137,PG
2017,23,8,74,12,26,6,15,6,11,12,12,0,5,5,6,3,1,3,11,42,PG
2017,23,18,225,28,72,10,32,18,40,29,31,6,21,27,28,6,1,16,28,95,PG
2017,22,74,2132,377,773,17,63,360,710,204,282,151,485,636,264,49,37,173,248,975,PF
2017,35,73,1786,433,964,21,94,412,870,141,193,182,416,598,122,38,10,99,136,1028,PF
2017,32,78,2198,396,890,201,468,195,422,180,202,11,160,171,110,55,13,98,125,1173,SG
2017,26,71,1031,162,285,1,4,161,281,49,88,129,203,332,26,18,47,31,137,374,C
2017,23,53,1614,202,513,75,227,127,286,60,77,35,133,168,140,60,39,65,132,539,SG
2017,21,22,198,28,68,8,28,20,40,15,19,3,20,23,11,5,1,8,23,79,SG
2017,24,74,2054,323,731,111,299,212,432,132,191,20,141,161,204,48,10,115,187,889,SG
2017,25,79,2376,215,463,45,184,170,279,47,111,98,304,402,79,94,79,51,204,522,SF
2017,31,41,416,46,122,17,44,29,78,33,39,5,34,39,52,9,1,26,18,142,PG
2017,23,69,1426,158,338,49,125,109,213,54,76,57,188,245,47,41,20,37,63,419,SF
2017,25,48,560,105,196,0,1,105,195,31,66,84,139,223,31,26,9,46,76,241,PF
2017,30,68,1518,210,536,92,252,118,284,18,27,21,136,157,344,48,4,128,95,530,PG
2017,30,69,1843,229,561,50,133,179,428,30,50,73,282,355,461,99,11,168,144,538,PG
2017,28,64,2082,460,977,13,60,447,917,221,253,66,180,246,283,44,17,147,84,1154,PG
2017,25,78,1955,326,746,142,391,184,355,64,77,18,189,207,88,88,33,68,143,858,SF
2017,25,54,1207,211,479,96,256,115,223,41,50,14,125,139,45,54,20,33,82,559,SF
2017,25,24,748,115,267,46,135,69,132,23,27,4,64,68,43,34,13,35,61,299,SF
2017,22,74,1263,151,411,57,179,94,232,51,66,40,187,227,131,45,11,47,69,410,PG
2017,26,75,2469,261,650,60,196,201,454,254,285,68,237,305,682,128,10,195,202,836,PG
2017,30,45,314,31,88,20,64,11,24,0,0,5,20,25,20,12,1,9,31,82,SF
2017,31,47,1030,70,187,44,114,26,73,13,18,16,83,99,45,22,23,28,42,197,SG
2017,20,63,1811,351,867,135,384,216,483,147,188,31,191,222,303,87,16,176,130,984,PG
2017,20,81,1632,192,481,51,159,141,322,44,67,45,242,287,82,39,32,83,200,479,PF
2017,28,5,13,1,4,0,0,1,4,2,2,3,1,4,0,1,1,2,5,4,C
2017,22,81,2129,381,927,106,341,275,586,172,220,112,401,513,182,57,30,183,162,1040,PF
2017,25,57,719,61,146,9,37,52,109,23,33,25,58,83,92,26,6,38,60,154,SG
2017,23,79,2485,548,1215,100,294,448,921,218,255,42,206,248,499,74,16,258,149,1414,PG
2017,36,36,461,71,151,17,50,54,101,25,37,51,88,139,37,14,4,34,63,184,PF
2017,28,18,195,17,59,4,27,13,32,7,8,10,27,37,17,4,3,8,12,45,PF
2017,32,62,1596,174,395,41,120,133,275,55,75,54,216,270,107,96,31,58,97,444,SF
2017,22,14,236,25,58,7,28,18,30,14,22,1,15,16,13,6,1,12,18,71,SG
2017,22,3,47,5,8,4,7,1,1,2,4,0,5,5,1,2,0,3,6,16,SG
2017,22,11,189,20,50,3,21,17,29,12,18,1,10,11,12,4,1,9,12,55,SG
2017,27,49,559,109,198,0,2,109,196,14,22,41,101,142,23,7,20,29,66,232,PF
2017,30,50,811,100,263,21,62,79,201,91,118,11,62,73,129,26,3,46,43,312,PG
2017,26,76,1937,201,489,94,261,107,228,71,90,39,180,219,109,62,27,78,150,567,SG
2017,22,55,859,103,205,1,7,102,198,22,32,64,121,185,17,26,45,33,109,229,PF
2017,27,78,1392,177,421,30,102,147,319,99,132,20,140,160,126,47,25,76,146,483,SG
2017,28,32,385,34,83,7,37,27,46,13,17,8,40,48,9,7,5,11,29,88,SF
2017,22,79,2399,269,749,94,332,175,417,203,250,78,228,306,364,125,34,159,192,835,SG
2017,28,81,1955,329,749,28,105,301,644,72,102,21,214,235,418,61,33,112,127,758,PG
2017,31,41,1187,123,356,95,271,28,85,10,15,17,96,113,62,40,11,26,77,351,SG
2017,30,74,1068,174,329,37,78,137,251,35,51,64,194,258,37,21,55,58,168,420,C
2017,25,80,2336,246,541,144,355,102,186,47,58,22,226,248,96,54,14,55,125,683,SG
2017,29,82,1286,244,548,103,277,141,271,120,137,88,285,373,66,23,41,69,229,711,C
2017,32,8,76,14,31,2,6,12,25,9,11,8,14,22,4,1,1,6,8,39,C
2017,23,80,2188,251,634,132,359,119,275,122,150,21,205,226,188,45,32,128,144,756,SG
2017,26,18,361,54,120,6,20,48,100,8,13,4,48,52,59,5,3,26,32,122,SG
2017,26,6,162,26,55,1,10,25,45,5,8,3,15,18,29,2,1,11,18,58,SG
2017,26,6,67,10,21,0,2,10,19,1,2,0,10,10,5,0,0,4,2,21,SG
2017,26,6,132,18,44,5,8,13,36,2,3,1,23,24,25,3,2,11,12,43,SG
2017,23,2,7,1,1,0,0,1,1,1,2,1,1,2,2,1,0,0,3,3,C
2017,19,7,24,3,13,0,0,3,13,4,4,1,5,6,0,0,1,2,5,10,C
2017,30,39,696,91,244,19,60,72,184,80,107,6,78,84,84,16,0,53,44,281,PG
2017,24,11,118,15,48,3,18,12,30,4,8,10,17,27,3,4,1,4,17,37,PF
2017,24,2,28,4,5,0,0,4,5,0,3,4,7,11,1,0,6,2,3,8,C
2017,24,1,4,1,1,0,0,1,1,0,2,0,1,1,0,0,0,0,0,2,C
2017,24,1,24,3,4,0,0,3,4,0,1,4,6,10,1,0,6,2,3,6,C
2017,22,4,52,1,7,0,2,1,5,1,2,1,2,3,3,1,1,0,6,3,PG
2017,28,82,2657,402,909,90,252,312,657,360,415,33,298,331,639,100,32,216,165,1254,PG
2017,31,70,1133,156,418,104,305,52,113,35,45,11,151,162,48,12,13,37,109,451,PF
2017,30,65,1728,183,432,82,220,101,212,58,74,32,151,183,169,84,28,78,141,506,SG
2017,39,74,1365,105,243,73,171,32,72,24,29,15,91,106,98,45,20,36,95,307,SG
2017,27,76,2569,682,1473,245,646,437,827,590,649,43,162,205,449,70,13,210,167,2199,PG
2017,28,46,968,97,244,38,85,59,159,43,51,32,110,142,35,21,5,25,85,275,PF
2017,25,40,752,77,200,32,95,45,105,19,29,19,92,111,35,20,6,11,69,205,SG
2017,25,31,561,66,159,26,71,40,88,13,20,15,68,83,26,14,6,9,55,171,SG
2017,25,9,191,11,41,6,24,5,17,6,9,4,24,28,9,6,0,2,14,34,SG
2017,26,78,2649,644,1376,268,647,376,729,186,218,49,236,285,160,66,40,128,139,1742,SG
2017,25,78,2336,262,437,0,3,262,434,106,213,287,429,716,77,39,84,64,176,630,C
2017,29,33,575,84,210,28,80,56,130,23,27,22,54,76,41,19,3,25,48,219,SG
2017,22,2,25,1,4,0,0,1,4,0,0,2,1,3,1,0,0,1,2,2,C
2017,31,65,1477,155,351,90,230,65,121,61,82,51,188,239,77,33,20,56,109,461,PF
2017,24,4,47,5,9,1,4,4,5,0,0,0,1,1,0,1,1,0,6,11,SF
2017,24,2,41,5,8,1,3,4,5,0,0,0,1,1,0,1,1,0,5,11,SF
2017,21,82,3030,802,1479,101,275,701,1204,356,428,296,711,1007,220,57,103,212,241,2061,C
2017,31,81,2236,199,482,70,196,129,286,72,93,117,355,472,99,116,19,66,196,540,SF
2017,31,57,1627,147,354,46,136,101,218,61,77,94,249,343,73,85,14,52,143,401,SF
2017,31,24,609,52,128,24,60,28,68,11,16,23,106,129,26,31,5,14,53,139,SF
2017,28,65,1658,235,552,31,118,204,434,85,103,36,211,247,205,53,24,100,121,586,SF
2017,20,81,2541,444,869,40,115,404,754,245,303,139,448,587,106,74,173,105,262,1173,C
2017,34,39,560,92,197,11,32,81,165,32,34,6,51,57,131,13,0,37,29,227,PG
2017,21,61,1123,184,437,21,79,163,358,55,71,20,75,95,226,48,5,77,73,444,PG
2017,23,9,115,16,38,3,9,13,29,5,7,8,14,22,9,2,4,3,8,40,PF
2017,24,80,2066,391,702,1,2,390,700,176,217,226,533,759,57,37,63,106,216,959,C
2017,23,57,976,102,288,73,208,29,80,14,18,11,140,151,63,30,7,49,86,291,SG
2017,22,37,294,39,111,11,29,28,82,18,22,4,38,42,35,17,2,15,36,107,PG
2017,34,14,92,5,14,0,0,5,14,8,11,12,15,27,10,3,3,8,16,18,C
2017,30,3,39,2,8,1,3,1,5,2,3,0,2,2,5,1,1,1,6,7,PG
2017,20,41,458,57,156,26,81,31,75,2,5,4,45,49,23,19,10,14,32,142,SG
2017,21,74,1265,130,270,7,20,123,250,60,94,131,256,387,31,30,27,64,154,327,PF
2017,26,75,2163,483,1031,23,75,460,956,107,160,176,603,779,208,77,74,117,180,1096,C
2017,32,42,408,42,136,23,74,19,62,17,24,12,47,59,52,13,2,16,38,124,SG
2017,35,60,1792,414,955,45,145,369,810,223,281,64,207,271,229,86,41,138,112,1096,SG
2017,25,46,1384,281,663,85,215,196,448,82,127,18,136,154,200,41,20,103,95,729,SG
2017,26,79,2739,643,1449,240,602,403,847,304,359,45,263,308,435,85,22,168,119,1830,PG
2017,26,78,2836,647,1435,89,272,558,1163,422,527,58,268,326,831,157,49,323,151,1805,PG
2017,22,59,981,114,285,33,102,81,183,74,94,25,132,157,55,43,27,61,96,335,SF
2017,23,66,2048,403,814,26,98,377,716,119,154,125,214,339,75,76,39,57,175,951,SF
2017,32,62,1012,96,248,32,105,64,143,57,66,16,73,89,114,43,2,47,84,281,PG
2017,24,20,205,25,60,1,10,24,50,11,16,8,18,26,21,12,1,8,16,62,PG
2017,24,7,46,5,14,0,3,5,11,2,3,0,4,4,5,3,1,3,4,12,PG
2017,24,13,159,20,46,1,7,19,39,9,13,8,14,22,16,9,0,5,12,50,PG
2017,36,68,854,135,252,3,8,132,244,43,56,47,156,203,151,42,48,78,105,316,C
2017,28,81,2802,824,1941,200,583,624,1358,710,840,137,727,864,840,133,31,438,190,2558,PG
2017,24,35,471,33,87,12,34,21,53,20,22,25,57,82,21,10,10,18,52,98,PF
2017,21,73,1643,204,508,44,149,160,359,91,113,32,152,184,192,42,36,142,175,543,PG
2017,27,77,2513,542,973,0,0,542,973,225,358,293,795,1088,57,56,161,154,226,1309,C
2017,21,82,3048,709,1570,103,289,606,1281,412,542,103,226,329,189,82,30,187,183,1933,SF
2017,26,22,108,8,31,3,15,5,16,2,2,4,8,12,12,2,1,6,8,21,SG
2017,24,47,708,138,267,0,1,138,266,70,112,94,198,292,23,27,32,37,125,346,C
2017,32,64,1657,263,600,85,234,178,366,90,109,14,133,147,360,31,8,138,138,701,PG
2017,32,40,1171,195,453,63,181,132,272,69,84,13,89,102,274,25,2,98,96,522,PG
2017,32,24,486,68,147,22,53,46,94,21,25,1,44,45,86,6,6,40,42,179,PG
2017,25,50,804,108,244,30,97,78,147,58,89,19,111,130,28,14,7,28,60,304,PF
2017,25,25,377,54,137,9,45,45,92,31,50,16,57,73,14,9,5,14,33,148,PF
2017,25,25,427,54,107,21,52,33,55,27,39,3,54,57,14,5,2,14,27,156,PF
2017,30,81,1994,428,998,163,446,265,552,402,457,26,176,202,239,80,19,160,92,1421,SG
2017,30,58,1403,326,734,122,317,204,417,304,344,14,118,132,183,65,10,120,67,1078,SG
2017,30,23,591,102,264,41,129,61,135,98,113,12,58,70,56,15,9,40,25,343,SG
2017,30,76,2295,297,704,124,354,173,350,131,150,89,409,498,106,58,53,60,134,849,PF
2017,30,6,79,8,23,5,11,3,12,6,7,2,4,6,4,3,0,0,2,27,SF
2017,22,30,557,73,167,18,62,55,105,21,32,15,54,69,25,27,10,33,60,185,SF
2017,22,24,418,51,123,10,41,41,82,15,25,6,39,45,19,24,9,27,42,127,SF
2017,22,6,139,22,44,8,21,14,23,6,7,9,15,24,6,3,1,6,18,58,SF
2017,24,14,44,4,14,4,13,0,1,1,2,4,6,10,2,3,1,5,4,13,PF
2017,20,18,625,80,225,7,35,73,190,29,47,23,71,94,66,27,6,33,52,196,SF
2017,26,51,432,55,103,0,1,55,102,36,48,52,69,121,7,16,32,14,52,146,C
2017,21,13,107,12,23,0,5,12,18,11,15,14,15,29,2,3,6,7,11,35,PF
2017,37,25,160,19,68,9,38,10,30,10,16,5,15,20,11,9,2,7,18,57,SF
2017,29,28,447,83,135,0,1,83,134,23,35,31,47,78,15,11,20,10,42,189,PF
2017,24,27,446,49,116,10,30,39,86,42,55,16,32,48,57,27,11,25,31,150,PG
2017,21,29,220,25,58,12,35,13,23,6,9,6,20,26,4,10,2,4,15,68,SG
2017,24,33,135,26,72,5,23,21,49,11,15,1,16,17,15,4,0,5,5,68,PG
2017,31,60,1556,272,633,170,421,102,212,77,90,25,112,137,58,37,14,36,137,791,SG
2017,28,74,2237,362,687,45,118,317,569,45,86,131,318,449,122,114,30,96,135,814,PF
2017,24,62,1725,253,443,0,1,253,442,133,196,135,270,405,99,62,58,65,189,639,PF
2017,27,51,525,78,158,0,1,78,157,22,39,43,81,124,42,7,21,20,61,178,C
2017,20,19,108,10,31,0,0,10,31,3,5,11,24,35,4,2,5,3,17,23,C
2017,22,44,843,88,221,33,99,55,122,31,40,15,110,125,36,15,16,40,78,240,SF
2017,19,38,609,126,238,0,3,126,235,32,49,41,118,159,30,14,33,30,66,284,C